PokerStars Hand #b72dcaf1-0f8e-49d6-abc8-f0f1a5310edb:  Hold'em No Limit ($0.1/$0.20 USD) - 2021/11/20 23:33:00 ET
Table 'Lacey' 6-max Seat #6 is the button
Seat 1: warioman ($20.60 in chips)
Seat 2: Player#4316 ($14.00 in chips)
Seat 3: Player#4848 ($63.27 in chips)
Seat 4: Player#6685 ($29.65 in chips)
Seat 5: Player#9526 ($20.00 in chips)
Seat 6: Player#7369 ($62.03 in chips)
warioman: posts small blind $0.10
Player#4316: posts big blind $0.20
*** HOLE CARDS ***
Dealt to warioman [5h Qc]
Player#9526 Entry Bet 0.2
Player#4848: raises $0.20 to $0.6
Player#6685: folds
Player#9526: folds
Player#7369: folds
warioman: folds
Player#4316: folds
Player#4848: doesn't show hand
Uncalled bet ($0.60) returned to Player#4848
Player#4848 collected $0.30 from pot
*** SUMMARY ***
Total Pot $0.30 | Rake $0.00
Seat 1: warioman (small blind) folded before the flop
Seat 2: Player#4316 (big blind) folded before the flop
Seat 3: Player#4848 shows [] and won ($0.30) with 
Seat 4: Player#6685 folded before the flop
Seat 5: Player#9526 folded before the flop
Seat 6: Player#7369 (button) folded before the flop

PokerStars Hand #a91ed66c-fb5b-4b66-b719-a14d2daa48b0:  Hold'em No Limit ($0.1/$0.20 USD) - 2021/11/20 23:32:00 ET
Table 'Denver' 6-max Seat #1 is the button
Seat 1: Player#0768 ($2.06 in chips)
Seat 2: Player#3756 ($63.58 in chips)
Seat 3: warioman ($29.39 in chips)
Seat 4: Player#0003 ($9.70 in chips)
Seat 5: Player#5462 ($20.69 in chips)
Player#3756: posts small blind $0.10
warioman: posts big blind $0.20
*** HOLE CARDS ***
Dealt to warioman [8s 9c]
Player#0003: folds
Player#5462: folds
Player#0768: folds
Player#3756: raises $0.20 to $0.6
warioman: calls $0.40
*** FLOP *** [Js Kc Tc]
Player#3756: bets $0.80
warioman: calls $0.80
*** TURN *** [Js Kc Tc] [Jc]
Player#3756: checks
warioman: checks
*** RIVER *** [Js Kc Tc] [Jc] [7c]
Player#3756: checks
warioman: bets $1.44
Player#3756: folds
warioman: doesn't show hand
Uncalled bet ($1.44) returned to warioman
warioman collected $2.66 from pot
*** SUMMARY ***
Total Pot $2.80 | Rake $0.14
Board [Js Kc Tc Jc 7c]
Seat 1: Player#0768 (button) folded before the flop
Seat 2: Player#3756 (small blind) folded on the river
Seat 3: warioman (big blind)
Seat 4: Player#0003 folded before the flop
Seat 5: Player#5462 folded before the flop

PokerStars Hand #dad7e1db-c765-48bc-8c76-010586fe782d:  Hold'em No Limit ($0.1/$0.20 USD) - 2021/11/20 23:32:00 ET
Table 'Lacey' 6-max Seat #1 is the button
Seat 1: warioman ($20.32 in chips)
Seat 2: Player#7332 ($14.00 in chips)
Seat 3: Player#1444 ($63.47 in chips)
Seat 4: Player#3635 ($29.65 in chips)
Seat 5: Player#1117 ($20.00 in chips)
Seat 6: Player#3976 ($62.13 in chips)
Player#7332: posts small blind $0.10
Player#3976: posts big blind $0.20
*** HOLE CARDS ***
Dealt to warioman [Kc 6s]
Player#7332 Waiting
Player#1444: calls $0.20
Player#3635: folds
Player#3976: folds
warioman: checks
*** FLOP *** [6h Ah Qd]
warioman: checks
Player#1444: checks
*** TURN *** [6h Ah Qd] [Jc]
warioman: checks
Player#1444: checks
*** RIVER *** [6h Ah Qd] [Jc] [Tc]
warioman: checks
Player#1444: checks
*** SHOW DOWN *** 
warioman collected $0.47 from pot
*** SUMMARY ***
Total Pot $0.50 | Rake $0.03
Board [6h Ah Qd Jc Tc]
Seat 1: warioman (button)
Seat 2: Player#7332 (small blind) mucked
Seat 3: Player#1444 mucked
Seat 4: Player#3635 folded before the flop
Seat 5: Player#1117 mucked
Seat 6: Player#3976 (big blind) folded before the flop

PokerStars Hand #da78fc4a-7c73-49e3-87fe-3be798ed699d:  Hold'em No Limit ($0.1/$0.20 USD) - 2021/11/20 23:32:00 ET
Table 'Denver' 6-max Seat #6 is the button
Seat 1: Player#0319 ($1.08 in chips)
Seat 2: Player#4391 ($64.66 in chips)
Seat 3: warioman ($29.39 in chips)
Seat 4: Player#0329 ($9.70 in chips)
Seat 5: Player#3239 ($20.69 in chips)
Player#0319: posts small blind $0.10
Player#4391: posts big blind $0.20
*** HOLE CARDS ***
Dealt to warioman [Jd 7c]
warioman: folds
Player#0329: folds
Player#3239: folds
Player#0319: raises $0.20 to $0.4
Player#4391: raises $0.40 to $0.8
Player#0319: raises $0.80 to $1.08
Player#4391: calls $0.28
Player#0319 Showing Pocket Cards AA
Player#4391 Showing Pocket Cards 57
*** FLOP *** [9c 5h 8d]
*** TURN *** [9c 5h 8d] [4h]
*** RIVER *** [9c 5h 8d] [4h] [Tc]
Player#0319 collected $2.05 from pot
*** SUMMARY ***
Total Pot $2.16 | Rake $0.11
Board [9c 5h 8d 4h Tc]
Seat 1: Player#0319 shows [Ac Ah] and won ($2.05) with 
Seat 2: Player#4391 (big blind) mucked
Seat 3: warioman folded before the flop
Seat 4: Player#0329 folded before the flop
Seat 5: Player#3239 folded before the flop

PokerStars Hand #e3486ef1-70af-482b-8be8-6f77c07ee042:  Hold'em No Limit ($0.1/$0.20 USD) - 2021/11/20 23:31:00 ET
Table 'Denver' 6-max Seat #5 is the button
Seat 1: Player#1448 ($53.17 in chips)
Seat 2: Player#6375 ($1.28 in chips)
Seat 3: Player#7446 ($64.29 in chips)
Seat 4: warioman ($29.39 in chips)
Seat 5: Player#2898 ($9.70 in chips)
Seat 6: Player#1653 ($20.89 in chips)
Player#1653: posts small blind $0.10
Player#6375: posts big blind $0.20
*** HOLE CARDS ***
Dealt to warioman [2c Js]
Player#1448 Decline Entry Bet
Player#7446: calls $0.20
warioman: folds
Player#2898: folds
Player#1653: calls $0.10
Player#6375: checks
*** FLOP *** [Jd 7d Qs]
Player#1653: checks
Player#6375: checks
Player#7446: bets $0.60
Player#1653: folds
Player#6375: folds
Player#7446: doesn't show hand
Uncalled bet ($0.60) returned to Player#7446
Player#7446 collected $0.57 from pot
*** SUMMARY ***
Total Pot $0.60 | Rake $0.03
Board [Jd 7d Qs]
Seat 1: Player#1448 mucked
Seat 2: Player#6375 (big blind) folded on the flop
Seat 3: Player#7446 shows [] and won ($0.57) with 
Seat 4: warioman folded before the flop
Seat 5: Player#2898 (button) folded before the flop
Seat 6: Player#1653 (small blind) folded on the flop

PokerStars Hand #a62cc191-082f-42bb-8af8-71fbc9951a0e:  Hold'em No Limit ($0.1/$0.20 USD) - 2021/11/20 23:31:00 ET
Table 'Lacey' 6-max Seat #1 is the button
Seat 1: warioman ($20.32 in chips)
Seat 2: Player#2717 ($14.00 in chips)
Seat 3: Player#9092 ($67.77 in chips)
Seat 4: Player#1373 ($29.85 in chips)
Seat 5: Player#2274 ($58.07 in chips)
Player#2717: posts small blind $0.10
Player#1373: posts big blind $0.20
*** HOLE CARDS ***
Dealt to warioman [3s Td]
Player#2717 Waiting
warioman: folds
Player#9092: calls $0.20
Player#1373: calls $0.10
Player#2274: checks
*** FLOP *** [9h 8c 5h]
Player#1373: checks
Player#2274: checks
Player#9092: checks
*** TURN *** [9h 8c 5h] [7c]
Player#1373: checks
Player#2274: bets $0.40
Player#9092: raises0.40 to $1
Player#1373: folds
Player#2274: calls $0.60
*** RIVER *** [9h 8c 5h] [7c] [Jc]
Player#2274: bets $3.10
Player#9092: calls $3.10
*** SHOW DOWN *** 
Player#9092: doesn't show hand
Player#2274 collected $8.36 from pot
*** SUMMARY ***
Total Pot $8.80 | Rake $0.44
Board [9h 8c 5h 7c Jc]
Seat 1: warioman (button) folded before the flop
Seat 2: Player#2717 (small blind) mucked
Seat 3: Player#9092 mucked
Seat 4: Player#1373 (big blind) folded on the turn
Seat 5: Player#2274 shows [2h Th] and won ($8.36) with 

PokerStars Hand #7642333e-9864-4097-a743-eed8a65a05fb:  Hold'em No Limit ($0.1/$0.20 USD) - 2021/11/20 23:30:00 ET
Table 'Lacey' 6-max Seat #2 is the button
Seat 1: warioman ($20.32 in chips)
Seat 2: Player#0510 ($14.00 in chips)
Seat 3: Player#1979 ($67.97 in chips)
Seat 4: Player#6823 ($29.67 in chips)
Seat 5: Player#4185 ($58.07 in chips)
Player#1979: posts small blind $0.10
Player#6823: posts big blind $0.20
*** HOLE CARDS ***
Dealt to warioman [7h 2h]
Player#4185: folds
warioman: folds
Player#1979: calls $0.10
Player#6823: checks
*** FLOP *** [2c Td 2d]
Player#1979: checks
Player#6823: bets $0.40
Player#1979: folds
Player#6823: doesn't show hand
Uncalled bet ($0.40) returned to Player#6823
Player#6823 collected $0.38 from pot
*** SUMMARY ***
Total Pot $0.40 | Rake $0.02
Board [2c Td 2d]
Seat 1: warioman folded before the flop
Seat 2: Player#0510 (button) mucked
Seat 3: Player#1979 (small blind) folded on the flop
Seat 4: Player#6823 shows [] and won ($0.38) with 
Seat 5: Player#4185 folded before the flop

PokerStars Hand #717adf08-2132-4caf-b842-4a077fa43b19:  Hold'em No Limit ($0.1/$0.20 USD) - 2021/11/20 23:30:00 ET
Table 'Lacey' 6-max Seat #6 is the button
Seat 1: warioman ($20.42 in chips)
Seat 2: Player#1456 ($67.87 in chips)
Seat 3: Player#3752 ($29.67 in chips)
Seat 4: Player#6325 ($58.07 in chips)
warioman: posts small blind $0.10
Player#1456: posts big blind $0.20
*** HOLE CARDS ***
Dealt to warioman [5d 9h]
Player#3752: folds
Player#6325: folds
warioman: folds
Player#1456 collected $0.20 from pot
*** SUMMARY ***
Total Pot $0.20 | Rake $0.00
Seat 1: warioman (small blind) folded before the flop
Seat 2: Player#1456 shows [] and won ($0.20) with 
Seat 3: Player#3752 folded before the flop
Seat 4: Player#6325 folded before the flop

PokerStars Hand #53fc9acf-0356-46ba-baf2-ef03ec1dfc98:  Hold'em No Limit ($0.1/$0.20 USD) - 2021/11/20 23:30:00 ET
Table 'Denver' 6-max Seat #4 is the button
Seat 1: Player#3437 ($53.17 in chips)
Seat 2: Player#0461 ($1.88 in chips)
Seat 3: Player#7765 ($64.89 in chips)
Seat 4: warioman ($27.61 in chips)
Seat 5: Player#6441 ($9.80 in chips)
Seat 6: Player#0839 ($21.49 in chips)
Player#6441: posts small blind $0.10
Player#0839: posts big blind $0.20
*** HOLE CARDS ***
Dealt to warioman [Th 8h]
Player#3437: folds
Player#0461: calls $0.20
Player#7765: calls $0.20
warioman: calls $0.20
Player#6441: folds
Player#0839: checks
*** FLOP *** [8s 7h Ts]
Player#0839: checks
Player#0461: checks
Player#7765: bets $0.40
warioman: calls $0.40
Player#0839: calls $0.40
Player#0461: calls $0.40
*** TURN *** [8s 7h Ts] [Ks]
Player#0839: checks
Player#0461: checks
Player#7765: checks
warioman: checks
*** RIVER *** [8s 7h Ts] [Ks] [2s]
Player#0839: checks
Player#0461: checks
Player#7765: checks
warioman: checks
*** SHOW DOWN *** 
warioman collected $2.38 from pot
*** SUMMARY ***
Total Pot $2.50 | Rake $0.12
Board [8s 7h Ts Ks 2s]
Seat 1: Player#3437 folded before the flop
Seat 2: Player#0461 mucked
Seat 3: Player#7765 mucked
Seat 4: warioman (button)
Seat 5: Player#6441 (small blind) folded before the flop
Seat 6: Player#0839 (big blind) mucked

PokerStars Hand #4d6eba2e-1e74-4fc6-b36c-662d1a8bc4e0:  Hold'em No Limit ($0.1/$0.20 USD) - 2021/11/20 23:30:00 ET
Table 'Lacey' 6-max Seat #4 is the button
Seat 1: warioman ($20.62 in chips)
Seat 2: Player#5699 ($67.57 in chips)
Seat 3: Player#9414 ($29.67 in chips)
Seat 4: Player#7828 ($14.60 in chips)
Seat 5: Player#0983 ($58.17 in chips)
Player#0983: posts small blind $0.10
warioman: posts big blind $0.20
*** HOLE CARDS ***
Dealt to warioman [7s Ac]
Player#5699: raises $0.20 to $0.6
Player#9414: folds
Player#0983: folds
warioman: folds
Player#5699: doesn't show hand
Uncalled bet ($0.60) returned to Player#5699
Player#5699 collected $0.30 from pot
*** SUMMARY ***
Total Pot $0.30 | Rake $0.00
Seat 1: warioman (big blind) folded before the flop
Seat 2: Player#5699 shows [] and won ($0.30) with 
Seat 3: Player#9414 folded before the flop
Seat 4: Player#7828 (button) mucked
Seat 5: Player#0983 (small blind) folded before the flop

PokerStars Hand #43090cad-cee0-4aff-857e-16687f8f3a7d:  Hold'em No Limit ($0.1/$0.20 USD) - 2021/11/20 23:30:00 ET
Table 'Denver' 6-max Seat #3 is the button
Seat 1: Player#3908 ($53.17 in chips)
Seat 2: Player#6064 ($2.08 in chips)
Seat 3: Player#3461 ($64.42 in chips)
Seat 4: warioman ($27.71 in chips)
Seat 5: Player#2396 ($10.00 in chips)
Seat 6: Player#5377 ($21.49 in chips)
warioman: posts small blind $0.10
Player#2396: posts big blind $0.20
*** HOLE CARDS ***
Dealt to warioman [3c Th]
Player#5377: folds
Player#3908: folds
Player#6064: calls $0.20
Player#3461: calls $0.20
warioman: folds
Player#2396: checks
*** FLOP *** [2d 5d 3d]
Player#2396: checks
Player#6064: checks
Player#3461: bets $0.40
Player#2396: folds
Player#6064: folds
Player#3461: doesn't show hand
Uncalled bet ($0.40) returned to Player#3461
Player#3461 collected $0.67 from pot
*** SUMMARY ***
Total Pot $0.70 | Rake $0.04
Board [2d 5d 3d]
Seat 1: Player#3908 folded before the flop
Seat 2: Player#6064 folded on the flop
Seat 3: Player#3461 shows [] and won ($0.67) with 
Seat 4: warioman (small blind) folded before the flop
Seat 5: Player#2396 (big blind) folded on the flop
Seat 6: Player#5377 folded before the flop

PokerStars Hand #870cee63-dc19-4ffb-b22a-38b4d0471c44:  Hold'em No Limit ($0.1/$0.20 USD) - 2021/11/20 23:29:00 ET
Table 'Lacey' 6-max Seat #3 is the button
Seat 1: warioman ($20.62 in chips)
Seat 2: Player#5508 ($18.60 in chips)
Seat 3: Player#2732 ($67.77 in chips)
Seat 4: Player#8062 ($29.30 in chips)
Seat 5: Player#5966 ($58.37 in chips)
Player#8062: posts small blind $0.10
Player#5966: posts big blind $0.20
*** HOLE CARDS ***
Dealt to warioman [9d 6c]
warioman: folds
Player#5508: folds
Player#2732: calls $0.20
Player#8062: calls $0.10
Player#5966: checks
*** FLOP *** [4d Kc 8h]
Player#8062: checks
Player#5966: checks
Player#2732: checks
*** TURN *** [4d Kc 8h] [7h]
Player#8062: checks
Player#5966: checks
Player#2732: checks
*** RIVER *** [4d Kc 8h] [7h] [Th]
Player#8062: checks
Player#5966: checks
Player#2732: checks
*** SHOW DOWN *** 
Player#8062 collected $0.57 from pot
*** SUMMARY ***
Total Pot $0.60 | Rake $0.03
Board [4d Kc 8h 7h Th]
Seat 1: warioman folded before the flop
Seat 2: Player#5508 folded before the flop
Seat 3: Player#2732 (button) mucked
Seat 4: Player#8062 shows [4c Jh] and won ($0.57) with 
Seat 5: Player#5966 (big blind) mucked

PokerStars Hand #cd926df9-59b4-4de6-bac2-6d4fd8e557f5:  Hold'em No Limit ($0.1/$0.20 USD) - 2021/11/20 23:28:00 ET
Table 'Denver' 6-max Seat #2 is the button
Seat 1: Player#7209 ($53.17 in chips)
Seat 2: Player#0064 ($2.08 in chips)
Seat 3: Player#8232 ($71.02 in chips)
Seat 4: warioman ($21.58 in chips)
Seat 5: Player#6770 ($21.69 in chips)
Player#8232: posts small blind $0.10
warioman: posts big blind $0.20
*** HOLE CARDS ***
Dealt to warioman [Ks Kh]
Player#6770: calls $0.20
Player#7209: folds
Player#0064: folds
Player#8232: calls $0.10
warioman: raises $0.20 to $1.2
Player#6770: folds
Player#8232: calls $1.00
*** FLOP *** [3s Qd 3h]
Player#8232: bets $1.30
warioman: calls $1.30
*** TURN *** [3s Qd 3h] [3d]
Player#8232: bets $4.10
warioman: calls $4.10
*** RIVER *** [3s Qd 3h] [3d] [8d]
Player#8232: checks
warioman: bets $14.98
Player#8232: folds
warioman: doesn't show hand
Uncalled bet ($14.98) returned to warioman
warioman collected $12.73 from pot
*** SUMMARY ***
Total Pot $13.40 | Rake $0.67
Board [3s Qd 3h 3d 8d]
Seat 1: Player#7209 folded before the flop
Seat 2: Player#0064 (button) folded before the flop
Seat 3: Player#8232 (small blind) folded on the river
Seat 4: warioman (big blind)
Seat 5: Player#6770 folded before the flop

PokerStars Hand #f2eda175-15f3-4b73-9c2d-e0d0a3a7380b:  Hold'em No Limit ($0.1/$0.20 USD) - 2021/11/20 23:28:00 ET
Table 'Lacey' 6-max Seat #2 is the button
Seat 1: warioman ($20.62 in chips)
Seat 2: Player#0568 ($18.60 in chips)
Seat 3: Player#4922 ($66.69 in chips)
Seat 4: Player#9588 ($30.50 in chips)
Seat 5: Player#6126 ($58.37 in chips)
Player#4922: posts small blind $0.10
Player#9588: posts big blind $0.20
*** HOLE CARDS ***
Dealt to warioman [6h 7d]
Player#6126: folds
warioman: folds
Player#0568: folds
Player#4922: raises $0.20 to $0.6
Player#9588: calls $0.40
*** FLOP *** [As Jd 9c]
Player#4922: checks
Player#9588: checks
*** TURN *** [As Jd 9c] [3d]
Player#4922: bets $0.60
Player#9588: calls $0.60
*** RIVER *** [As Jd 9c] [3d] [2d]
Player#4922: checks
Player#9588: checks
*** SHOW DOWN *** 
Player#4922 collected $2.28 from pot
*** SUMMARY ***
Total Pot $2.40 | Rake $0.12
Board [As Jd 9c 3d 2d]
Seat 1: warioman folded before the flop
Seat 2: Player#0568 (button) folded before the flop
Seat 3: Player#4922 shows [Jc Th] and won ($2.28) with 
Seat 4: Player#9588 (big blind) mucked
Seat 5: Player#6126 folded before the flop

PokerStars Hand #fe06a3fc-8a55-4bca-b287-c2bfb13066dc:  Hold'em No Limit ($0.1/$0.20 USD) - 2021/11/20 23:27:00 ET
Table 'Denver' 6-max Seat #1 is the button
Seat 1: Player#0720 ($53.92 in chips)
Seat 2: Player#7532 ($2.83 in chips)
Seat 3: Player#7439 ($67.66 in chips)
Seat 4: warioman ($21.58 in chips)
Seat 5: Player#4871 ($23.84 in chips)
Player#7532: posts small blind $0.10
Player#7439: posts big blind $0.20
*** HOLE CARDS ***
Dealt to warioman [7c Tc]
warioman: folds
Player#4871: calls $0.20
Player#0720: raises $0.20 to $0.75
Player#7532: calls $0.65
Player#7439: calls $0.55
Player#4871: calls $0.55
*** FLOP *** [Kc Ah Ts]
Player#7532: checks
Player#7439: checks
Player#4871: checks
Player#0720: checks
*** TURN *** [Kc Ah Ts] [4d]
Player#7532: checks
Player#7439: checks
Player#4871: bets $0.60
Player#0720: folds
Player#7532: folds
Player#7439: calls $0.60
*** RIVER *** [Kc Ah Ts] [4d] [9d]
Player#7439: checks
Player#4871: bets $0.80
Player#7439: calls $0.80
*** SHOW DOWN *** 
Player#7439 collected $5.51 from pot
*** SUMMARY ***
Total Pot $5.80 | Rake $0.29
Board [Kc Ah Ts 4d 9d]
Seat 1: Player#0720 (button) folded on the turn
Seat 2: Player#7532 (small blind) folded on the turn
Seat 3: Player#7439 shows [Jh As] and won ($5.51) with 
Seat 4: warioman folded before the flop
Seat 5: Player#4871 mucked

PokerStars Hand #1883eaaf-8254-4505-a643-ce30165c9cd6:  Hold'em No Limit ($0.1/$0.20 USD) - 2021/11/20 23:27:00 ET
Table 'Denver' 6-max Seat #6 is the button
Seat 1: Player#5994 ($53.36 in chips)
Seat 2: Player#7505 ($3.03 in chips)
Seat 3: Player#2459 ($67.86 in chips)
Seat 4: warioman ($21.58 in chips)
Seat 5: Player#4210 ($24.04 in chips)
Player#5994: posts small blind $0.10
Player#7505: posts big blind $0.20
*** HOLE CARDS ***
Dealt to warioman [2d Jc]
Player#2459: calls $0.20
warioman: folds
Player#4210: calls $0.20
Player#5994: calls $0.10
Player#7505: checks
*** FLOP *** [Qs Ac 9c]
Player#5994: bets $0.30
Player#7505: folds
Player#2459: folds
Player#4210: folds
Player#5994: doesn't show hand
Uncalled bet ($0.30) returned to Player#5994
Player#5994 collected $0.76 from pot
*** SUMMARY ***
Total Pot $0.80 | Rake $0.04
Board [Qs Ac 9c]
Seat 1: Player#5994 shows [] and won ($0.76) with 
Seat 2: Player#7505 (big blind) folded on the flop
Seat 3: Player#2459 folded on the flop
Seat 4: warioman folded before the flop
Seat 5: Player#4210 folded on the flop

PokerStars Hand #8e5b3756-9411-4d76-be98-cb442dba654e:  Hold'em No Limit ($0.1/$0.20 USD) - 2021/11/20 23:27:00 ET
Table 'Lacey' 6-max Seat #1 is the button
Seat 1: warioman ($20.62 in chips)
Seat 2: Player#7496 ($19.80 in chips)
Seat 3: Player#0049 ($67.89 in chips)
Seat 4: Player#5203 ($30.90 in chips)
Seat 5: Player#4123 ($55.77 in chips)
Player#7496: posts small blind $0.10
Player#0049: posts big blind $0.20
*** HOLE CARDS ***
Dealt to warioman [4s 2s]
Player#5203: raises $0.20 to $0.4
Player#4123: calls $0.40
warioman: folds
Player#7496: calls $0.30
Player#0049: calls $0.20
*** FLOP *** [9c Qd 7h]
Player#7496: checks
Player#0049: checks
Player#5203: checks
Player#4123: checks
*** TURN *** [9c Qd 7h] [Kh]
Player#7496: checks
Player#0049: checks
Player#5203: checks
Player#4123: bets $0.80
Player#7496: calls $0.80
Player#0049: calls $0.80
Player#5203: folds
*** RIVER *** [9c Qd 7h] [Kh] [2h]
Player#7496: checks
Player#0049: checks
Player#4123: checks
*** SHOW DOWN *** 
Player#4123 collected $3.80 from pot
*** SUMMARY ***
Total Pot $4.00 | Rake $0.20
Board [9c Qd 7h Kh 2h]
Seat 1: warioman (button) folded before the flop
Seat 2: Player#7496 (small blind) mucked
Seat 3: Player#0049 (big blind) mucked
Seat 4: Player#5203 folded on the turn
Seat 5: Player#4123 shows [Jc Qc] and won ($3.80) with 

PokerStars Hand #b0bbe205-cd83-4e62-84aa-9e220766ebf8:  Hold'em No Limit ($0.1/$0.20 USD) - 2021/11/20 23:26:00 ET
Table 'Lacey' 6-max Seat #6 is the button
Seat 1: warioman ($20.72 in chips)
Seat 2: Player#3798 ($20.00 in chips)
Seat 3: Player#6145 ($67.89 in chips)
Seat 4: Player#1001 ($30.90 in chips)
Seat 5: Player#4433 ($55.47 in chips)
warioman: posts small blind $0.10
Player#3798: posts big blind $0.20
*** HOLE CARDS ***
Dealt to warioman [3c 4h]
Player#6145: folds
Player#1001: folds
Player#4433: raises $0.20 to $0.6
warioman: folds
Player#3798: folds
Player#4433: doesn't show hand
Uncalled bet ($0.60) returned to Player#4433
Player#4433 collected $0.30 from pot
*** SUMMARY ***
Total Pot $0.30 | Rake $0.00
Seat 1: warioman (small blind) folded before the flop
Seat 2: Player#3798 (big blind) folded before the flop
Seat 3: Player#6145 folded before the flop
Seat 4: Player#1001 folded before the flop
Seat 5: Player#4433 shows [] and won ($0.30) with 

PokerStars Hand #07210cce-2cd8-49d7-928e-83f8e9c5d872:  Hold'em No Limit ($0.1/$0.20 USD) - 2021/11/20 23:26:00 ET
Table 'Denver' 6-max Seat #4 is the button
Seat 1: Player#2674 ($51.61 in chips)
Seat 2: Player#6246 ($3.03 in chips)
Seat 3: Player#3131 ($68.06 in chips)
Seat 4: warioman ($21.58 in chips)
Seat 5: Player#4385 ($25.77 in chips)
Player#4385: posts small blind $0.10
Player#2674: posts big blind $0.20
*** HOLE CARDS ***
Dealt to warioman [5h 4h]
Player#6246: folds
Player#3131: calls $0.20
warioman: folds
Player#4385: calls $0.10
Player#2674: checks
*** FLOP *** [3d As 8d]
Player#4385: bets $0.20
Player#2674: raises $0.20 to $0.68
Player#3131: folds
Player#4385: calls $0.48
*** TURN *** [3d As 8d] [6d]
Player#4385: checks
Player#2674: bets $0.85
Player#4385: calls $0.85
*** RIVER *** [3d As 8d] [6d] [Qd]
Player#4385: checks
Player#2674: checks
*** SHOW DOWN *** 
Player#2674 collected $3.48 from pot
*** SUMMARY ***
Total Pot $3.66 | Rake $0.18
Board [3d As 8d 6d Qd]
Seat 1: Player#2674 shows [Th Ac] and won ($3.48) with 
Seat 2: Player#6246 folded before the flop
Seat 3: Player#3131 folded on the flop
Seat 4: warioman (button) folded before the flop
Seat 5: Player#4385 (small blind) mucked

PokerStars Hand #6ab78b9a-5d56-40ae-9cca-9038a5fec503:  Hold'em No Limit ($0.1/$0.20 USD) - 2021/11/20 23:26:00 ET
Table 'Lacey' 6-max Seat #4 is the button
Seat 1: warioman ($20.92 in chips)
Seat 2: Player#7367 ($10.91 in chips)
Seat 3: Player#7988 ($67.89 in chips)
Seat 4: Player#8501 ($30.90 in chips)
Seat 5: Player#0494 ($55.57 in chips)
Player#0494: posts small blind $0.10
warioman: posts big blind $0.20
*** HOLE CARDS ***
Dealt to warioman [Qd 7h]
Player#7367: raises $0.20 to $0.4
Player#7988: folds
Player#8501: folds
Player#0494: folds
warioman: folds
warioman: doesn't show hand
Player#7367: doesn't show hand
Player#7988: doesn't show hand
Player#8501: doesn't show hand
Player#0494: doesn't show hand
Uncalled bet ($0.40) returned to Player#7367
Player#7367 collected $0.30 from pot
*** SUMMARY ***
Total Pot $0.30 | Rake $0.00
Seat 1: warioman (big blind) folded before the flop
Seat 2: Player#7367 shows [] and won ($0.30) with 
Seat 3: Player#7988 folded before the flop
Seat 4: Player#8501 (button) folded before the flop
Seat 5: Player#0494 (small blind) folded before the flop

PokerStars Hand #fcebc3cc-6200-4215-8b27-f84bc49f028a:  Hold'em No Limit ($0.1/$0.20 USD) - 2021/11/20 23:25:00 ET
Table 'Denver' 6-max Seat #4 is the button
Seat 1: Player#3982 ($51.61 in chips)
Seat 2: Player#0711 ($3.03 in chips)
Seat 3: Player#1417 ($62.80 in chips)
Seat 4: warioman ($21.58 in chips)
Seat 5: Player#4267 ($42.23 in chips)
Seat 6: Player#7625 ($26.47 in chips)
Player#4267: posts small blind $0.10
Player#7625: posts big blind $0.20
*** HOLE CARDS ***
Dealt to warioman [9c 3d]
Player#3982: folds
Player#0711: folds
Player#1417: raises $0.20 to $0.7
warioman: folds
Player#4267: calls $0.60
Player#7625: calls $0.50
*** FLOP *** [3s Ah Ks]
Player#4267: checks
Player#7625: checks
Player#1417: bets $1.05
Player#4267: calls $1.05
Player#7625: folds
*** TURN *** [3s Ah Ks] [4s]
Player#4267: checks
Player#1417: checks
*** RIVER *** [3s Ah Ks] [4s] [2s]
Player#4267: bets $3.35
Player#1417: raises $ 13.35 to $10.69
Player#4267: folds
Player#1417: doesn't show hand
Uncalled bet ($10.69) returned to Player#1417
Player#1417 collected $7.17 from pot
*** SUMMARY ***
Total Pot $7.55 | Rake $0.38
Board [3s Ah Ks 4s 2s]
Seat 1: Player#3982 folded before the flop
Seat 2: Player#0711 folded before the flop
Seat 3: Player#1417 shows [] and won ($7.17) with 
Seat 4: warioman (button) folded before the flop
Seat 5: Player#4267 (small blind) folded on the river
Seat 6: Player#7625 (big blind) folded on the flop

PokerStars Hand #14942a06-9128-43e8-bc35-9b0090de0fc1:  Hold'em No Limit ($0.1/$0.20 USD) - 2021/11/20 23:24:00 ET
Table 'Lacey' 6-max Seat #3 is the button
Seat 1: warioman ($20.92 in chips)
Seat 2: Player#5413 ($13.56 in chips)
Seat 3: Player#6428 ($65.22 in chips)
Seat 4: Player#9510 ($31.00 in chips)
Seat 5: Player#6847 ($48.27 in chips)
Seat 6: Player#3081 ($55.77 in chips)
Player#9510: posts small blind $0.10
Player#3081: posts big blind $0.20
*** HOLE CARDS ***
Dealt to warioman [3h 4h]
Player#6847 Decline Entry Bet
warioman: folds
Player#5413: raises $0.20 to $0.6
Player#6428: raises $0.60 to $1.05
Player#9510: folds
Player#3081: folds
Player#5413: calls $0.45
*** FLOP *** [6h Qh 7s]
Player#5413: checks
Player#6428: bets $1.60
Player#5413: calls $1.60
*** TURN *** [6h Qh 7s] [Jh]
Player#5413: checks
Player#6428: checks
*** RIVER *** [6h Qh 7s] [Jh] [8h]
Player#5413: checks
Player#6428: bets $4.20
Player#5413: folds
Player#6428: doesn't show hand
Uncalled bet ($4.20) returned to Player#6428
Player#6428 collected $5.32 from pot
*** SUMMARY ***
Total Pot $5.60 | Rake $0.28
Board [6h Qh 7s Jh 8h]
Seat 1: warioman folded before the flop
Seat 2: Player#5413 folded on the river
Seat 3: Player#6428 shows [] and won ($5.32) with 
Seat 4: Player#9510 (small blind) folded before the flop
Seat 5: Player#6847 mucked
Seat 6: Player#3081 (big blind) folded before the flop

PokerStars Hand #e40f5255-1de2-4e52-9fd3-0c348c902e4a:  Hold'em No Limit ($0.1/$0.20 USD) - 2021/11/20 23:24:00 ET
Table 'Lacey' 6-max Seat #2 is the button
Seat 1: warioman ($20.92 in chips)
Seat 2: Player#9359 ($13.56 in chips)
Seat 3: Player#5262 ($65.82 in chips)
Seat 4: Player#5789 ($30.46 in chips)
Seat 5: Player#0904 ($48.27 in chips)
Seat 6: Player#6430 ($55.77 in chips)
Player#5262: posts small blind $0.10
Player#5789: posts big blind $0.20
*** HOLE CARDS ***
Dealt to warioman [8s 3h]
Player#0904: folds
Player#6430: folds
warioman: folds
Player#9359: folds
Player#5262: calls $0.10
Player#5789: raises $0.20 to $0.6
Player#5262: calls $0.40
*** FLOP *** [Jc Tc 4s]
Player#5262: checks
Player#5789: checks
*** TURN *** [Jc Tc 4s] [Ah]
Player#5262: checks
Player#5789: bets $0.60
Player#5262: folds
Player#5789: doesn't show hand
Uncalled bet ($0.60) returned to Player#5789
Player#5789 collected $1.14 from pot
*** SUMMARY ***
Total Pot $1.20 | Rake $0.06
Board [Jc Tc 4s Ah]
Seat 1: warioman folded before the flop
Seat 2: Player#9359 (button) folded before the flop
Seat 3: Player#5262 (small blind) folded on the turn
Seat 4: Player#5789 shows [] and won ($1.14) with 
Seat 5: Player#0904 folded before the flop
Seat 6: Player#6430 folded before the flop

PokerStars Hand #3e13ec3b-387f-4922-9480-26cd9c37b763:  Hold'em No Limit ($0.1/$0.20 USD) - 2021/11/20 23:23:00 ET
Table 'Denver' 6-max Seat #3 is the button
Seat 1: Player#1186 ($51.61 in chips)
Seat 2: Player#3211 ($3.03 in chips)
Seat 3: Player#7607 ($67.90 in chips)
Seat 4: warioman ($21.68 in chips)
Seat 5: Player#2673 ($43.03 in chips)
Seat 6: Player#6063 ($21.02 in chips)
warioman: posts small blind $0.10
Player#2673: posts big blind $0.20
*** HOLE CARDS ***
Dealt to warioman [5s 8s]
Player#6063: calls $0.20
Player#1186: folds
Player#3211: folds
Player#7607: calls $0.20
warioman: folds
Player#2673: checks
*** FLOP *** [8c 3s 3h]
Player#2673: checks
Player#6063: checks
Player#7607: bets $0.60
Player#2673: calls $0.60
Player#6063: raises $0.60 to $1.2
Player#7607: calls $0.60
Player#2673: folds
*** TURN *** [8c 3s 3h] [3d]
Player#6063: checks
Player#7607: checks
*** RIVER *** [8c 3s 3h] [3d] [Kd]
Player#6063: bets $3.70
Player#7607: calls $3.70
*** SHOW DOWN *** 
Player#7607: doesn't show hand
Player#6063 collected $10.55 from pot
*** SUMMARY ***
Total Pot $11.10 | Rake $0.56
Board [8c 3s 3h 3d Kd]
Seat 1: Player#1186 folded before the flop
Seat 2: Player#3211 folded before the flop
Seat 3: Player#7607 (button) mucked
Seat 4: warioman (small blind) folded before the flop
Seat 5: Player#2673 (big blind) folded on the flop
Seat 6: Player#6063 shows [7c 3c] and won ($10.55) with 

PokerStars Hand #e0ea4238-4063-466c-9d45-6124ddc3650e:  Hold'em No Limit ($0.1/$0.20 USD) - 2021/11/20 23:23:00 ET
Table 'Lacey' 6-max Seat #1 is the button
Seat 1: warioman ($20.92 in chips)
Seat 2: Player#0746 ($13.66 in chips)
Seat 3: Player#1758 ($64.06 in chips)
Seat 4: Player#9162 ($30.46 in chips)
Seat 5: Player#3247 ($50.11 in chips)
Seat 6: Player#9673 ($55.77 in chips)
Player#0746: posts small blind $0.10
Player#1758: posts big blind $0.20
*** HOLE CARDS ***
Dealt to warioman [7h 5d]
Player#9162: folds
Player#3247: raises $0.20 to $0.75
Player#9673: folds
warioman: folds
Player#0746: folds
Player#1758: calls $0.55
*** FLOP *** [2h 2s Ts]
Player#1758: checks
Player#3247: bets $1.09
Player#1758: calls $1.09
*** TURN *** [2h 2s Ts] [6s]
Player#1758: checks
Player#3247: checks
*** RIVER *** [2h 2s Ts] [6s] [Js]
Player#1758: bets $2.83
Player#3247: folds
Player#1758: doesn't show hand
Uncalled bet ($2.83) returned to Player#1758
Player#1758 collected $3.59 from pot
*** SUMMARY ***
Total Pot $3.78 | Rake $0.19
Board [2h 2s Ts 6s Js]
Seat 1: warioman (button) folded before the flop
Seat 2: Player#0746 (small blind) folded before the flop
Seat 3: Player#1758 shows [] and won ($3.59) with 
Seat 4: Player#9162 folded before the flop
Seat 5: Player#3247 folded on the river
Seat 6: Player#9673 folded before the flop

PokerStars Hand #fe83e191-8582-41a2-8d17-184fd0b7cb08:  Hold'em No Limit ($0.1/$0.20 USD) - 2021/11/20 23:22:00 ET
Table 'Denver' 6-max Seat #2 is the button
Seat 1: Player#6104 ($51.61 in chips)
Seat 2: Player#5115 ($1.65 in chips)
Seat 3: Player#2175 ($68.00 in chips)
Seat 4: warioman ($22.68 in chips)
Seat 5: Player#1971 ($43.03 in chips)
Seat 6: Player#0086 ($21.42 in chips)
Player#2175: posts small blind $0.10
warioman: posts big blind $0.20
*** HOLE CARDS ***
Dealt to warioman [8c Ac]
Player#1971: folds
Player#0086: calls $0.20
Player#6104: folds
Player#5115: calls $0.20
Player#2175: folds
warioman: checks
*** FLOP *** [7h 8h 7s]
warioman: checks
Player#0086: checks
Player#5115: checks
*** TURN *** [7h 8h 7s] [4s]
warioman: bets $0.20
Player#0086: calls $0.20
Player#5115: calls $0.20
*** RIVER *** [7h 8h 7s] [4s] [Js]
warioman: checks
Player#0086: checks
Player#5115: bets $0.60
warioman: calls $0.60
Player#0086: folds
*** SHOW DOWN *** 
warioman: doesn't show hand
Player#5115 collected $2.38 from pot
*** SUMMARY ***
Total Pot $2.50 | Rake $0.12
Board [7h 8h 7s 4s Js]
Seat 1: Player#6104 folded before the flop
Seat 2: Player#5115 shows [9h Jc] and won ($2.38) with 
Seat 3: Player#2175 (small blind) folded before the flop
Seat 4: warioman (big blind)
Seat 5: Player#1971 folded before the flop
Seat 6: Player#0086 folded on the river

PokerStars Hand #a342f0a5-843f-4012-9572-c568a0c0cdc1:  Hold'em No Limit ($0.1/$0.20 USD) - 2021/11/20 23:22:00 ET
Table 'Lacey' 6-max Seat #6 is the button
Seat 1: warioman ($21.02 in chips)
Seat 2: Player#3089 ($15.30 in chips)
Seat 3: Player#3246 ($64.06 in chips)
Seat 4: Player#8088 ($30.46 in chips)
Seat 5: Player#7043 ($48.53 in chips)
Seat 6: Player#1617 ($55.77 in chips)
warioman: posts small blind $0.10
Player#3089: posts big blind $0.20
*** HOLE CARDS ***
Dealt to warioman [7d 2c]
Player#3246: folds
Player#8088: folds
Player#7043: raises $0.20 to $0.75
Player#1617: folds
warioman: folds
Player#3089: calls $0.55
*** FLOP *** [Ks As 6s]
Player#3089: checks
Player#7043: bets $0.89
Player#3089: calls $0.89
*** TURN *** [Ks As 6s] [7s]
Player#3089: checks
Player#7043: checks
*** RIVER *** [Ks As 6s] [7s] [5s]
Player#3089: checks
Player#7043: checks
*** SHOW DOWN *** 
Player#7043 collected $3.21 from pot
*** SUMMARY ***
Total Pot $3.38 | Rake $0.17
Board [Ks As 6s 7s 5s]
Seat 1: warioman (small blind) folded before the flop
Seat 2: Player#3089 (big blind) mucked
Seat 3: Player#3246 folded before the flop
Seat 4: Player#8088 folded before the flop
Seat 5: Player#7043 shows [Qd Ac] and won ($3.21) with 
Seat 6: Player#1617 (button) folded before the flop

PokerStars Hand #65f1ef32-2131-44cf-82e4-fd7e06e375d2:  Hold'em No Limit ($0.1/$0.20 USD) - 2021/11/20 23:21:00 ET
Table 'Lacey' 6-max Seat #5 is the button
Seat 1: warioman ($21.22 in chips)
Seat 2: Player#2465 ($15.30 in chips)
Seat 3: Player#8902 ($61.86 in chips)
Seat 4: Player#9234 ($30.46 in chips)
Seat 5: Player#7805 ($49.13 in chips)
Seat 6: Player#3123 ($57.37 in chips)
Player#3123: posts small blind $0.10
warioman: posts big blind $0.20
*** HOLE CARDS ***
Dealt to warioman [Jc 4s]
Player#2465: folds
Player#8902: raises $0.20 to $0.6
Player#9234: folds
Player#7805: calls $0.60
Player#3123: calls $0.50
warioman: folds
*** FLOP *** [3h Td Jh]
Player#3123: checks
Player#8902: bets $1.00
Player#7805: folds
Player#3123: calls $1.00
*** TURN *** [3h Td Jh] [5c]
Player#3123: checks
Player#8902: checks
*** RIVER *** [3h Td Jh] [5c] [9c]
Player#3123: checks
Player#8902: bets $3.00
Player#3123: folds
Player#8902: doesn't show hand
Uncalled bet ($3.00) returned to Player#8902
Player#8902 collected $3.80 from pot
*** SUMMARY ***
Total Pot $4.00 | Rake $0.20
Board [3h Td Jh 5c 9c]
Seat 1: warioman (big blind) folded before the flop
Seat 2: Player#2465 folded before the flop
Seat 3: Player#8902 shows [] and won ($3.80) with 
Seat 4: Player#9234 folded before the flop
Seat 5: Player#7805 (button) folded on the flop
Seat 6: Player#3123 (small blind) folded on the river

PokerStars Hand #9fa88f33-9cb6-4882-a3ae-ca314002b951:  Hold'em No Limit ($0.1/$0.20 USD) - 2021/11/20 23:21:00 ET
Table 'Denver' 6-max Seat #1 is the button
Seat 1: Player#9557 ($51.61 in chips)
Seat 2: Player#2004 ($2.45 in chips)
Seat 3: Player#9762 ($69.60 in chips)
Seat 4: warioman ($22.68 in chips)
Seat 5: Player#0042 ($43.03 in chips)
Seat 6: Player#3500 ($19.22 in chips)
Player#2004: posts small blind $0.10
Player#9762: posts big blind $0.20
*** HOLE CARDS ***
Dealt to warioman [3s 9d]
warioman: folds
Player#0042: folds
Player#3500: calls $0.20
Player#9557: folds
Player#2004: calls $0.10
Player#9762: raises $0.20 to $0.8
Player#3500: calls $0.60
Player#2004: calls $0.60
*** FLOP *** [Qd 8s Qc]
Player#2004: checks
Player#9762: checks
Player#3500: bets $0.20
Player#2004: folds
Player#9762: calls $0.20
*** TURN *** [Qd 8s Qc] [2d]
Player#9762: checks
Player#3500: bets $0.60
Player#9762: calls $0.60
*** RIVER *** [Qd 8s Qc] [2d] [6d]
Player#9762: checks
Player#3500: bets $0.80
Player#9762: folds
Player#3500: doesn't show hand
Uncalled bet ($0.80) returned to Player#3500
Player#3500 collected $3.80 from pot
*** SUMMARY ***
Total Pot $4.00 | Rake $0.20
Board [Qd 8s Qc 2d 6d]
Seat 1: Player#9557 (button) folded before the flop
Seat 2: Player#2004 (small blind) folded on the flop
Seat 3: Player#9762 (big blind) folded on the river
Seat 4: warioman folded before the flop
Seat 5: Player#0042 folded before the flop
Seat 6: Player#3500 shows [] and won ($3.80) with 

PokerStars Hand #753f5bc7-1741-4900-946c-7f72f7e51ccf:  Hold'em No Limit ($0.1/$0.20 USD) - 2021/11/20 23:20:00 ET
Table 'Lacey' 6-max Seat #4 is the button
Seat 1: warioman ($21.22 in chips)
Seat 2: Player#4951 ($15.30 in chips)
Seat 3: Player#1665 ($61.86 in chips)
Seat 4: Player#7269 ($30.86 in chips)
Seat 5: Player#4899 ($48.58 in chips)
Seat 6: Player#5368 ($57.57 in chips)
Player#4899: posts small blind $0.10
Player#5368: posts big blind $0.20
*** HOLE CARDS ***
Dealt to warioman [6d Jd]
warioman: folds
Player#4951: folds
Player#1665: folds
Player#7269: raises $0.20 to $0.4
Player#4899: calls $0.30
Player#5368: folds
*** FLOP *** [9s Tc 2h]
Player#4899: checks
Player#7269: checks
*** TURN *** [9s Tc 2h] [Qc]
Player#4899: checks
Player#7269: checks
*** RIVER *** [9s Tc 2h] [Qc] [8c]
Player#4899: checks
Player#7269: checks
*** SHOW DOWN *** 
Player#4899 collected $0.95 from pot
*** SUMMARY ***
Total Pot $1.00 | Rake $0.05
Board [9s Tc 2h Qc 8c]
Seat 1: warioman folded before the flop
Seat 2: Player#4951 folded before the flop
Seat 3: Player#1665 folded before the flop
Seat 4: Player#7269 (button) mucked
Seat 5: Player#4899 shows [8d Ks] and won ($0.95) with 
Seat 6: Player#5368 (big blind) folded before the flop

PokerStars Hand #e614b58a-0536-4c51-8bc6-4cfb491ef6fc:  Hold'em No Limit ($0.1/$0.20 USD) - 2021/11/20 23:20:00 ET
Table 'Denver' 6-max Seat #6 is the button
Seat 1: Player#1225 ($51.81 in chips)
Seat 2: Player#6193 ($3.05 in chips)
Seat 3: Player#1830 ($68.87 in chips)
Seat 4: warioman ($22.68 in chips)
Seat 5: Player#2936 ($43.03 in chips)
Seat 6: Player#0926 ($19.22 in chips)
Player#1225: posts small blind $0.10
Player#6193: posts big blind $0.20
*** HOLE CARDS ***
Dealt to warioman [Jd 2s]
Player#1830: calls $0.20
warioman: folds
Player#2936: folds
Player#0926: folds
Player#1225: calls $0.10
Player#6193: checks
*** FLOP *** [8s 4h Th]
Player#1225: checks
Player#6193: checks
Player#1830: bets $0.40
Player#1225: folds
Player#6193: calls $0.40
*** TURN *** [8s 4h Th] [9c]
Player#6193: checks
Player#1830: bets $2.40
Player#6193: folds
Player#1830: doesn't show hand
Uncalled bet ($2.40) returned to Player#1830
Player#1830 collected $1.33 from pot
*** SUMMARY ***
Total Pot $1.40 | Rake $0.07
Board [8s 4h Th 9c]
Seat 1: Player#1225 (small blind) folded on the flop
Seat 2: Player#6193 (big blind) folded on the turn
Seat 3: Player#1830 shows [] and won ($1.33) with 
Seat 4: warioman folded before the flop
Seat 5: Player#2936 folded before the flop
Seat 6: Player#0926 (button) folded before the flop

PokerStars Hand #34278ff5-49b4-47c4-8601-943dbd67e6db:  Hold'em No Limit ($0.1/$0.20 USD) - 2021/11/20 23:19:00 ET
Table 'Denver' 6-max Seat #5 is the button
Seat 1: Player#0891 ($52.01 in chips)
Seat 2: Player#7266 ($5.50 in chips)
Seat 3: Player#7340 ($69.07 in chips)
Seat 4: warioman ($20.00 in chips)
Seat 5: Player#8712 ($43.03 in chips)
Seat 6: Player#2592 ($19.32 in chips)
Player#2592: posts small blind $0.10
Player#0891: posts big blind $0.20
*** HOLE CARDS ***
Dealt to warioman [Kd 9d]
Player#7266: calls $0.20
Player#7340: calls $0.20
warioman: raises $0.20 to $1.1
Player#8712: folds
Player#2592: folds
Player#0891: folds
Player#7266: calls $0.90
Player#7340: folds
*** FLOP *** [Qc 9s 8h]
Player#7266: checks
warioman: checks
*** TURN *** [Qc 9s 8h] [9c]
Player#7266: bets $1.35
warioman: calls $1.35
*** RIVER *** [Qc 9s 8h] [9c] [3c]
Player#7266: checks
warioman: bets $4.05
Player#7266: folds
warioman: doesn't show hand
Uncalled bet ($4.05) returned to warioman
warioman collected $5.13 from pot
*** SUMMARY ***
Total Pot $5.40 | Rake $0.27
Board [Qc 9s 8h 9c 3c]
Seat 1: Player#0891 (big blind) folded before the flop
Seat 2: Player#7266 folded on the river
Seat 3: Player#7340 folded before the flop
Seat 4: warioman
Seat 5: Player#8712 (button) folded before the flop
Seat 6: Player#2592 (small blind) folded before the flop

PokerStars Hand #b54e6c04-6ca5-4871-bc4f-a35166b57773:  Hold'em No Limit ($0.1/$0.20 USD) - 2021/11/20 23:19:00 ET
Table 'Lacey' 6-max Seat #3 is the button
Seat 1: warioman ($21.72 in chips)
Seat 2: Player#9215 ($15.30 in chips)
Seat 3: Player#6990 ($65.55 in chips)
Seat 4: Player#8714 ($26.87 in chips)
Seat 5: Player#3008 ($48.78 in chips)
Seat 6: Player#1786 ($57.57 in chips)
Player#8714: posts small blind $0.10
Player#3008: posts big blind $0.20
*** HOLE CARDS ***
Dealt to warioman [Jd Ks]
Player#1786: folds
warioman: raises $0.20 to $0.5
Player#9215: folds
Player#6990: calls $0.50
Player#8714: calls $0.40
Player#3008: folds
*** FLOP *** [8d 5c 2c]
Player#8714: checks
warioman: checks
Player#6990: bets $0.85
Player#8714: raises $0.85 to $3.19
warioman: folds
Player#6990: calls $2.34
*** TURN *** [8d 5c 2c] [Ts]
Player#8714: bets $6.06
Player#6990: folds
Player#8714: doesn't show hand
Uncalled bet ($6.06) returned to Player#8714
Player#8714 collected $7.68 from pot
*** SUMMARY ***
Total Pot $8.08 | Rake $0.40
Board [8d 5c 2c Ts]
Seat 1: warioman folded on the flop
Seat 2: Player#9215 folded before the flop
Seat 3: Player#6990 (button) folded on the turn
Seat 4: Player#8714 shows [] and won ($7.68) with 
Seat 5: Player#3008 (big blind) folded before the flop
Seat 6: Player#1786 folded before the flop

PokerStars Hand #6b2f95bf-56e6-47e2-a09c-16917c5ad165:  Hold'em No Limit ($0.1/$0.20 USD) - 2021/11/20 23:18:00 ET
Table 'Denver' 6-max Seat #4 is the button
Seat 1: Player#6385 ($51.54 in chips)
Seat 2: Player#1420 ($5.50 in chips)
Seat 3: Player#0640 ($69.27 in chips)
Seat 4: warioman ($20.00 in chips)
Seat 5: Player#9070 ($43.13 in chips)
Seat 6: Player#6450 ($19.52 in chips)
Player#9070: posts small blind $0.10
Player#6450: posts big blind $0.20
*** HOLE CARDS ***
Dealt to warioman [Jc 4d]
Player#6385: calls $0.20
Player#1420: folds
Player#0640: calls $0.20
warioman: folds
Player#9070: folds
Player#6450: checks
*** FLOP *** [Kh Jh Ac]
Player#6450: checks
Player#6385: checks
Player#0640: checks
*** TURN *** [Kh Jh Ac] [5d]
Player#6450: checks
Player#6385: checks
Player#0640: checks
*** RIVER *** [Kh Jh Ac] [5d] [9d]
Player#6450: checks
Player#6385: checks
Player#0640: checks
*** SHOW DOWN *** 
Player#6385 collected $0.66 from pot
*** SUMMARY ***
Total Pot $0.70 | Rake $0.03
Board [Kh Jh Ac 5d 9d]
Seat 1: Player#6385 shows [2c 2h] and won ($0.66) with 
Seat 2: Player#1420 folded before the flop
Seat 3: Player#0640 mucked
Seat 4: warioman (button) folded before the flop
Seat 5: Player#9070 (small blind) folded before the flop
Seat 6: Player#6450 (big blind) mucked

PokerStars Hand #c81ff67a-c619-43ca-b3c4-3872382bc6a9:  Hold'em No Limit ($0.1/$0.20 USD) - 2021/11/20 23:17:00 ET
Table 'Lacey' 6-max Seat #4 is the button
Seat 1: warioman ($21.72 in chips)
Seat 2: Player#0504 ($7.95 in chips)
Seat 3: Player#8367 ($73.50 in chips)
Seat 4: Player#2255 ($27.07 in chips)
Seat 5: Player#1483 ($48.78 in chips)
Seat 6: Player#9598 ($57.57 in chips)
Player#1483: posts small blind $0.10
Player#8367: posts big blind $0.20
*** HOLE CARDS ***
Dealt to warioman [Kh 6s]
Player#1483 Waiting
Player#9598: folds
warioman: folds
Player#0504: raises $0.20 to $0.4
Player#8367: raises $0.40 to $0.7
Player#2255: folds
Player#0504: calls $0.30
*** FLOP *** [8c 8s 9h]
Player#8367: bets $0.80
Player#0504: raises0.80 to $2
Player#8367: calls $1.20
*** TURN *** [8c 8s 9h] [As]
Player#8367: checks
Player#0504: bets $2.20
Player#8367: calls $2.20
*** RIVER *** [8c 8s 9h] [As] [4s]
Player#8367: bets $10.00
Player#0504: calls $3.05
*** SHOW DOWN *** 
Player#0504 collected $21.90 from pot
*** SUMMARY ***
Total Pot $23.05 | Rake $1.15
Board [8c 8s 9h As 4s]
Seat 1: warioman folded before the flop
Seat 2: Player#0504 shows [8h Th] and won ($21.90) with 
Seat 3: Player#8367 (big blind) mucked
Seat 4: Player#2255 (button) folded before the flop
Seat 5: Player#1483 (small blind) mucked
Seat 6: Player#9598 folded before the flop

PokerStars Hand #84d1c3dc-abd9-452b-8eb2-f9acf7e66bc0:  Hold'em No Limit ($0.1/$0.20 USD) - 2021/11/20 23:17:00 ET
Table 'Denver' 6-max Seat #3 is the button
Seat 1: Player#6064 ($51.74 in chips)
Seat 2: Player#5378 ($5.50 in chips)
Seat 3: Player#1745 ($64.90 in chips)
Seat 4: warioman ($19.80 in chips)
Seat 5: Player#0244 ($43.33 in chips)
Seat 6: Player#5286 ($19.72 in chips)
warioman: posts small blind $0.10
Player#0244: posts big blind $0.20
*** HOLE CARDS ***
Dealt to warioman [Qh As]
Player#5286: calls $0.20
Player#6064: calls $0.20
Player#5378: folds
Player#1745: raises $0.20 to $0.6
warioman: raises $0.60 to $2.4
Player#0244: folds
Player#5286: folds
Player#6064: folds
Player#1745: calls $1.80
*** FLOP *** [9h 5h 7c]
warioman: bets $1.82
Player#1745: raises $1.82 to $5.43
warioman: folds
Player#1745: doesn't show hand
Uncalled bet ($5.43) returned to Player#1745
Player#1745 collected $6.86 from pot
*** SUMMARY ***
Total Pot $7.22 | Rake $0.36
Board [9h 5h 7c]
Seat 1: Player#6064 folded before the flop
Seat 2: Player#5378 folded before the flop
Seat 3: Player#1745 shows [] and won ($6.86) with 
Seat 4: warioman (small blind) folded on the flop
Seat 5: Player#0244 (big blind) folded before the flop
Seat 6: Player#5286 folded before the flop

PokerStars Hand #0ed301e7-7f5c-4bad-ba9c-abf7ba3984d8:  Hold'em No Limit ($0.1/$0.20 USD) - 2021/11/20 23:17:00 ET
Table 'Lacey' 6-max Seat #1 is the button
Seat 1: warioman ($21.17 in chips)
Seat 2: Player#1084 ($8.05 in chips)
Seat 3: Player#5021 ($74.00 in chips)
Seat 4: Player#8814 ($27.07 in chips)
Seat 5: Player#9615 ($57.57 in chips)
Player#1084: posts small blind $0.10
Player#5021: posts big blind $0.20
*** HOLE CARDS ***
Dealt to warioman [Ks Tc]
Player#8814: folds
Player#9615: folds
warioman: raises $0.20 to $0.5
Player#1084: folds
Player#5021: calls $0.30
*** FLOP *** [7h As 6d]
Player#5021: checks
warioman: bets $0.33
Player#5021: folds
warioman: doesn't show hand
Uncalled bet ($0.33) returned to warioman
warioman collected $1.05 from pot
*** SUMMARY ***
Total Pot $1.10 | Rake $0.06
Board [7h As 6d]
Seat 1: warioman (button)
Seat 2: Player#1084 (small blind) folded before the flop
Seat 3: Player#5021 (big blind) folded on the flop
Seat 4: Player#8814 folded before the flop
Seat 5: Player#9615 folded before the flop

PokerStars Hand #4bbca48e-918a-4630-b473-cf0463b2cd8a:  Hold'em No Limit ($0.1/$0.20 USD) - 2021/11/20 23:16:00 ET
Table 'Denver' 6-max Seat #2 is the button
Seat 1: Player#2550 ($53.64 in chips)
Seat 2: Player#0103 ($5.50 in chips)
Seat 3: Player#1222 ($63.00 in chips)
Seat 4: warioman ($20.00 in chips)
Seat 5: Player#3607 ($43.33 in chips)
Seat 6: Player#1466 ($19.72 in chips)
Player#1222: posts small blind $0.10
warioman: posts big blind $0.20
*** HOLE CARDS ***
Dealt to warioman [As 6h]
Player#3607: folds
Player#1466: folds
Player#2550: raises $0.20 to $0.7
Player#0103: folds
Player#1222: calls $0.60
warioman: folds
*** FLOP *** [9s 2c 4h]
Player#1222: bets $0.20
Player#2550: calls $0.20
*** TURN *** [9s 2c 4h] [8s]
Player#1222: bets $1.00
Player#2550: calls $1.00
*** RIVER *** [9s 2c 4h] [8s] [4s]
Player#1222: bets $3.00
Player#2550: folds
Player#1222: doesn't show hand
Uncalled bet ($3.00) returned to Player#1222
Player#1222 collected $3.80 from pot
*** SUMMARY ***
Total Pot $4.00 | Rake $0.20
Board [9s 2c 4h 8s 4s]
Seat 1: Player#2550 folded on the river
Seat 2: Player#0103 (button) folded before the flop
Seat 3: Player#1222 shows [] and won ($3.80) with 
Seat 4: warioman (big blind) folded before the flop
Seat 5: Player#3607 folded before the flop
Seat 6: Player#1466 folded before the flop

PokerStars Hand #5b81ded9-af5a-41e8-9166-e2a9cd2e7439:  Hold'em No Limit ($0.1/$0.20 USD) - 2021/11/20 23:16:00 ET
Table 'Lacey' 6-max Seat #6 is the button
Seat 1: warioman ($21.27 in chips)
Seat 2: Player#0653 ($13.63 in chips)
Seat 3: Player#7943 ($68.88 in chips)
Seat 4: Player#0093 ($27.07 in chips)
Seat 5: Player#2364 ($57.57 in chips)
warioman: posts small blind $0.10
Player#0653: posts big blind $0.20
*** HOLE CARDS ***
Dealt to warioman [6c Jc]
Player#7943: calls $0.20
Player#0093: folds
Player#2364: folds
warioman: folds
Player#0653: raises $0.20 to $0.6
Player#7943: calls $0.40
*** FLOP *** [Qd Qh 8s]
Player#0653: bets $0.60
Player#7943: calls $0.60
*** TURN *** [Qd Qh 8s] [9h]
Player#0653: bets $1.00
Player#7943: calls $1.00
*** RIVER *** [Qd Qh 8s] [9h] [Jh]
Player#0653: checks
Player#7943: bets $3.38
Player#0653: calls $3.38
*** SHOW DOWN *** 
warioman: doesn't show hand
Player#0653: doesn't show hand
Player#7943: doesn't show hand
Player#0093: doesn't show hand
Player#2364: doesn't show hand
Player#7943 collected $10.70 from pot
*** SUMMARY ***
Total Pot $11.26 | Rake $0.56
Board [Qd Qh 8s 9h Jh]
Seat 1: warioman (small blind) folded before the flop
Seat 2: Player#0653 (big blind) mucked
Seat 3: Player#7943 shows [Th 5h] and won ($10.70) with 
Seat 4: Player#0093 folded before the flop
Seat 5: Player#2364 folded before the flop

PokerStars Hand #74a6d1b3-d3f0-4c70-b5d3-2e09c4e57618:  Hold'em No Limit ($0.1/$0.20 USD) - 2021/11/20 23:15:00 ET
Table 'Denver' 6-max Seat #1 is the button
Seat 1: Player#1508 ($53.64 in chips)
Seat 2: Player#1756 ($5.70 in chips)
Seat 3: Player#6802 ($62.63 in chips)
Seat 4: warioman ($20.00 in chips)
Seat 5: Player#8568 ($43.33 in chips)
Seat 6: Player#2406 ($19.92 in chips)
Player#1756: posts small blind $0.10
Player#6802: posts big blind $0.20
*** HOLE CARDS ***
Dealt to warioman [9c 8s]
warioman: folds
Player#8568: folds
Player#2406: calls $0.20
Player#1508: folds
Player#1756: calls $0.10
Player#6802: checks
*** FLOP *** [Js 2c 2h]
Player#1756: checks
Player#6802: checks
Player#2406: checks
*** TURN *** [Js 2c 2h] [6h]
Player#1756: checks
Player#6802: bets $0.20
Player#2406: folds
Player#1756: folds
Player#6802: doesn't show hand
Uncalled bet ($0.20) returned to Player#6802
Player#6802 collected $0.57 from pot
*** SUMMARY ***
Total Pot $0.60 | Rake $0.03
Board [Js 2c 2h 6h]
Seat 1: Player#1508 (button) folded before the flop
Seat 2: Player#1756 (small blind) folded on the turn
Seat 3: Player#6802 shows [] and won ($0.57) with 
Seat 4: warioman folded before the flop
Seat 5: Player#8568 folded before the flop
Seat 6: Player#2406 folded on the turn

PokerStars Hand #6a9532ed-f421-4a5d-a279-f062f5289115:  Hold'em No Limit ($0.1/$0.20 USD) - 2021/11/20 23:15:00 ET
Table 'Lacey' 6-max Seat #4 is the button
Seat 1: warioman ($21.47 in chips)
Seat 2: Player#1703 ($14.03 in chips)
Seat 3: Player#2886 ($67.85 in chips)
Seat 4: Player#8260 ($27.47 in chips)
Seat 5: Player#4331 ($57.67 in chips)
Player#4331: posts small blind $0.10
warioman: posts big blind $0.20
*** HOLE CARDS ***
Dealt to warioman [6h 4d]
Player#1703: raises $0.20 to $0.4
Player#2886: calls $0.40
Player#8260: calls $0.40
Player#4331: folds
warioman: folds
*** FLOP *** [Kd 7c 5s]
Player#1703: checks
Player#2886: checks
Player#8260: checks
*** TURN *** [Kd 7c 5s] [4c]
Player#1703: checks
Player#2886: bets $0.75
Player#8260: folds
Player#1703: folds
Player#2886: doesn't show hand
Uncalled bet ($0.75) returned to Player#2886
Player#2886 collected $1.43 from pot
*** SUMMARY ***
Total Pot $1.50 | Rake $0.08
Board [Kd 7c 5s 4c]
Seat 1: warioman (big blind) folded before the flop
Seat 2: Player#1703 folded on the turn
Seat 3: Player#2886 shows [] and won ($1.43) with 
Seat 4: Player#8260 (button) folded on the turn
Seat 5: Player#4331 (small blind) folded before the flop

PokerStars Hand #42c27fd0-d88d-4e24-bc58-cc35548b5cea:  Hold'em No Limit ($0.1/$0.20 USD) - 2021/11/20 23:14:00 ET
Table 'Lacey' 6-max Seat #3 is the button
Seat 1: warioman ($21.47 in chips)
Seat 2: Player#8203 ($14.03 in chips)
Seat 3: Player#1035 ($67.85 in chips)
Seat 4: Player#7371 ($27.57 in chips)
Seat 5: Player#9402 ($57.57 in chips)
Player#7371: posts small blind $0.10
Player#9402: posts big blind $0.20
*** HOLE CARDS ***
Dealt to warioman [6s Qs]
warioman: folds
Player#8203: folds
Player#1035: folds
Player#7371: folds
Player#9402 collected $0.20 from pot
*** SUMMARY ***
Total Pot $0.20 | Rake $0.00
Seat 1: warioman folded before the flop
Seat 2: Player#8203 folded before the flop
Seat 3: Player#1035 (button) folded before the flop
Seat 4: Player#7371 (small blind) folded before the flop
Seat 5: Player#9402 shows [] and won ($0.20) with 

PokerStars Hand #98ec44cd-df4b-4e2f-9dcd-cd27364a651f:  Hold'em No Limit ($0.1/$0.20 USD) - 2021/11/20 23:14:00 ET
Table 'Lacey' 6-max Seat #2 is the button
Seat 1: warioman ($21.47 in chips)
Seat 2: Player#6389 ($14.03 in chips)
Seat 3: Player#8781 ($67.95 in chips)
Seat 4: Player#5918 ($27.47 in chips)
Seat 5: Player#1903 ($57.57 in chips)
Player#8781: posts small blind $0.10
Player#5918: posts big blind $0.20
*** HOLE CARDS ***
Dealt to warioman [2s 5d]
Player#1903: folds
warioman: folds
Player#6389: folds
Player#8781: folds
Player#5918 collected $0.20 from pot
*** SUMMARY ***
Total Pot $0.20 | Rake $0.00
Seat 1: warioman folded before the flop
Seat 2: Player#6389 (button) folded before the flop
Seat 3: Player#8781 (small blind) folded before the flop
Seat 4: Player#5918 shows [] and won ($0.20) with 
Seat 5: Player#1903 folded before the flop

PokerStars Hand #633c94cd-9abe-4b25-a11f-c32a0b5c069d:  Hold'em No Limit ($0.1/$0.20 USD) - 2021/11/20 23:14:00 ET
Table 'Denver' 6-max Seat #6 is the button
Seat 1: Player#9318 ($53.74 in chips)
Seat 2: Player#6951 ($5.90 in chips)
Seat 3: Player#8340 ($64.60 in chips)
Seat 4: warioman ($20.00 in chips)
Seat 5: Player#9041 ($43.33 in chips)
Seat 6: Player#0510 ($17.86 in chips)
Player#9318: posts small blind $0.10
Player#6951: posts big blind $0.20
*** HOLE CARDS ***
Dealt to warioman [8s 5s]
Player#8340: raises $0.20 to $0.7
warioman: folds
Player#9041: folds
Player#0510: calls $0.70
Player#9318: folds
Player#6951: folds
*** FLOP *** [7d Js 7s]
Player#8340: checks
Player#0510: checks
*** TURN *** [7d Js 7s] [4d]
Player#8340: bets $1.27
Player#0510: calls $1.27
*** RIVER *** [7d Js 7s] [4d] [2d]
Player#8340: checks
Player#0510: checks
*** SHOW DOWN *** 
Player#0510 collected $4.03 from pot
*** SUMMARY ***
Total Pot $4.24 | Rake $0.21
Board [7d Js 7s 4d 2d]
Seat 1: Player#9318 (small blind) folded before the flop
Seat 2: Player#6951 (big blind) folded before the flop
Seat 3: Player#8340 mucked
Seat 4: warioman folded before the flop
Seat 5: Player#9041 folded before the flop
Seat 6: Player#0510 shows [4s Qs] and won ($4.03) with 

PokerStars Hand #c69b857f-3d5a-436e-be5e-71356dbdc3aa:  Hold'em No Limit ($0.1/$0.20 USD) - 2021/11/20 23:13:00 ET
Table 'Denver' 6-max Seat #5 is the button
Seat 1: Player#2651 ($53.94 in chips)
Seat 2: Player#6767 ($5.90 in chips)
Seat 3: Player#7020 ($66.37 in chips)
Seat 4: warioman ($19.40 in chips)
Seat 5: Player#8107 ($43.33 in chips)
Seat 6: Player#3306 ($14.39 in chips)
Player#3306: posts small blind $0.10
Player#2651: posts big blind $0.20
*** HOLE CARDS ***
Dealt to warioman [Kd Jd]
Player#6767: folds
Player#7020: calls $0.20
warioman: raises $0.20 to $0.9
Player#8107: folds
Player#3306: calls $0.80
Player#2651: folds
Player#7020: calls $0.70
*** FLOP *** [Js 2d Th]
Player#3306: checks
Player#7020: checks
warioman: bets $0.87
Player#3306: calls $0.87
Player#7020: calls $0.87
*** TURN *** [Js 2d Th] [9c]
Player#3306: checks
Player#7020: checks
warioman: checks
*** RIVER *** [Js 2d Th] [9c] [6c]
Player#3306: bets $5.51
Player#7020: folds
warioman: folds
Player#3306: doesn't show hand
Uncalled bet ($5.51) returned to Player#3306
Player#3306 collected $5.23 from pot
*** SUMMARY ***
Total Pot $5.51 | Rake $0.28
Board [Js 2d Th 9c 6c]
Seat 1: Player#2651 (big blind) folded before the flop
Seat 2: Player#6767 folded before the flop
Seat 3: Player#7020 folded on the river
Seat 4: warioman folded on the river
Seat 5: Player#8107 (button) folded before the flop
Seat 6: Player#3306 shows [] and won ($5.23) with 

PokerStars Hand #2ef3b166-6197-4cd0-a415-6942ede5afae:  Hold'em No Limit ($0.1/$0.20 USD) - 2021/11/20 23:13:00 ET
Table 'Lacey' 6-max Seat #1 is the button
Seat 1: warioman ($21.47 in chips)
Seat 2: Player#2549 ($14.23 in chips)
Seat 3: Player#2949 ($74.25 in chips)
Seat 4: Player#9440 ($27.47 in chips)
Seat 5: Player#1581 ($51.71 in chips)
Player#2549: posts small blind $0.10
Player#2949: posts big blind $0.20
*** HOLE CARDS ***
Dealt to warioman [3d Ks]
Player#9440: folds
Player#1581: calls $0.20
warioman: folds
Player#2549: calls $0.10
Player#2949: checks
*** FLOP *** [Ac 5h As]
Player#2549: checks
Player#2949: checks
Player#1581: checks
*** TURN *** [Ac 5h As] [2c]
Player#2549: checks
Player#2949: bets $0.60
Player#1581: raises $0.60 to $2.4
Player#2549: folds
Player#2949: calls $1.80
*** RIVER *** [Ac 5h As] [2c] [6c]
Player#2949: checks
Player#1581: bets $3.70
Player#2949: calls $3.70
*** SHOW DOWN *** 
Player#2949: doesn't show hand
Player#1581 collected $12.16 from pot
*** SUMMARY ***
Total Pot $12.80 | Rake $0.64
Board [Ac 5h As 2c 6c]
Seat 1: warioman (button) folded before the flop
Seat 2: Player#2549 (small blind) folded on the turn
Seat 3: Player#2949 (big blind) mucked
Seat 4: Player#9440 folded before the flop
Seat 5: Player#1581 shows [4c 3c] and won ($12.16) with 

PokerStars Hand #97cb97a8-6f33-43af-a80f-bdae9c085c9b:  Hold'em No Limit ($0.1/$0.20 USD) - 2021/11/20 23:12:00 ET
Table 'Lacey' 6-max Seat #6 is the button
Seat 1: warioman ($21.29 in chips)
Seat 2: Player#5163 ($14.43 in chips)
Seat 3: Player#4204 ($74.25 in chips)
Seat 4: Player#6157 ($27.47 in chips)
Seat 5: Player#9488 ($51.71 in chips)
warioman: posts small blind $0.10
Player#5163: posts big blind $0.20
*** HOLE CARDS ***
Dealt to warioman [6c Qc]
Player#4204: folds
Player#6157: folds
Player#9488: folds
warioman: calls $0.10
Player#5163: checks
*** FLOP *** [6h Tc 2d]
warioman: checks
Player#5163: checks
*** TURN *** [6h Tc 2d] [Ah]
warioman: checks
Player#5163: checks
*** RIVER *** [6h Tc 2d] [Ah] [Th]
warioman: checks
Player#5163: checks
*** SHOW DOWN *** 
warioman collected $0.38 from pot
*** SUMMARY ***
Total Pot $0.40 | Rake $0.02
Board [6h Tc 2d Ah Th]
Seat 1: warioman (small blind)
Seat 2: Player#5163 (big blind) mucked
Seat 3: Player#4204 folded before the flop
Seat 4: Player#6157 folded before the flop
Seat 5: Player#9488 folded before the flop

PokerStars Hand #ea2ba26c-e729-47c4-a002-cf3797581606:  Hold'em No Limit ($0.1/$0.20 USD) - 2021/11/20 23:12:00 ET
Table 'Denver' 6-max Seat #3 is the button
Seat 1: Player#5120 ($6.80 in chips)
Seat 2: Player#3402 ($68.67 in chips)
Seat 3: warioman ($19.40 in chips)
Seat 4: Player#5424 ($43.43 in chips)
Seat 5: Player#6734 ($11.37 in chips)
Player#5424: posts small blind $0.10
Player#6734: posts big blind $0.20
*** HOLE CARDS ***
Dealt to warioman [Td Jh]
Player#5120: calls $0.20
Player#3402: raises $0.20 to $0.9
warioman: folds
Player#5424: folds
Player#6734: calls $0.70
Player#5120: calls $0.70
*** FLOP *** [Kc 4s 6s]
Player#6734: checks
Player#5120: checks
Player#3402: bets $1.40
Player#6734: calls $1.40
Player#5120: folds
*** TURN *** [Kc 4s 6s] [5c]
Player#6734: checks
Player#3402: checks
*** RIVER *** [Kc 4s 6s] [5c] [3c]
Player#6734: bets $2.80
Player#3402: folds
Player#6734: doesn't show hand
Uncalled bet ($2.80) returned to Player#6734
Player#6734 collected $5.32 from pot
*** SUMMARY ***
Total Pot $5.60 | Rake $0.28
Board [Kc 4s 6s 5c 3c]
Seat 1: Player#5120 folded on the flop
Seat 2: Player#3402 folded on the river
Seat 3: warioman (button) folded before the flop
Seat 4: Player#5424 (small blind) folded before the flop
Seat 5: Player#6734 shows [] and won ($5.32) with 

PokerStars Hand #8e072f2a-f3f1-47e8-9133-c47877e11e45:  Hold'em No Limit ($0.1/$0.20 USD) - 2021/11/20 23:12:00 ET
Table 'Denver' 6-max Seat #2 is the button
Seat 1: Player#6900 ($6.80 in chips)
Seat 2: Player#0314 ($67.39 in chips)
Seat 3: warioman ($19.50 in chips)
Seat 4: Player#3800 ($43.63 in chips)
Seat 5: Player#4712 ($12.47 in chips)
warioman: posts small blind $0.10
Player#3800: posts big blind $0.20
*** HOLE CARDS ***
Dealt to warioman [7s 3d]
Player#4712: calls $0.20
Player#6900: folds
Player#0314: raises $0.20 to $1.1
warioman: folds
Player#3800: folds
Player#4712: calls $0.90
*** FLOP *** [Ad Kc Ts]
Player#4712: checks
Player#0314: bets $2.50
Player#4712: folds
Player#0314: doesn't show hand
Uncalled bet ($2.50) returned to Player#0314
Player#0314 collected $2.38 from pot
*** SUMMARY ***
Total Pot $2.50 | Rake $0.12
Board [Ad Kc Ts]
Seat 1: Player#6900 folded before the flop
Seat 2: Player#0314 shows [] and won ($2.38) with 
Seat 3: warioman (small blind) folded before the flop
Seat 4: Player#3800 (big blind) folded before the flop
Seat 5: Player#4712 folded on the flop

PokerStars Hand #9cfa2f0a-750d-493f-af05-b940193dd1e2:  Hold'em No Limit ($0.1/$0.20 USD) - 2021/11/20 23:11:00 ET
Table 'Lacey' 6-max Seat #4 is the button
Seat 1: warioman ($21.49 in chips)
Seat 2: Player#7748 ($15.43 in chips)
Seat 3: Player#9364 ($74.25 in chips)
Seat 4: Player#8146 ($27.47 in chips)
Seat 5: Player#6878 ($50.62 in chips)
Player#6878: posts small blind $0.10
warioman: posts big blind $0.20
*** HOLE CARDS ***
Dealt to warioman [As 3c]
Player#7748: raises $0.20 to $0.4
Player#9364: folds
Player#8146: folds
Player#6878: calls $0.30
warioman: folds
*** FLOP *** [5s 4d 2c]
Player#6878: checks
Player#7748: checks
*** TURN *** [5s 4d 2c] [Ks]
Player#6878: bets $0.60
Player#7748: calls $0.60
*** RIVER *** [5s 4d 2c] [Ks] [Ks]
Player#6878: checks
Player#7748: checks
*** SHOW DOWN *** 
Player#6878 collected $2.09 from pot
*** SUMMARY ***
Total Pot $2.20 | Rake $0.11
Board [5s 4d 2c Ks Ks]
Seat 1: warioman (big blind) folded before the flop
Seat 2: Player#7748 mucked
Seat 3: Player#9364 folded before the flop
Seat 4: Player#8146 (button) folded before the flop
Seat 5: Player#6878 shows [Kc Js] and won ($2.09) with 

PokerStars Hand #76ccba28-c6e7-41df-9ce8-1719336cd417:  Hold'em No Limit ($0.1/$0.20 USD) - 2021/11/20 23:11:00 ET
Table 'Denver' 6-max Seat #2 is the button
Seat 1: Player#7346 ($53.94 in chips)
Seat 2: Player#2724 ($6.80 in chips)
Seat 3: Player#6067 ($67.02 in chips)
Seat 4: warioman ($19.70 in chips)
Seat 5: Player#9808 ($43.63 in chips)
Seat 6: Player#9413 ($12.67 in chips)
Player#6067: posts small blind $0.10
warioman: posts big blind $0.20
*** HOLE CARDS ***
Dealt to warioman [Js Kd]
Player#7346 Decline Entry Bet
Player#9808: folds
Player#9413: calls $0.20
Player#2724: folds
Player#6067: calls $0.10
warioman: checks
*** FLOP *** [6s 3d Qd]
Player#6067: bets $0.20
warioman: folds
Player#9413: folds
Player#6067: doesn't show hand
Uncalled bet ($0.20) returned to Player#6067
Player#6067 collected $0.57 from pot
*** SUMMARY ***
Total Pot $0.60 | Rake $0.03
Board [6s 3d Qd]
Seat 1: Player#7346 mucked
Seat 2: Player#2724 (button) folded before the flop
Seat 3: Player#6067 shows [] and won ($0.57) with 
Seat 4: warioman (big blind) folded on the flop
Seat 5: Player#9808 folded before the flop
Seat 6: Player#9413 folded on the flop

PokerStars Hand #829f5fd0-c9bd-408f-afec-eb056ed038c6:  Hold'em No Limit ($0.1/$0.20 USD) - 2021/11/20 23:11:00 ET
Table 'Lacey' 6-max Seat #3 is the button
Seat 1: warioman ($21.49 in chips)
Seat 2: Player#8825 ($15.43 in chips)
Seat 3: Player#7632 ($74.25 in chips)
Seat 4: Player#4366 ($27.29 in chips)
Seat 5: Player#5322 ($48.78 in chips)
Seat 6: Player#2122 ($50.82 in chips)
Player#4366: posts small blind $0.10
Player#2122: posts big blind $0.20
*** HOLE CARDS ***
Dealt to warioman [8h Ts]
Player#5322 Decline Entry Bet
warioman: folds
Player#8825: folds
Player#7632: folds
Player#4366: calls $0.10
Player#2122: checks
*** FLOP *** [3c Ah 7d]
Player#4366: checks
Player#2122: checks
*** TURN *** [3c Ah 7d] [Js]
Player#4366: checks
Player#2122: checks
*** RIVER *** [3c Ah 7d] [Js] [7s]
Player#4366: checks
Player#2122: checks
*** SHOW DOWN *** 
Player#4366 collected $0.38 from pot
*** SUMMARY ***
Total Pot $0.40 | Rake $0.02
Board [3c Ah 7d Js 7s]
Seat 1: warioman folded before the flop
Seat 2: Player#8825 folded before the flop
Seat 3: Player#7632 (button) folded before the flop
Seat 4: Player#4366 shows [5h Kh] and won ($0.38) with 
Seat 5: Player#5322 mucked
Seat 6: Player#2122 (big blind) mucked

PokerStars Hand #98659b35-4781-4aa1-b3e0-564c3e2199f2:  Hold'em No Limit ($0.1/$0.20 USD) - 2021/11/20 23:10:00 ET
Table 'Lacey' 6-max Seat #2 is the button
Seat 1: warioman ($21.49 in chips)
Seat 2: Player#3692 ($15.43 in chips)
Seat 3: Player#0428 ($74.07 in chips)
Seat 4: Player#6374 ($27.49 in chips)
Seat 5: Player#3635 ($50.82 in chips)
Player#0428: posts small blind $0.10
Player#6374: posts big blind $0.20
*** HOLE CARDS ***
Dealt to warioman [4c 8c]
Player#3635: folds
warioman: folds
Player#3692: folds
Player#0428: calls $0.10
Player#6374: checks
*** FLOP *** [7h 4h 3s]
Player#0428: checks
Player#6374: checks
*** TURN *** [7h 4h 3s] [8h]
Player#0428: bets $1.00
Player#6374: folds
Player#0428: doesn't show hand
Uncalled bet ($1.00) returned to Player#0428
Player#0428 collected $0.38 from pot
*** SUMMARY ***
Total Pot $0.40 | Rake $0.02
Board [7h 4h 3s 8h]
Seat 1: warioman folded before the flop
Seat 2: Player#3692 (button) folded before the flop
Seat 3: Player#0428 shows [] and won ($0.38) with 
Seat 4: Player#6374 (big blind) folded on the turn
Seat 5: Player#3635 folded before the flop

PokerStars Hand #7937430c-649c-4c05-b6f9-5f68e6e9abe9:  Hold'em No Limit ($0.1/$0.20 USD) - 2021/11/20 23:10:00 ET
Table 'Denver' 6-max Seat #6 is the button
Seat 1: Player#3983 ($7.60 in chips)
Seat 2: Player#0705 ($70.22 in chips)
Seat 3: warioman ($19.70 in chips)
Seat 4: Player#2969 ($43.63 in chips)
Seat 5: Player#0541 ($9.03 in chips)
Player#3983: posts small blind $0.10
Player#0705: posts big blind $0.20
*** HOLE CARDS ***
Dealt to warioman [4s Kh]
warioman: folds
Player#2969: folds
Player#0541: calls $0.20
Player#3983: raises $0.20 to $0.4
Player#0705: raises $0.40 to $0.8
Player#0541: calls $0.60
Player#3983: calls $0.40
*** FLOP *** [5h As 3d]
Player#3983: checks
Player#0705: bets $0.60
Player#0541: calls $0.60
Player#3983: folds
*** TURN *** [5h As 3d] [3h]
Player#0705: bets $1.80
Player#0541: calls $1.80
*** RIVER *** [5h As 3d] [3h] [2h]
Player#0705: checks
Player#0541: bets $5.83
Player#0705: folds
Player#0541: doesn't show hand
Uncalled bet ($5.83) returned to Player#0541
Player#0541 collected $6.84 from pot
*** SUMMARY ***
Total Pot $7.20 | Rake $0.36
Board [5h As 3d 3h 2h]
Seat 1: Player#3983 (small blind) folded on the flop
Seat 2: Player#0705 (big blind) folded on the river
Seat 3: warioman folded before the flop
Seat 4: Player#2969 folded before the flop
Seat 5: Player#0541 shows [] and won ($6.84) with 

PokerStars Hand #eb2582b4-c0b8-45ea-9f93-8350d4e098c1:  Hold'em No Limit ($0.1/$0.20 USD) - 2021/11/20 23:10:00 ET
Table 'Denver' 6-max Seat #4 is the button
Seat 1: Player#4352 ($7.80 in chips)
Seat 2: Player#3935 ($69.92 in chips)
Seat 3: warioman ($19.70 in chips)
Seat 4: Player#1568 ($43.63 in chips)
Seat 5: Player#2715 ($9.13 in chips)
Player#2715: posts small blind $0.10
Player#4352: posts big blind $0.20
*** HOLE CARDS ***
Dealt to warioman [5c Kd]
Player#3935: raises $0.20 to $0.8
warioman: folds
Player#1568: folds
Player#2715: folds
Player#4352: folds
Player#3935: doesn't show hand
Uncalled bet ($0.80) returned to Player#3935
Player#3935 collected $0.30 from pot
*** SUMMARY ***
Total Pot $0.30 | Rake $0.00
Seat 1: Player#4352 (big blind) folded before the flop
Seat 2: Player#3935 shows [] and won ($0.30) with 
Seat 3: warioman folded before the flop
Seat 4: Player#1568 (button) folded before the flop
Seat 5: Player#2715 (small blind) folded before the flop

PokerStars Hand #441e4334-eb43-4055-a10a-0fa355575609:  Hold'em No Limit ($0.1/$0.20 USD) - 2021/11/20 23:09:00 ET
Table 'Denver' 6-max Seat #3 is the button
Seat 1: Player#4671 ($7.80 in chips)
Seat 2: Player#1613 ($69.92 in chips)
Seat 3: warioman ($19.70 in chips)
Seat 4: Player#5912 ($43.43 in chips)
Seat 5: Player#0592 ($9.33 in chips)
Player#5912: posts small blind $0.10
Player#0592: posts big blind $0.20
*** HOLE CARDS ***
Dealt to warioman [8s Kd]
Player#4671: folds
Player#1613: folds
warioman: folds
Player#5912: raises $0.20 to $0.6
Player#0592: folds
Player#5912: doesn't show hand
Uncalled bet ($0.60) returned to Player#5912
Player#5912 collected $0.20 from pot
*** SUMMARY ***
Total Pot $0.20 | Rake $0.00
Seat 1: Player#4671 folded before the flop
Seat 2: Player#1613 folded before the flop
Seat 3: warioman (button) folded before the flop
Seat 4: Player#5912 shows [] and won ($0.20) with 
Seat 5: Player#0592 (big blind) folded before the flop

PokerStars Hand #7370ddd9-c0dd-49e0-adf8-9d8a643b78d5:  Hold'em No Limit ($0.1/$0.20 USD) - 2021/11/20 23:09:00 ET
Table 'Lacey' 6-max Seat #1 is the button
Seat 1: warioman ($21.49 in chips)
Seat 2: Player#1201 ($15.53 in chips)
Seat 3: Player#5423 ($76.14 in chips)
Seat 4: Player#2314 ($25.53 in chips)
Seat 5: Player#1470 ($20.25 in chips)
Seat 6: Player#2185 ($50.82 in chips)
Player#1201: posts small blind $0.10
Player#5423: posts big blind $0.20
*** HOLE CARDS ***
Dealt to warioman [4d Kh]
Player#2314: raises $0.20 to $0.4
Player#1470: folds
Player#2185: folds
warioman: folds
Player#1201: folds
Player#5423: calls $0.20
*** FLOP *** [2c Qs 8d]
Player#5423: checks
Player#2314: bets $0.40
Player#5423: calls $0.40
*** TURN *** [2c Qs 8d] [6d]
Player#5423: checks
Player#2314: bets $1.27
Player#5423: calls $1.27
*** RIVER *** [2c Qs 8d] [6d] [9d]
Player#5423: checks
Player#2314: bets $4.24
Player#5423: folds
Player#2314: doesn't show hand
Uncalled bet ($4.24) returned to Player#2314
Player#2314 collected $4.03 from pot
*** SUMMARY ***
Total Pot $4.24 | Rake $0.21
Board [2c Qs 8d 6d 9d]
Seat 1: warioman (button) folded before the flop
Seat 2: Player#1201 (small blind) folded before the flop
Seat 3: Player#5423 (big blind) folded on the river
Seat 4: Player#2314 shows [] and won ($4.03) with 
Seat 5: Player#1470 folded before the flop
Seat 6: Player#2185 folded before the flop

PokerStars Hand #2b25563f-f9ea-4e4f-b7b8-f50073dc4ef8:  Hold'em No Limit ($0.1/$0.20 USD) - 2021/11/20 23:09:00 ET
Table 'Denver' 6-max Seat #2 is the button
Seat 1: Player#8391 ($8.00 in chips)
Seat 2: Player#8567 ($68.54 in chips)
Seat 3: warioman ($19.80 in chips)
Seat 4: Player#5162 ($43.63 in chips)
Seat 5: Player#8656 ($10.33 in chips)
warioman: posts small blind $0.10
Player#5162: posts big blind $0.20
*** HOLE CARDS ***
Dealt to warioman [5s 2c]
Player#8391 Entry Bet 0.2
Player#8656: calls $0.20
Player#8391: checks
Player#8567: raises0.20 to $1
warioman: folds
Player#5162: folds
Player#8656: calls $0.80
Player#8391: folds
*** FLOP *** [Kh 5c 5d]
Player#8656: checks
Player#8567: bets $1.25
Player#8656: folds
Player#8567: doesn't show hand
Uncalled bet ($1.25) returned to Player#8567
Player#8567 collected $2.18 from pot
*** SUMMARY ***
Total Pot $2.30 | Rake $0.11
Board [Kh 5c 5d]
Seat 1: Player#8391 folded before the flop
Seat 2: Player#8567 shows [] and won ($2.18) with 
Seat 3: warioman (small blind) folded before the flop
Seat 4: Player#5162 (big blind) folded before the flop
Seat 5: Player#8656 folded on the flop

PokerStars Hand #5b45ef8a-4edb-4273-ac24-05e509ef81d8:  Hold'em No Limit ($0.1/$0.20 USD) - 2021/11/20 23:09:00 ET
Table 'Lacey' 6-max Seat #6 is the button
Seat 1: warioman ($21.59 in chips)
Seat 2: Player#9093 ($15.43 in chips)
Seat 3: Player#4481 ($76.14 in chips)
Seat 4: Player#0860 ($25.53 in chips)
Seat 5: Player#4336 ($20.25 in chips)
Seat 6: Player#5162 ($50.82 in chips)
warioman: posts small blind $0.10
Player#9093: posts big blind $0.20
*** HOLE CARDS ***
Dealt to warioman [2s 9d]
Player#4481: folds
Player#0860: folds
Player#4336: folds
Player#5162: folds
warioman: folds
Player#9093 collected $0.20 from pot
*** SUMMARY ***
Total Pot $0.20 | Rake $0.00
Seat 1: warioman (small blind) folded before the flop
Seat 2: Player#9093 shows [] and won ($0.20) with 
Seat 3: Player#4481 folded before the flop
Seat 4: Player#0860 folded before the flop
Seat 5: Player#4336 folded before the flop
Seat 6: Player#5162 (button) folded before the flop

PokerStars Hand #9b42905a-f83a-4a9c-8c45-ed38082e3b02:  Hold'em No Limit ($0.1/$0.20 USD) - 2021/11/20 23:08:00 ET
Table 'Lacey' 6-max Seat #5 is the button
Seat 1: warioman ($21.79 in chips)
Seat 2: Player#7859 ($15.13 in chips)
Seat 3: Player#4706 ($76.14 in chips)
Seat 4: Player#2787 ($25.53 in chips)
Seat 5: Player#6298 ($20.25 in chips)
Seat 6: Player#3470 ($50.92 in chips)
Player#3470: posts small blind $0.10
warioman: posts big blind $0.20
*** HOLE CARDS ***
Dealt to warioman [2s Qh]
Player#7859: raises $0.20 to $0.4
Player#4706: folds
Player#2787: folds
Player#6298: folds
Player#3470: folds
warioman: folds
warioman: doesn't show hand
Player#7859: doesn't show hand
Player#4706: doesn't show hand
Player#2787: doesn't show hand
Player#6298: doesn't show hand
Player#3470: doesn't show hand
Uncalled bet ($0.40) returned to Player#7859
Player#7859 collected $0.30 from pot
*** SUMMARY ***
Total Pot $0.30 | Rake $0.00
Seat 1: warioman (big blind) folded before the flop
Seat 2: Player#7859 shows [] and won ($0.30) with 
Seat 3: Player#4706 folded before the flop
Seat 4: Player#2787 folded before the flop
Seat 5: Player#6298 (button) folded before the flop
Seat 6: Player#3470 (small blind) folded before the flop

PokerStars Hand #18e435ae-0a73-4764-a37f-0e2efe3f020b:  Hold'em No Limit ($0.1/$0.20 USD) - 2021/11/20 23:08:00 ET
Table 'Denver' 6-max Seat #1 is the button
Seat 1: Player#7357 ($8.00 in chips)
Seat 2: Player#0123 ($65.20 in chips)
Seat 3: warioman ($20.00 in chips)
Seat 4: Player#1845 ($43.63 in chips)
Seat 5: Player#5128 ($13.83 in chips)
Player#0123: posts small blind $0.10
warioman: posts big blind $0.20
*** HOLE CARDS ***
Dealt to warioman [3h Ac]
Player#1845: folds
Player#5128: calls $0.20
Player#0123: raises $0.20 to $0.8
warioman: folds
Player#5128: calls $0.60
*** FLOP *** [Kd Jd 8d]
Player#0123: bets $0.90
Player#5128: calls $0.90
*** TURN *** [Kd Jd 8d] [5h]
Player#0123: bets $1.80
Player#5128: calls $1.80
*** RIVER *** [Kd Jd 8d] [5h] [6h]
Player#0123: checks
Player#5128: checks
*** SHOW DOWN *** 
Player#0123 collected $6.84 from pot
*** SUMMARY ***
Total Pot $7.20 | Rake $0.36
Board [Kd Jd 8d 5h 6h]
Seat 1: Player#7357 (button) mucked
Seat 2: Player#0123 shows [Qd Qh] and won ($6.84) with 
Seat 3: warioman (big blind) folded before the flop
Seat 4: Player#1845 folded before the flop
Seat 5: Player#5128 mucked

PokerStars Hand #43730bfb-09ca-4e5e-a76b-11691c94cc91:  Hold'em No Limit ($0.1/$0.20 USD) - 2021/11/20 23:07:00 ET
Table 'Lacey' 6-max Seat #4 is the button
Seat 1: warioman ($21.79 in chips)
Seat 2: Player#5831 ($15.13 in chips)
Seat 3: Player#8454 ($77.87 in chips)
Seat 4: Player#3731 ($23.68 in chips)
Seat 5: Player#2355 ($20.35 in chips)
Seat 6: Player#9642 ($51.12 in chips)
Player#2355: posts small blind $0.10
Player#9642: posts big blind $0.20
*** HOLE CARDS ***
Dealt to warioman [Qc Jh]
warioman: folds
Player#5831: folds
Player#8454: raises $0.20 to $0.6
Player#3731: calls $0.60
Player#2355: folds
Player#9642: folds
*** FLOP *** [4c Kc Ac]
Player#8454: checks
Player#3731: checks
*** TURN *** [4c Kc Ac] [Ks]
Player#8454: checks
Player#3731: bets $1.13
Player#8454: calls $1.13
*** RIVER *** [4c Kc Ac] [Ks] [6s]
Player#8454: checks
Player#3731: bets $3.76
Player#8454: folds
Player#3731: doesn't show hand
Uncalled bet ($3.76) returned to Player#3731
Player#3731 collected $3.57 from pot
*** SUMMARY ***
Total Pot $3.76 | Rake $0.19
Board [4c Kc Ac Ks 6s]
Seat 1: warioman folded before the flop
Seat 2: Player#5831 folded before the flop
Seat 3: Player#8454 folded on the river
Seat 4: Player#3731 shows [] and won ($3.57) with 
Seat 5: Player#2355 (small blind) folded before the flop
Seat 6: Player#9642 (big blind) folded before the flop

PokerStars Hand #9a454599-8ab5-485c-8940-427024460a29:  Hold'em No Limit ($0.1/$0.20 USD) - 2021/11/20 23:07:00 ET
Table 'Denver' 6-max Seat #4 is the button
Seat 1: Player#3174 ($53.94 in chips)
Seat 2: Player#9586 ($63.40 in chips)
Seat 3: warioman ($20.00 in chips)
Seat 4: Player#5661 ($43.63 in chips)
Seat 5: Player#9006 ($15.83 in chips)
Player#9006: posts small blind $0.10
Player#9586: posts big blind $0.20
*** HOLE CARDS ***
Dealt to warioman [Qs 7h]
Player#3174 Decline Entry Bet
warioman: folds
Player#5661: folds
Player#9006: calls $0.10
Player#9586: raises $0.20 to $0.8
Player#9006: calls $0.60
*** FLOP *** [9h 8s Td]
Player#9006: checks
Player#9586: bets $1.20
Player#9006: calls $1.20
*** TURN *** [9h 8s Td] [2c]
Player#9006: checks
Player#9586: bets $2.00
Player#9006: folds
Player#9586: doesn't show hand
Uncalled bet ($2.00) returned to Player#9586
Player#9586 collected $3.80 from pot
*** SUMMARY ***
Total Pot $4.00 | Rake $0.20
Board [9h 8s Td 2c]
Seat 1: Player#3174 mucked
Seat 2: Player#9586 shows [] and won ($3.80) with 
Seat 3: warioman folded before the flop
Seat 4: Player#5661 (button) folded before the flop
Seat 5: Player#9006 (small blind) folded on the turn

PokerStars Hand #deb8e894-0c74-417e-8707-824681b5a7a6:  Hold'em No Limit ($0.1/$0.20 USD) - 2021/11/20 23:07:00 ET
Table 'Lacey' 6-max Seat #3 is the button
Seat 1: warioman ($21.79 in chips)
Seat 2: Player#2092 ($15.13 in chips)
Seat 3: Player#3696 ($77.87 in chips)
Seat 4: Player#9237 ($23.78 in chips)
Seat 5: Player#6241 ($20.55 in chips)
Seat 6: Player#3738 ($50.82 in chips)
Player#9237: posts small blind $0.10
Player#6241: posts big blind $0.20
*** HOLE CARDS ***
Dealt to warioman [Ks 3d]
Player#3738: raises $0.20 to $0.6
warioman: folds
Player#2092: folds
Player#3696: folds
Player#9237: folds
Player#6241: folds
Player#3738: doesn't show hand
Uncalled bet ($0.60) returned to Player#3738
Player#3738 collected $0.30 from pot
*** SUMMARY ***
Total Pot $0.30 | Rake $0.00
Seat 1: warioman folded before the flop
Seat 2: Player#2092 folded before the flop
Seat 3: Player#3696 (button) folded before the flop
Seat 4: Player#9237 (small blind) folded before the flop
Seat 5: Player#6241 (big blind) folded before the flop
Seat 6: Player#3738 shows [] and won ($0.30) with 

PokerStars Hand #e3e2b057-48e3-43e1-a316-d5eef3cb8241:  Hold'em No Limit ($0.1/$0.20 USD) - 2021/11/20 23:07:00 ET
Table 'Denver' 6-max Seat #6 is the button
Seat 1: Player#9931 ($53.94 in chips)
Seat 2: Player#9035 ($63.40 in chips)
Seat 3: warioman ($20.00 in chips)
Seat 4: Player#5684 ($43.73 in chips)
Seat 5: Player#1074 ($15.73 in chips)
Player#9931: posts small blind $0.10
Player#5684: posts big blind $0.20
*** HOLE CARDS ***
Dealt to warioman [Th 6h]
Player#9931 Waiting
Player#9035: folds
warioman: folds
Player#5684: folds
Player#1074 collected $0.20 from pot
*** SUMMARY ***
Total Pot $0.20 | Rake $0.00
Seat 1: Player#9931 (small blind) mucked
Seat 2: Player#9035 folded before the flop
Seat 3: warioman folded before the flop
Seat 4: Player#5684 (big blind) folded before the flop
Seat 5: Player#1074 shows [] and won ($0.20) with 

PokerStars Hand #f33c2311-bb93-4a6e-a3cf-f93aa3ce6e34:  Hold'em No Limit ($0.1/$0.20 USD) - 2021/11/20 23:07:00 ET
Table 'Lacey' 6-max Seat #2 is the button
Seat 1: warioman ($21.79 in chips)
Seat 2: Player#5341 ($15.13 in chips)
Seat 3: Player#7304 ($77.97 in chips)
Seat 4: Player#4498 ($24.18 in chips)
Seat 5: Player#7706 ($20.09 in chips)
Seat 6: Player#4850 ($50.82 in chips)
Player#7304: posts small blind $0.10
Player#4498: posts big blind $0.20
*** HOLE CARDS ***
Dealt to warioman [Jc Qd]
Player#7706: raises $0.20 to $0.4
Player#4850: folds
warioman: folds
Player#5341: folds
Player#7304: folds
Player#4498: calls $0.20
*** FLOP *** [6d 8s Jd]
Player#4498: checks
Player#7706: bets $0.60
Player#4498: folds
Player#7706: doesn't show hand
Uncalled bet ($0.60) returned to Player#7706
Player#7706 collected $0.85 from pot
*** SUMMARY ***
Total Pot $0.90 | Rake $0.05
Board [6d 8s Jd]
Seat 1: warioman folded before the flop
Seat 2: Player#5341 (button) folded before the flop
Seat 3: Player#7304 (small blind) folded before the flop
Seat 4: Player#4498 (big blind) folded on the flop
Seat 5: Player#7706 shows [] and won ($0.85) with 
Seat 6: Player#4850 folded before the flop

PokerStars Hand #467a5d00-a125-4a77-a826-bb4ec1a9cb83:  Hold'em No Limit ($0.1/$0.20 USD) - 2021/11/20 23:06:00 ET
Table 'Denver' 6-max Seat #1 is the button
Seat 1: Player#7386 ($63.40 in chips)
Seat 2: warioman ($20.27 in chips)
Seat 3: Player#0206 ($23.76 in chips)
Seat 4: Player#2668 ($16.93 in chips)
warioman: posts small blind $0.10
Player#0206: posts big blind $0.20
*** HOLE CARDS ***
Dealt to warioman [Ac Kc]
Player#2668: calls $0.20
Player#7386: folds
warioman: calls $0.10
Player#0206: raises $0.20 to $1.2
Player#2668: calls $1.00
warioman: raises $ 21.20 to $20.27
Player#0206: raises $ 220.27 to $23.76
Player#2668: folds
warioman Showing Pocket Cards AK
Player#0206 Showing Pocket Cards QQ
*** FLOP *** [9c 7c 6s]
*** TURN *** [9c 7c 6s] [3d]
*** RIVER *** [9c 7c 6s] [3d] [2d]
Uncalled bet ($23.76) returned to Player#0206
Player#0206 collected $20.40 from pot
*** SUMMARY ***
Total Pot $21.47 | Rake $1.07
Board [9c 7c 6s 3d 2d]
Seat 1: Player#7386 (button) folded before the flop
Seat 2: warioman (small blind)
Seat 3: Player#0206 shows [Qs Qd] and won ($20.40) with 
Seat 4: Player#2668 folded before the flop

PokerStars Hand #14975f20-61bf-4247-ae51-05d0c574afb1:  Hold'em No Limit ($0.1/$0.20 USD) - 2021/11/20 23:06:00 ET
Table 'Lacey' 6-max Seat #1 is the button
Seat 1: warioman ($20.75 in chips)
Seat 2: Player#8920 ($15.23 in chips)
Seat 3: Player#5980 ($79.02 in chips)
Seat 4: Player#3240 ($24.18 in chips)
Seat 5: Player#2410 ($20.09 in chips)
Seat 6: Player#5122 ($50.82 in chips)
Player#8920: posts small blind $0.10
Player#5980: posts big blind $0.20
*** HOLE CARDS ***
Dealt to warioman [Ac Ts]
Player#3240: folds
Player#2410: folds
Player#5122: folds
warioman: raises $0.20 to $0.5
Player#8920: folds
Player#5980: calls $0.30
*** FLOP *** [8c Kd Tc]
Player#5980: checks
warioman: checks
*** TURN *** [8c Kd Tc] [Js]
Player#5980: checks
warioman: checks
*** RIVER *** [8c Kd Tc] [Js] [Ts]
Player#5980: bets $0.55
warioman: calls $0.55
*** SHOW DOWN *** 
warioman collected $2.09 from pot
*** SUMMARY ***
Total Pot $2.20 | Rake $0.11
Board [8c Kd Tc Js Ts]
Seat 1: warioman (button)
Seat 2: Player#8920 (small blind) folded before the flop
Seat 3: Player#5980 (big blind) mucked
Seat 4: Player#3240 folded before the flop
Seat 5: Player#2410 folded before the flop
Seat 6: Player#5122 folded before the flop

PokerStars Hand #ec395746-7e1a-4773-aa87-1991fa3e7cd2:  Hold'em No Limit ($0.1/$0.20 USD) - 2021/11/20 23:06:00 ET
Table 'Denver' 6-max Seat #1 is the button
Seat 1: Player#0292 ($9.70 in chips)
Seat 2: Player#7819 ($63.60 in chips)
Seat 3: warioman ($19.90 in chips)
Seat 4: Player#9423 ($17.13 in chips)
Player#7819: posts small blind $0.10
warioman: posts big blind $0.20
*** HOLE CARDS ***
Dealt to warioman [Ad 3d]
Player#9423: calls $0.20
Player#0292: folds
Player#7819: calls $0.10
warioman: checks
*** FLOP *** [8c 7h 9d]
Player#7819: checks
warioman: checks
Player#9423: checks
*** TURN *** [8c 7h 9d] [7c]
Player#7819: checks
warioman: checks
Player#9423: checks
*** RIVER *** [8c 7h 9d] [7c] [Ac]
Player#7819: checks
warioman: checks
Player#9423: checks
*** SHOW DOWN *** 
warioman collected $0.57 from pot
*** SUMMARY ***
Total Pot $0.60 | Rake $0.03
Board [8c 7h 9d 7c Ac]
Seat 1: Player#0292 (button) folded before the flop
Seat 2: Player#7819 (small blind) mucked
Seat 3: warioman (big blind)
Seat 4: Player#9423 mucked

PokerStars Hand #e85efa46-5211-4db2-b3f1-c28fc4fdc076:  Hold'em No Limit ($0.1/$0.20 USD) - 2021/11/20 23:05:00 ET
Table 'Lacey' 6-max Seat #6 is the button
Seat 1: warioman ($21.15 in chips)
Seat 2: Player#0696 ($14.87 in chips)
Seat 3: Player#3173 ($79.02 in chips)
Seat 4: Player#2742 ($24.18 in chips)
Seat 5: Player#0144 ($20.09 in chips)
Seat 6: Player#2239 ($50.82 in chips)
warioman: posts small blind $0.10
Player#0696: posts big blind $0.20
*** HOLE CARDS ***
Dealt to warioman [5d Qd]
Player#3173: folds
Player#2742: folds
Player#0144: folds
Player#2239: folds
warioman: calls $0.10
Player#0696: checks
*** FLOP *** [7d Qc 9s]
warioman: checks
Player#0696: checks
*** TURN *** [7d Qc 9s] [Ts]
warioman: bets $0.20
Player#0696: raises $0.20 to $0.6
warioman: folds
warioman: doesn't show hand
Player#0696: doesn't show hand
Player#3173: doesn't show hand
Player#2742: doesn't show hand
Player#0144: doesn't show hand
Player#2239: doesn't show hand
Uncalled bet ($0.60) returned to Player#0696
Player#0696 collected $0.57 from pot
*** SUMMARY ***
Total Pot $0.60 | Rake $0.03
Board [7d Qc 9s Ts]
Seat 1: warioman (small blind) folded on the turn
Seat 2: Player#0696 shows [] and won ($0.57) with 
Seat 3: Player#3173 folded before the flop
Seat 4: Player#2742 folded before the flop
Seat 5: Player#0144 folded before the flop
Seat 6: Player#2239 (button) folded before the flop

PokerStars Hand #968e00a7-834e-4ab5-9432-ed9caabe2cb6:  Hold'em No Limit ($0.1/$0.20 USD) - 2021/11/20 23:05:00 ET
Table 'Denver' 6-max Seat #6 is the button
Seat 1: Player#0245 ($9.90 in chips)
Seat 2: Player#8725 ($66.30 in chips)
Seat 3: warioman ($19.90 in chips)
Seat 4: Player#5585 ($14.51 in chips)
Player#0245: posts small blind $0.10
Player#8725: posts big blind $0.20
*** HOLE CARDS ***
Dealt to warioman [8h Kd]
warioman: folds
Player#5585: calls $0.20
Player#0245: calls $0.10
Player#8725: raises $0.20 to $0.6
Player#5585: calls $0.40
Player#0245: folds
*** FLOP *** [8d 7c 7s]
Player#8725: checks
Player#5585: checks
*** TURN *** [8d 7c 7s] [2h]
Player#8725: bets $0.70
Player#5585: calls $0.70
*** RIVER *** [8d 7c 7s] [2h] [8h]
Player#8725: bets $1.40
Player#5585: calls $1.40
*** SHOW DOWN *** 
Player#5585 collected $5.32 from pot
*** SUMMARY ***
Total Pot $5.60 | Rake $0.28
Board [8d 7c 7s 2h 8h]
Seat 1: Player#0245 (small blind) folded before the flop
Seat 2: Player#8725 (big blind) mucked
Seat 3: warioman folded before the flop
Seat 4: Player#5585 shows [Ks As] and won ($5.32) with 

PokerStars Hand #ff24ae79-6047-47e2-a9fb-d1eb18aae3b6:  Hold'em No Limit ($0.1/$0.20 USD) - 2021/11/20 23:04:00 ET
Table 'Lacey' 6-max Seat #5 is the button
Seat 1: warioman ($21.55 in chips)
Seat 2: Player#4673 ($14.87 in chips)
Seat 3: Player#9369 ($79.02 in chips)
Seat 4: Player#1243 ($24.18 in chips)
Seat 5: Player#1540 ($19.63 in chips)
Seat 6: Player#8600 ($50.92 in chips)
Player#8600: posts small blind $0.10
warioman: posts big blind $0.20
*** HOLE CARDS ***
Dealt to warioman [3d Jd]
Player#4673: folds
Player#9369: folds
Player#1243: folds
Player#1540: calls $0.20
Player#8600: folds
warioman: checks
*** FLOP *** [3c 9h 7d]
warioman: checks
Player#1540: bets $0.20
warioman: calls $0.20
*** TURN *** [3c 9h 7d] [As]
warioman: checks
Player#1540: bets $0.60
warioman: folds
Player#1540: doesn't show hand
Uncalled bet ($0.60) returned to Player#1540
Player#1540 collected $0.85 from pot
*** SUMMARY ***
Total Pot $0.90 | Rake $0.05
Board [3c 9h 7d As]
Seat 1: warioman (big blind) folded on the turn
Seat 2: Player#4673 folded before the flop
Seat 3: Player#9369 folded before the flop
Seat 4: Player#1243 folded before the flop
Seat 5: Player#1540 shows [] and won ($0.85) with 
Seat 6: Player#8600 (small blind) folded before the flop

PokerStars Hand #91ee958a-5b8d-4575-af95-46d4d81329f4:  Hold'em No Limit ($0.1/$0.20 USD) - 2021/11/20 23:04:00 ET
Table 'Denver' 6-max Seat #4 is the button
Seat 1: Player#6861 ($10.10 in chips)
Seat 2: Player#9934 ($30.79 in chips)
Seat 3: Player#0732 ($65.39 in chips)
Seat 4: warioman ($19.90 in chips)
Seat 5: Player#8352 ($15.31 in chips)
Player#8352: posts small blind $0.10
Player#6861: posts big blind $0.20
*** HOLE CARDS ***
Dealt to warioman [3h 5c]
Player#9934: folds
Player#0732: calls $0.20
warioman: folds
Player#8352: calls $0.10
Player#6861: checks
*** FLOP *** [6h 3d Ad]
Player#8352: bets $0.20
Player#6861: folds
Player#0732: calls $0.20
*** TURN *** [6h 3d Ad] [As]
Player#8352: bets $0.20
Player#0732: calls $0.20
*** RIVER *** [6h 3d Ad] [As] [Ks]
Player#8352: bets $0.20
Player#0732: raises0.20 to $1
Player#8352: folds
Player#0732: doesn't show hand
Uncalled bet ($1.00) returned to Player#0732
Player#0732 collected $1.52 from pot
*** SUMMARY ***
Total Pot $1.60 | Rake $0.08
Board [6h 3d Ad As Ks]
Seat 1: Player#6861 (big blind) folded on the flop
Seat 2: Player#9934 folded before the flop
Seat 3: Player#0732 shows [] and won ($1.52) with 
Seat 4: warioman (button) folded before the flop
Seat 5: Player#8352 (small blind) folded on the river

PokerStars Hand #32fc1f98-e890-4696-9cd9-c33137c76c4a:  Hold'em No Limit ($0.1/$0.20 USD) - 2021/11/20 23:04:00 ET
Table 'Denver' 6-max Seat #4 is the button
Seat 1: Player#5711 ($10.10 in chips)
Seat 2: Player#0623 ($31.79 in chips)
Seat 3: Player#3782 ($64.30 in chips)
Seat 4: warioman ($19.90 in chips)
Seat 5: Player#6491 ($15.51 in chips)
Player#6491: posts small blind $0.10
Player#0623: posts big blind $0.20
*** HOLE CARDS ***
Dealt to warioman [5c 4d]
Player#5711: folds
Player#0623: raises $0.20 to $0.4
Player#3782: raises0.40 to $1
warioman: folds
Player#6491: folds
Player#0623: calls $0.60
*** FLOP *** [9h 5s 5d]
Player#0623: checks
Player#3782: bets $1.65
Player#0623: folds
Player#3782: doesn't show hand
Uncalled bet ($1.65) returned to Player#3782
Player#3782 collected $2.09 from pot
*** SUMMARY ***
Total Pot $2.20 | Rake $0.11
Board [9h 5s 5d]
Seat 1: Player#5711 folded before the flop
Seat 2: Player#0623 (big blind) folded on the flop
Seat 3: Player#3782 shows [] and won ($2.09) with 
Seat 4: warioman (button) folded before the flop
Seat 5: Player#6491 (small blind) folded before the flop

PokerStars Hand #71026c4f-a753-4510-9c19-17da31c9974a:  Hold'em No Limit ($0.1/$0.20 USD) - 2021/11/20 23:03:00 ET
Table 'Lacey' 6-max Seat #4 is the button
Seat 1: warioman ($21.55 in chips)
Seat 2: Player#1861 ($17.55 in chips)
Seat 3: Player#3482 ($80.07 in chips)
Seat 4: Player#1328 ($24.18 in chips)
Seat 5: Player#7378 ($19.73 in chips)
Seat 6: Player#5077 ($47.41 in chips)
Player#7378: posts small blind $0.10
Player#5077: posts big blind $0.20
*** HOLE CARDS ***
Dealt to warioman [6s Jh]
warioman: folds
Player#1861: raises $0.20 to $0.6
Player#3482: raises $0.60 to $1.05
Player#1328: folds
Player#7378: folds
Player#5077: calls $0.85
Player#1861: calls $0.45
*** FLOP *** [5s 9s Qc]
Player#5077: checks
Player#1861: checks
Player#3482: checks
*** TURN *** [5s 9s Qc] [7s]
Player#5077: bets $1.63
Player#1861: calls $1.63
Player#3482: folds
*** RIVER *** [5s 9s Qc] [7s] [As]
Player#5077: checks
Player#1861: checks
*** SHOW DOWN *** 
Player#5077 collected $6.18 from pot
*** SUMMARY ***
Total Pot $6.51 | Rake $0.33
Board [5s 9s Qc 7s As]
Seat 1: warioman folded before the flop
Seat 2: Player#1861 mucked
Seat 3: Player#3482 folded on the turn
Seat 4: Player#1328 (button) folded before the flop
Seat 5: Player#7378 (small blind) folded before the flop
Seat 6: Player#5077 shows [8d 6d] and won ($6.18) with 

PokerStars Hand #769e2d77-9261-421e-a456-8dbf59b17266:  Hold'em No Limit ($0.1/$0.20 USD) - 2021/11/20 23:03:00 ET
Table 'Denver' 6-max Seat #3 is the button
Seat 1: Player#5279 ($10.10 in chips)
Seat 2: Player#0620 ($27.76 in chips)
Seat 3: Player#4083 ($64.30 in chips)
Seat 4: warioman ($20.00 in chips)
Seat 5: Player#3760 ($4.16 in chips)
Seat 6: Player#4602 ($15.71 in chips)
warioman: posts small blind $0.10
Player#3760: posts big blind $0.20
*** HOLE CARDS ***
Dealt to warioman [2h 7c]
Player#4602: calls $0.20
Player#5279: folds
Player#0620: raises $0.20 to $0.8
Player#4083: folds
warioman: folds
Player#3760: raises $0.80 to $4.16
Player#4602: folds
Player#0620: calls $3.36
Player#3760 Showing Pocket Cards KA
Player#0620 Showing Pocket Cards 99
*** FLOP *** [3c Jc 8c]
*** TURN *** [3c Jc 8c] [9s]
*** RIVER *** [3c Jc 8c] [9s] [2h]
Player#0620 collected $8.19 from pot
*** SUMMARY ***
Total Pot $8.62 | Rake $0.43
Board [3c Jc 8c 9s 2h]
Seat 1: Player#5279 folded before the flop
Seat 2: Player#0620 shows [9c 9s] and won ($8.19) with 
Seat 3: Player#4083 (button) folded before the flop
Seat 4: warioman (small blind) folded before the flop
Seat 5: Player#3760 (big blind) mucked
Seat 6: Player#4602 folded before the flop

PokerStars Hand #7e797641-f25b-408e-9c60-fd40afaf7348:  Hold'em No Limit ($0.1/$0.20 USD) - 2021/11/20 23:03:00 ET
Table 'Lacey' 6-max Seat #3 is the button
Seat 1: warioman ($22.05 in chips)
Seat 2: Player#4574 ($17.55 in chips)
Seat 3: Player#0300 ($80.07 in chips)
Seat 4: Player#0601 ($23.48 in chips)
Seat 5: Player#6737 ($19.93 in chips)
Seat 6: Player#4470 ($47.41 in chips)
Player#0601: posts small blind $0.10
Player#6737: posts big blind $0.20
*** HOLE CARDS ***
Dealt to warioman [Qc 8c]
Player#4470: folds
warioman: raises $0.20 to $0.5
Player#4574: folds
Player#0300: folds
Player#0601: raises $0.50 to $2.1
Player#6737: folds
warioman: folds
Player#0601: doesn't show hand
Uncalled bet ($2.10) returned to Player#0601
Player#0601 collected $0.70 from pot
*** SUMMARY ***
Total Pot $0.70 | Rake $0.00
Seat 1: warioman folded before the flop
Seat 2: Player#4574 folded before the flop
Seat 3: Player#0300 (button) folded before the flop
Seat 4: Player#0601 shows [] and won ($0.70) with 
Seat 5: Player#6737 (big blind) folded before the flop
Seat 6: Player#4470 folded before the flop

PokerStars Hand #7bf1b8db-ac75-4239-a326-0755fc7eeda3:  Hold'em No Limit ($0.1/$0.20 USD) - 2021/11/20 23:02:00 ET
Table 'Denver' 6-max Seat #2 is the button
Seat 1: Player#2137 ($10.10 in chips)
Seat 2: Player#3425 ($27.76 in chips)
Seat 3: Player#6057 ($64.40 in chips)
Seat 4: warioman ($19.70 in chips)
Seat 5: Player#6142 ($4.16 in chips)
Seat 6: Player#0811 ($13.90 in chips)
Player#6057: posts small blind $0.10
warioman: posts big blind $0.20
*** HOLE CARDS ***
Dealt to warioman [5d 5c]
Player#6142: folds
Player#0811: calls $0.20
Player#2137: folds
Player#3425: folds
Player#6057: folds
warioman: checks
*** FLOP *** [3s Qd Td]
warioman: checks
Player#0811: bets $0.20
warioman: calls $0.20
*** TURN *** [3s Qd Td] [Jh]
warioman: checks
Player#0811: bets $0.20
warioman: calls $0.20
*** RIVER *** [3s Qd Td] [Jh] [2h]
warioman: checks
Player#0811: bets $1.30
warioman: calls $1.30
*** SHOW DOWN *** 
warioman: doesn't show hand
Player#0811 collected $3.70 from pot
*** SUMMARY ***
Total Pot $3.90 | Rake $0.19
Board [3s Qd Td Jh 2h]
Seat 1: Player#2137 folded before the flop
Seat 2: Player#3425 (button) folded before the flop
Seat 3: Player#6057 (small blind) folded before the flop
Seat 4: warioman (big blind)
Seat 5: Player#6142 folded before the flop
Seat 6: Player#0811 shows [Tc Qc] and won ($3.70) with 

PokerStars Hand #b2fa0996-0192-462b-9e5b-1e18a404f929:  Hold'em No Limit ($0.1/$0.20 USD) - 2021/11/20 23:02:00 ET
Table 'Lacey' 6-max Seat #2 is the button
Seat 1: warioman ($22.05 in chips)
Seat 2: Player#9761 ($17.55 in chips)
Seat 3: Player#2709 ($80.27 in chips)
Seat 4: Player#4060 ($23.68 in chips)
Seat 5: Player#0404 ($19.56 in chips)
Seat 6: Player#5892 ($47.41 in chips)
Player#2709: posts small blind $0.10
Player#4060: posts big blind $0.20
*** HOLE CARDS ***
Dealt to warioman [7d 2c]
Player#0404: calls $0.20
Player#5892: folds
warioman: folds
Player#9761: folds
Player#2709: calls $0.10
Player#4060: checks
*** FLOP *** [9d Th 7c]
Player#2709: checks
Player#4060: checks
Player#0404: checks
*** TURN *** [9d Th 7c] [5d]
Player#2709: checks
Player#4060: checks
Player#0404: bets $0.40
Player#2709: folds
Player#4060: folds
Player#0404: doesn't show hand
Uncalled bet ($0.40) returned to Player#0404
Player#0404 collected $0.57 from pot
*** SUMMARY ***
Total Pot $0.60 | Rake $0.03
Board [9d Th 7c 5d]
Seat 1: warioman folded before the flop
Seat 2: Player#9761 (button) folded before the flop
Seat 3: Player#2709 (small blind) folded on the turn
Seat 4: Player#4060 (big blind) folded on the turn
Seat 5: Player#0404 shows [] and won ($0.57) with 
Seat 6: Player#5892 folded before the flop

PokerStars Hand #e1616476-81aa-4ac2-b85f-8064314da928:  Hold'em No Limit ($0.1/$0.20 USD) - 2021/11/20 23:01:00 ET
Table 'Denver' 6-max Seat #1 is the button
Seat 1: Player#8778 ($12.60 in chips)
Seat 2: Player#5636 ($27.86 in chips)
Seat 3: Player#5662 ($65.30 in chips)
Seat 4: warioman ($19.70 in chips)
Seat 5: Player#0558 ($4.16 in chips)
Seat 6: Player#2638 ($10.70 in chips)
Player#5636: posts small blind $0.10
Player#5662: posts big blind $0.20
*** HOLE CARDS ***
Dealt to warioman [2s Th]
warioman: folds
Player#0558: folds
Player#2638: calls $0.20
Player#8778: raises $0.20 to $0.9
Player#5636: folds
Player#5662: calls $0.70
Player#2638: calls $0.70
*** FLOP *** [Ts 4c Ad]
Player#5662: checks
Player#2638: checks
Player#8778: checks
*** TURN *** [Ts 4c Ad] [3c]
Player#5662: checks
Player#2638: bets $0.60
Player#8778: calls $0.60
Player#5662: folds
*** RIVER *** [Ts 4c Ad] [3c] [Tc]
Player#2638: bets $1.00
Player#8778: calls $1.00
*** SHOW DOWN *** 
Player#8778: doesn't show hand
Player#2638 collected $5.70 from pot
*** SUMMARY ***
Total Pot $6.00 | Rake $0.30
Board [Ts 4c Ad 3c Tc]
Seat 1: Player#8778 (button) mucked
Seat 2: Player#5636 (small blind) folded before the flop
Seat 3: Player#5662 (big blind) folded on the turn
Seat 4: warioman folded before the flop
Seat 5: Player#0558 folded before the flop
Seat 6: Player#2638 shows [Qc Ah] and won ($5.70) with 

PokerStars Hand #77c96916-3e94-4355-a9d4-f12253332a7f:  Hold'em No Limit ($0.1/$0.20 USD) - 2021/11/20 23:01:00 ET
Table 'Denver' 6-max Seat #6 is the button
Seat 1: Player#8303 ($12.70 in chips)
Seat 2: Player#4903 ($28.06 in chips)
Seat 3: Player#3386 ($65.30 in chips)
Seat 4: warioman ($19.70 in chips)
Seat 5: Player#1275 ($4.16 in chips)
Seat 6: Player#6796 ($10.40 in chips)
Player#8303: posts small blind $0.10
Player#4903: posts big blind $0.20
*** HOLE CARDS ***
Dealt to warioman [6c 2h]
Player#3386: folds
warioman: folds
Player#1275: folds
Player#6796: raises0.20 to $2
Player#8303: folds
Player#4903: folds
Player#6796: doesn't show hand
Uncalled bet ($2.00) returned to Player#6796
Player#6796 collected $0.30 from pot
*** SUMMARY ***
Total Pot $0.30 | Rake $0.00
Seat 1: Player#8303 (small blind) folded before the flop
Seat 2: Player#4903 (big blind) folded before the flop
Seat 3: Player#3386 folded before the flop
Seat 4: warioman folded before the flop
Seat 5: Player#1275 folded before the flop
Seat 6: Player#6796 shows [] and won ($0.30) with 

PokerStars Hand #84382c5d-10cd-49e3-8416-a3738093247d:  Hold'em No Limit ($0.1/$0.20 USD) - 2021/11/20 23:01:00 ET
Table 'Lacey' 6-max Seat #1 is the button
Seat 1: warioman ($22.05 in chips)
Seat 2: Player#8294 ($18.55 in chips)
Seat 3: Player#5658 ($80.47 in chips)
Seat 4: Player#0152 ($23.68 in chips)
Seat 5: Player#9630 ($18.47 in chips)
Seat 6: Player#5627 ($47.41 in chips)
Player#8294: posts small blind $0.10
Player#5658: posts big blind $0.20
*** HOLE CARDS ***
Dealt to warioman [9c 3s]
Player#0152: folds
Player#9630: calls $0.20
Player#5627: folds
warioman: folds
Player#8294: calls $0.10
Player#5658: checks
*** FLOP *** [6s 6d 7h]
Player#8294: checks
Player#5658: checks
Player#9630: bets $0.20
Player#8294: calls $0.20
Player#5658: folds
*** TURN *** [6s 6d 7h] [7s]
Player#8294: checks
Player#9630: bets $0.60
Player#8294: calls $0.60
*** RIVER *** [6s 6d 7h] [7s] [3s]
Player#8294: checks
Player#9630: checks
*** SHOW DOWN *** 
Player#9630 collected $2.09 from pot
*** SUMMARY ***
Total Pot $2.20 | Rake $0.11
Board [6s 6d 7h 7s 3s]
Seat 1: warioman (button) folded before the flop
Seat 2: Player#8294 (small blind) mucked
Seat 3: Player#5658 (big blind) folded on the flop
Seat 4: Player#0152 folded before the flop
Seat 5: Player#9630 shows [5s Ad] and won ($2.09) with 
Seat 6: Player#5627 folded before the flop

PokerStars Hand #a61d4e63-6006-454e-ae03-00ed476da666:  Hold'em No Limit ($0.1/$0.20 USD) - 2021/11/20 23:00:00 ET
Table 'Denver' 6-max Seat #5 is the button
Seat 1: Player#1854 ($13.30 in chips)
Seat 2: Player#5400 ($28.06 in chips)
Seat 3: Player#5162 ($65.90 in chips)
Seat 4: warioman ($19.70 in chips)
Seat 5: Player#9707 ($4.16 in chips)
Seat 6: Player#8301 ($9.29 in chips)
Player#8301: posts small blind $0.10
Player#1854: posts big blind $0.20
*** HOLE CARDS ***
Dealt to warioman [Kh 3c]
Player#5400: folds
Player#5162: raises $0.20 to $0.6
warioman: folds
Player#9707: folds
Player#8301: calls $0.50
Player#1854: calls $0.40
*** FLOP *** [2d Qd Kd]
Player#8301: checks
Player#1854: checks
Player#5162: checks
*** TURN *** [2d Qd Kd] [5c]
Player#8301: bets $0.20
Player#1854: folds
Player#5162: folds
Player#8301: doesn't show hand
Uncalled bet ($0.20) returned to Player#8301
Player#8301 collected $1.71 from pot
*** SUMMARY ***
Total Pot $1.80 | Rake $0.09
Board [2d Qd Kd 5c]
Seat 1: Player#1854 (big blind) folded on the turn
Seat 2: Player#5400 folded before the flop
Seat 3: Player#5162 folded on the turn
Seat 4: warioman folded before the flop
Seat 5: Player#9707 (button) folded before the flop
Seat 6: Player#8301 shows [] and won ($1.71) with 

PokerStars Hand #466066c7-a881-4e1e-a764-e6bc97ae502c:  Hold'em No Limit ($0.1/$0.20 USD) - 2021/11/20 23:00:00 ET
Table 'Lacey' 6-max Seat #6 is the button
Seat 1: warioman ($21.68 in chips)
Seat 2: Player#9288 ($18.75 in chips)
Seat 3: Player#6163 ($80.47 in chips)
Seat 4: Player#2106 ($23.68 in chips)
Seat 5: Player#4020 ($18.67 in chips)
Seat 6: Player#0712 ($47.41 in chips)
warioman: posts small blind $0.10
Player#9288: posts big blind $0.20
*** HOLE CARDS ***
Dealt to warioman [5h 6h]
Player#6163: folds
Player#2106: folds
Player#4020: calls $0.20
Player#0712: folds
warioman: calls $0.10
Player#9288: checks
*** FLOP *** [2d 3c 9h]
warioman: checks
Player#9288: checks
Player#4020: checks
*** TURN *** [2d 3c 9h] [Kh]
warioman: bets $0.20
Player#9288: folds
Player#4020: folds
warioman: doesn't show hand
Uncalled bet ($0.20) returned to warioman
warioman collected $0.57 from pot
*** SUMMARY ***
Total Pot $0.60 | Rake $0.03
Board [2d 3c 9h Kh]
Seat 1: warioman (small blind)
Seat 2: Player#9288 (big blind) folded on the turn
Seat 3: Player#6163 folded before the flop
Seat 4: Player#2106 folded before the flop
Seat 5: Player#4020 folded on the turn
Seat 6: Player#0712 (button) folded before the flop

PokerStars Hand #c01d0165-4e59-428f-b27d-b0e8ad780ea6:  Hold'em No Limit ($0.1/$0.20 USD) - 2021/11/20 23:00:00 ET
Table 'Denver' 6-max Seat #4 is the button
Seat 1: Player#1841 ($13.30 in chips)
Seat 2: Player#1833 ($28.06 in chips)
Seat 3: Player#9462 ($62.46 in chips)
Seat 4: warioman ($19.70 in chips)
Seat 5: Player#2578 ($4.26 in chips)
Seat 6: Player#1130 ($13.00 in chips)
Player#2578: posts small blind $0.10
Player#1130: posts big blind $0.20
*** HOLE CARDS ***
Dealt to warioman [Qh 6d]
Player#1841: folds
Player#1833: folds
Player#9462: raises $0.20 to $0.7
warioman: folds
Player#2578: folds
Player#1130: calls $0.50
*** FLOP *** [Jc 4h Ac]
Player#1130: checks
Player#9462: bets $1.13
Player#1130: calls $1.13
*** TURN *** [Jc 4h Ac] [Jh]
Player#1130: checks
Player#9462: bets $1.88
Player#1130: calls $1.88
*** RIVER *** [Jc 4h Ac] [Jh] [8h]
Player#1130: checks
Player#9462: bets $6.24
Player#1130: folds
Player#9462: doesn't show hand
Uncalled bet ($6.24) returned to Player#9462
Player#9462 collected $7.14 from pot
*** SUMMARY ***
Total Pot $7.52 | Rake $0.38
Board [Jc 4h Ac Jh 8h]
Seat 1: Player#1841 folded before the flop
Seat 2: Player#1833 folded before the flop
Seat 3: Player#9462 shows [] and won ($7.14) with 
Seat 4: warioman (button) folded before the flop
Seat 5: Player#2578 (small blind) folded before the flop
Seat 6: Player#1130 (big blind) folded on the river

PokerStars Hand #ca800bce-32a2-444a-a9b3-c2ed155a4d0c:  Hold'em No Limit ($0.1/$0.20 USD) - 2021/11/20 22:59:00 ET
Table 'Lacey' 6-max Seat #5 is the button
Seat 1: warioman ($21.88 in chips)
Seat 2: Player#1821 ($18.75 in chips)
Seat 3: Player#8558 ($82.07 in chips)
Seat 4: Player#1111 ($24.28 in chips)
Seat 5: Player#6412 ($18.67 in chips)
Seat 6: Player#8312 ($45.21 in chips)
Player#8312: posts small blind $0.10
warioman: posts big blind $0.20
*** HOLE CARDS ***
Dealt to warioman [Ac 2h]
Player#1821: folds
Player#8558: raises $0.20 to $0.6
Player#1111: calls $0.60
Player#6412: folds
Player#8312: calls $0.50
warioman: folds
*** FLOP *** [Jd 4h 4s]
Player#8312: checks
Player#8558: checks
Player#1111: checks
*** TURN *** [Jd 4h 4s] [9h]
Player#8312: bets $1.00
Player#8558: calls $1.00
Player#1111: folds
*** RIVER *** [Jd 4h 4s] [9h] [9h]
Player#8312: checks
Player#8558: checks
*** SHOW DOWN *** 
Player#8312 collected $3.80 from pot
*** SUMMARY ***
Total Pot $4.00 | Rake $0.20
Board [Jd 4h 4s 9h 9h]
Seat 1: warioman (big blind) folded before the flop
Seat 2: Player#1821 folded before the flop
Seat 3: Player#8558 mucked
Seat 4: Player#1111 folded on the turn
Seat 5: Player#6412 (button) folded before the flop
Seat 6: Player#8312 shows [6h Ah] and won ($3.80) with 

PokerStars Hand #1b7d47f6-a5c9-4ed8-a218-c6ea624f312e:  Hold'em No Limit ($0.1/$0.20 USD) - 2021/11/20 22:58:00 ET
Table 'Denver' 6-max Seat #3 is the button
Seat 1: Player#0528 ($20.30 in chips)
Seat 2: Player#6040 ($21.28 in chips)
Seat 3: Player#4876 ($62.46 in chips)
Seat 4: warioman ($19.80 in chips)
Seat 5: Player#1062 ($4.46 in chips)
Seat 6: Player#7149 ($13.20 in chips)
warioman: posts small blind $0.10
Player#1062: posts big blind $0.20
*** HOLE CARDS ***
Dealt to warioman [4d 2c]
Player#7149: calls $0.20
Player#0528: raises $0.20 to $0.9
Player#6040: raises $0.90 to $1.6
Player#4876: folds
warioman: folds
Player#1062: folds
Player#7149: folds
Player#0528: calls $0.70
*** FLOP *** [Qh 6h 5s]
Player#0528: checks
Player#6040: bets $2.40
Player#0528: calls $2.40
*** TURN *** [Qh 6h 5s] [5h]
Player#0528: checks
Player#6040: bets $3.00
Player#0528: calls $3.00
*** RIVER *** [Qh 6h 5s] [5h] [2h]
Player#0528: checks
Player#6040: checks
*** SHOW DOWN *** 
Player#6040 collected $13.78 from pot
*** SUMMARY ***
Total Pot $14.50 | Rake $0.73
Board [Qh 6h 5s 5h 2h]
Seat 1: Player#0528 mucked
Seat 2: Player#6040 shows [Qd Ad] and won ($13.78) with 
Seat 3: Player#4876 (button) folded before the flop
Seat 4: warioman (small blind) folded before the flop
Seat 5: Player#1062 (big blind) folded before the flop
Seat 6: Player#7149 folded before the flop

PokerStars Hand #e0fbbb33-7b5e-49cd-acae-b54396ae5927:  Hold'em No Limit ($0.1/$0.20 USD) - 2021/11/20 22:57:00 ET
Table 'Lacey' 6-max Seat #4 is the button
Seat 1: warioman ($20.30 in chips)
Seat 2: Player#0622 ($19.25 in chips)
Seat 3: Player#3177 ($82.07 in chips)
Seat 4: Player#7973 ($24.28 in chips)
Seat 5: Player#6853 ($19.17 in chips)
Seat 6: Player#9238 ($45.91 in chips)
Player#6853: posts small blind $0.10
Player#9238: posts big blind $0.20
*** HOLE CARDS ***
Dealt to warioman [Kc Ac]
warioman: raises $0.20 to $0.5
Player#0622: calls $0.50
Player#3177: folds
Player#7973: folds
Player#6853: calls $0.40
Player#9238: calls $0.30
*** FLOP *** [6s 7d 8s]
Player#6853: checks
Player#9238: checks
warioman: checks
Player#0622: checks
*** TURN *** [6s 7d 8s] [Ad]
Player#6853: checks
Player#9238: checks
warioman: checks
Player#0622: checks
*** RIVER *** [6s 7d 8s] [Ad] [3d]
Player#6853: checks
Player#9238: bets $0.20
warioman: calls $0.20
Player#0622: folds
Player#6853: folds
*** SHOW DOWN *** 
warioman collected $2.28 from pot
*** SUMMARY ***
Total Pot $2.40 | Rake $0.12
Board [6s 7d 8s Ad 3d]
Seat 1: warioman
Seat 2: Player#0622 folded on the river
Seat 3: Player#3177 folded before the flop
Seat 4: Player#7973 (button) folded before the flop
Seat 5: Player#6853 (small blind) folded on the river
Seat 6: Player#9238 (big blind) mucked

PokerStars Hand #3d549c82-c256-4835-8c74-db5cb33df9fd:  Hold'em No Limit ($0.1/$0.20 USD) - 2021/11/20 22:57:00 ET
Table 'Denver' 6-max Seat #2 is the button
Seat 1: Player#1754 ($20.30 in chips)
Seat 2: Player#5586 ($22.48 in chips)
Seat 3: Player#1863 ($63.86 in chips)
Seat 4: warioman ($20.00 in chips)
Seat 5: Player#8765 ($4.46 in chips)
Seat 6: Player#9286 ($10.61 in chips)
Player#1863: posts small blind $0.10
warioman: posts big blind $0.20
*** HOLE CARDS ***
Dealt to warioman [Qs 3d]
Player#8765: folds
Player#9286: calls $0.20
Player#1754: folds
Player#5586: calls $0.20
Player#1863: raises $0.20 to $0.8
warioman: folds
Player#9286: calls $0.60
Player#5586: calls $0.60
*** FLOP *** [7d 5s Kh]
Player#1863: checks
Player#9286: bets $0.20
Player#5586: calls $0.20
Player#1863: calls $0.20
*** TURN *** [7d 5s Kh] [4h]
Player#1863: checks
Player#9286: bets $0.20
Player#5586: calls $0.20
Player#1863: calls $0.20
*** RIVER *** [7d 5s Kh] [4h] [3h]
Player#1863: checks
Player#9286: bets $0.20
Player#5586: folds
Player#1863: calls $0.20
*** SHOW DOWN *** 
Player#1863: doesn't show hand
Player#9286 collected $3.99 from pot
*** SUMMARY ***
Total Pot $4.20 | Rake $0.21
Board [7d 5s Kh 4h 3h]
Seat 1: Player#1754 folded before the flop
Seat 2: Player#5586 (button) folded on the river
Seat 3: Player#1863 (small blind) mucked
Seat 4: warioman (big blind) folded before the flop
Seat 5: Player#8765 folded before the flop
Seat 6: Player#9286 shows [Ks 9s] and won ($3.99) with 

PokerStars Hand #49974a92-653e-4258-a18c-c66b1eaddae0:  Hold'em No Limit ($0.1/$0.20 USD) - 2021/11/20 22:56:00 ET
Table 'Lacey' 6-max Seat #3 is the button
Seat 1: warioman ($20.30 in chips)
Seat 2: Player#0332 ($13.77 in chips)
Seat 3: Player#6196 ($83.22 in chips)
Seat 4: Player#0259 ($24.38 in chips)
Seat 5: Player#9810 ($19.37 in chips)
Seat 6: Player#6551 ($43.49 in chips)
Player#0259: posts small blind $0.10
Player#9810: posts big blind $0.20
*** HOLE CARDS ***
Dealt to warioman [6s Ac]
Player#6551: raises $0.20 to $0.4
warioman: folds
Player#0332: calls $0.40
Player#6196: calls $0.40
Player#0259: folds
Player#9810: folds
*** FLOP *** [Jh 9s 3c]
Player#6551: bets $0.75
Player#0332: calls $0.75
Player#6196: calls $0.75
*** TURN *** [Jh 9s 3c] [6c]
Player#6551: bets $2.81
Player#0332: folds
Player#6196: folds
Player#6551: doesn't show hand
Uncalled bet ($2.81) returned to Player#6551
Player#6551 collected $3.56 from pot
*** SUMMARY ***
Total Pot $3.75 | Rake $0.19
Board [Jh 9s 3c 6c]
Seat 1: warioman folded before the flop
Seat 2: Player#0332 folded on the turn
Seat 3: Player#6196 (button) folded on the turn
Seat 4: Player#0259 (small blind) folded before the flop
Seat 5: Player#9810 (big blind) folded before the flop
Seat 6: Player#6551 shows [] and won ($3.56) with 

PokerStars Hand #1bdbf364-c8c8-4f48-a9cb-158158713711:  Hold'em No Limit ($0.1/$0.20 USD) - 2021/11/20 22:56:00 ET
Table 'Denver' 6-max Seat #1 is the button
Seat 1: Player#1378 ($20.30 in chips)
Seat 2: Player#2015 ($22.58 in chips)
Seat 3: Player#8740 ($61.75 in chips)
Seat 4: warioman ($20.00 in chips)
Seat 5: Player#5760 ($6.69 in chips)
Seat 6: Player#9404 ($10.61 in chips)
Player#2015: posts small blind $0.10
Player#8740: posts big blind $0.20
*** HOLE CARDS ***
Dealt to warioman [Ac 9s]
warioman: folds
Player#5760: raises $0.20 to $0.6
Player#9404: folds
Player#1378: folds
Player#2015: folds
Player#8740: calls $0.40
*** FLOP *** [Th 9c 9d]
Player#8740: checks
Player#5760: bets $0.33
Player#8740: calls $0.33
*** TURN *** [Th 9c 9d] [6c]
Player#8740: checks
Player#5760: bets $1.30
Player#8740: raises $1.30 to $5.86
Player#5760: folds
Player#8740: doesn't show hand
Uncalled bet ($5.86) returned to Player#8740
Player#8740 collected $3.10 from pot
*** SUMMARY ***
Total Pot $3.26 | Rake $0.16
Board [Th 9c 9d 6c]
Seat 1: Player#1378 (button) folded before the flop
Seat 2: Player#2015 (small blind) folded before the flop
Seat 3: Player#8740 shows [] and won ($3.10) with 
Seat 4: warioman folded before the flop
Seat 5: Player#5760 folded on the turn
Seat 6: Player#9404 folded before the flop

PokerStars Hand #2d4f03f7-3fae-4717-b929-82eb6bda7fb7:  Hold'em No Limit ($0.1/$0.20 USD) - 2021/11/20 22:56:00 ET
Table 'Denver' 6-max Seat #6 is the button
Seat 1: Player#4351 ($20.40 in chips)
Seat 2: Player#1591 ($22.78 in chips)
Seat 3: Player#2440 ($61.45 in chips)
Seat 4: warioman ($20.00 in chips)
Seat 5: Player#2774 ($6.69 in chips)
Seat 6: Player#6586 ($10.61 in chips)
Player#4351: posts small blind $0.10
Player#1591: posts big blind $0.20
*** HOLE CARDS ***
Dealt to warioman [3s 2d]
Player#2440: raises $0.20 to $0.6
warioman: folds
Player#2774: folds
Player#6586: folds
Player#4351: folds
Player#1591: folds
Player#2440: doesn't show hand
Uncalled bet ($0.60) returned to Player#2440
Player#2440 collected $0.30 from pot
*** SUMMARY ***
Total Pot $0.30 | Rake $0.00
Seat 1: Player#4351 (small blind) folded before the flop
Seat 2: Player#1591 (big blind) folded before the flop
Seat 3: Player#2440 shows [] and won ($0.30) with 
Seat 4: warioman folded before the flop
Seat 5: Player#2774 folded before the flop
Seat 6: Player#6586 (button) folded before the flop

PokerStars Hand #9df26ec1-5201-404c-b672-019af7ea09cd:  Hold'em No Limit ($0.1/$0.20 USD) - 2021/11/20 22:55:00 ET
Table 'Denver' 6-max Seat #5 is the button
Seat 1: Player#9479 ($20.60 in chips)
Seat 2: Player#8863 ($22.78 in chips)
Seat 3: Player#9983 ($62.25 in chips)
Seat 4: warioman ($20.00 in chips)
Seat 5: Player#2389 ($6.69 in chips)
Seat 6: Player#6684 ($9.70 in chips)
Player#6684: posts small blind $0.10
Player#9479: posts big blind $0.20
*** HOLE CARDS ***
Dealt to warioman [5d Ac]
Player#8863: folds
Player#9983: calls $0.20
warioman: folds
Player#2389: folds
Player#6684: calls $0.10
Player#9479: checks
*** FLOP *** [7c 9c Th]
Player#6684: checks
Player#9479: checks
Player#9983: bets $0.60
Player#6684: raises $0.60 to $9.5
Player#9479: folds
Player#9983: folds
Player#6684: doesn't show hand
Uncalled bet ($9.50) returned to Player#6684
Player#6684 collected $1.14 from pot
*** SUMMARY ***
Total Pot $1.20 | Rake $0.06
Board [7c 9c Th]
Seat 1: Player#9479 (big blind) folded on the flop
Seat 2: Player#8863 folded before the flop
Seat 3: Player#9983 folded on the flop
Seat 4: warioman folded before the flop
Seat 5: Player#2389 (button) folded before the flop
Seat 6: Player#6684 shows [] and won ($1.14) with 

PokerStars Hand #dcb42a13-c585-4f5b-a82d-2f192b8f73f7:  Hold'em No Limit ($0.1/$0.20 USD) - 2021/11/20 22:55:00 ET
Table 'Lacey' 6-max Seat #2 is the button
Seat 1: warioman ($20.30 in chips)
Seat 2: Player#2174 ($18.99 in chips)
Seat 3: Player#8367 ($83.32 in chips)
Seat 4: Player#4286 ($24.58 in chips)
Seat 5: Player#4916 ($14.38 in chips)
Seat 6: Player#6672 ($43.49 in chips)
Player#8367: posts small blind $0.10
Player#4286: posts big blind $0.20
*** HOLE CARDS ***
Dealt to warioman [2s Qh]
Player#4916: raises $0.20 to $0.4
Player#6672: folds
warioman: folds
Player#2174: raises0.40 to $1
Player#8367: folds
Player#4286: folds
Player#4916: calls $0.60
*** FLOP *** [Ac 6h Jh]
Player#4916: checks
Player#2174: bets $1.00
Player#4916: calls $1.00
*** TURN *** [Ac 6h Jh] [Qs]
Player#4916: checks
Player#2174: checks
*** RIVER *** [Ac 6h Jh] [Qs] [Js]
Player#4916: bets $3.22
Player#2174: calls $3.22
*** SHOW DOWN *** 
warioman: doesn't show hand
Player#2174: doesn't show hand
Player#8367: doesn't show hand
Player#4286: doesn't show hand
Player#4916: doesn't show hand
Player#6672: doesn't show hand
Player#4916 collected $10.20 from pot
*** SUMMARY ***
Total Pot $10.74 | Rake $0.54
Board [Ac 6h Jh Qs Js]
Seat 1: warioman folded before the flop
Seat 2: Player#2174 (button) mucked
Seat 3: Player#8367 (small blind) folded before the flop
Seat 4: Player#4286 (big blind) folded before the flop
Seat 5: Player#4916 shows [Ah Js] and won ($10.20) with 
Seat 6: Player#6672 folded before the flop

PokerStars Hand #6e5c05e5-d3c3-4238-b85a-04241f5a13a5:  Hold'em No Limit ($0.1/$0.20 USD) - 2021/11/20 22:54:00 ET
Table 'Lacey' 6-max Seat #1 is the button
Seat 1: warioman ($20.30 in chips)
Seat 2: Player#2112 ($19.09 in chips)
Seat 3: Player#7192 ($83.92 in chips)
Seat 4: Player#3593 ($24.58 in chips)
Seat 5: Player#0734 ($14.38 in chips)
Seat 6: Player#9689 ($42.85 in chips)
Player#2112: posts small blind $0.10
Player#7192: posts big blind $0.20
*** HOLE CARDS ***
Dealt to warioman [5h 8d]
Player#3593: folds
Player#0734: folds
Player#9689: raises $0.20 to $0.6
warioman: folds
Player#2112: folds
Player#7192: calls $0.40
*** FLOP *** [Qd 6d 8c]
Player#7192: checks
Player#9689: checks
*** TURN *** [Qd 6d 8c] [2s]
Player#7192: checks
Player#9689: checks
*** RIVER *** [Qd 6d 8c] [2s] [9s]
Player#7192: checks
Player#9689: checks
*** SHOW DOWN *** 
Player#9689 collected $1.24 from pot
*** SUMMARY ***
Total Pot $1.30 | Rake $0.07
Board [Qd 6d 8c 2s 9s]
Seat 1: warioman (button) folded before the flop
Seat 2: Player#2112 (small blind) folded before the flop
Seat 3: Player#7192 (big blind) mucked
Seat 4: Player#3593 folded before the flop
Seat 5: Player#0734 folded before the flop
Seat 6: Player#9689 shows [Jh 8h] and won ($1.24) with 

PokerStars Hand #66ae09d1-03a0-44a0-b194-cae4180ed5d0:  Hold'em No Limit ($0.1/$0.20 USD) - 2021/11/20 22:54:00 ET
Table 'Lacey' 6-max Seat #6 is the button
Seat 1: warioman ($20.40 in chips)
Seat 2: Player#7907 ($18.95 in chips)
Seat 3: Player#6658 ($83.92 in chips)
Seat 4: Player#9414 ($24.58 in chips)
Seat 5: Player#3396 ($14.25 in chips)
Seat 6: Player#7607 ($43.05 in chips)
warioman: posts small blind $0.10
Player#7907: posts big blind $0.20
*** HOLE CARDS ***
Dealt to warioman [Qs 4c]
Player#6658: folds
Player#9414: folds
Player#3396: calls $0.20
Player#7607: calls $0.20
warioman: folds
Player#7907: checks
*** FLOP *** [5c Kc Jd]
Player#7907: checks
Player#3396: checks
Player#7607: checks
*** TURN *** [5c Kc Jd] [Js]
Player#7907: checks
Player#3396: checks
Player#7607: checks
*** RIVER *** [5c Kc Jd] [Js] [Ts]
Player#7907: checks
Player#3396: checks
Player#7607: checks
*** SHOW DOWN *** 
Player#3396 collected $0.66 from pot
*** SUMMARY ***
Total Pot $0.70 | Rake $0.03
Board [5c Kc Jd Js Ts]
Seat 1: warioman (small blind) folded before the flop
Seat 2: Player#7907 (big blind) mucked
Seat 3: Player#6658 folded before the flop
Seat 4: Player#9414 folded before the flop
Seat 5: Player#3396 shows [Qh 8h] and won ($0.66) with 
Seat 6: Player#7607 (button) mucked

PokerStars Hand #7139d2ed-4248-444c-9bc9-59f637e2aed3:  Hold'em No Limit ($0.1/$0.20 USD) - 2021/11/20 22:54:00 ET
Table 'Denver' 6-max Seat #4 is the button
Seat 1: Player#2756 ($20.60 in chips)
Seat 2: Player#2215 ($24.18 in chips)
Seat 3: Player#4673 ($47.51 in chips)
Seat 4: warioman ($24.02 in chips)
Seat 5: Player#6813 ($6.79 in chips)
Seat 6: Player#7705 ($17.00 in chips)
Player#6813: posts small blind $0.10
Player#7705: posts big blind $0.20
*** HOLE CARDS ***
Dealt to warioman [8c 8s]
Player#2756: folds
Player#2215: raises $0.20 to $0.6
Player#4673: calls $0.60
warioman: calls $0.60
Player#6813: folds
Player#7705: calls $0.40
*** FLOP *** [5s 4c 8h]
Player#7705: bets $0.20
Player#2215: calls $0.20
Player#4673: raises $0.20 to $0.8
warioman: calls $0.80
Player#7705: calls $0.60
Player#2215: calls $0.60
*** TURN *** [5s 4c 8h] [6h]
Player#7705: checks
Player#2215: checks
Player#4673: bets $2.85
warioman: calls $2.85
Player#7705: raises $2.85 to $5.7
Player#2215: folds
Player#4673: calls $2.85
warioman: calls $2.85
*** RIVER *** [5s 4c 8h] [6h] [7h]
Player#7705: bets $0.20
Player#4673: raises $0.20 to $23.4
warioman: folds
Player#7705: folds
Player#4673: doesn't show hand
Uncalled bet ($23.40) returned to Player#4673
Player#4673 collected $21.85 from pot
*** SUMMARY ***
Total Pot $23.00 | Rake $1.15
Board [5s 4c 8h 6h 7h]
Seat 1: Player#2756 folded before the flop
Seat 2: Player#2215 folded on the turn
Seat 3: Player#4673 shows [] and won ($21.85) with 
Seat 4: warioman (button) folded on the river
Seat 5: Player#6813 (small blind) folded before the flop
Seat 6: Player#7705 (big blind) folded on the river

PokerStars Hand #a361520a-9792-4f37-9774-daf4b3030a2b:  Hold'em No Limit ($0.1/$0.20 USD) - 2021/11/20 22:53:00 ET
Table 'Denver' 6-max Seat #5 is the button
Seat 1: Player#0716 ($20.60 in chips)
Seat 2: Player#0324 ($24.18 in chips)
Seat 3: Player#1706 ($46.87 in chips)
Seat 4: warioman ($24.12 in chips)
Seat 5: Player#7097 ($7.39 in chips)
Seat 6: Player#6658 ($17.00 in chips)
Player#6658: posts small blind $0.10
warioman: posts big blind $0.20
*** HOLE CARDS ***
Dealt to warioman [8h 6h]
Player#6658 Waiting
Player#0716: folds
Player#0324: folds
Player#1706: calls $0.20
warioman: folds
Player#7097: checks
*** FLOP *** [6s Qh 2s]
Player#7097: checks
Player#1706: bets $0.40
Player#7097: calls $0.40
*** TURN *** [6s Qh 2s] [Ah]
Player#7097: checks
Player#1706: bets $1.00
Player#7097: folds
Player#1706: doesn't show hand
Uncalled bet ($1.00) returned to Player#1706
Player#1706 collected $1.23 from pot
*** SUMMARY ***
Total Pot $1.30 | Rake $0.06
Board [6s Qh 2s Ah]
Seat 1: Player#0716 folded before the flop
Seat 2: Player#0324 folded before the flop
Seat 3: Player#1706 shows [] and won ($1.23) with 
Seat 4: warioman (big blind) folded before the flop
Seat 5: Player#7097 (button) folded on the turn
Seat 6: Player#6658 (small blind) mucked

PokerStars Hand #8a574b71-e248-4291-969f-bebe2688e30b:  Hold'em No Limit ($0.1/$0.20 USD) - 2021/11/20 22:52:00 ET
Table 'Lacey' 6-max Seat #5 is the button
Seat 1: warioman ($20.60 in chips)
Seat 2: Player#6794 ($19.70 in chips)
Seat 3: Player#6601 ($76.76 in chips)
Seat 4: Player#4197 ($31.42 in chips)
Seat 5: Player#5880 ($14.25 in chips)
Seat 6: Player#8905 ($43.15 in chips)
Player#8905: posts small blind $0.10
warioman: posts big blind $0.20
*** HOLE CARDS ***
Dealt to warioman [2h 2s]
Player#6794: raises $0.20 to $0.4
Player#6601: raises $0.40 to $0.75
Player#4197: calls $0.75
Player#5880: folds
Player#8905: folds
warioman: folds
Player#6794: calls $0.35
*** FLOP *** [Ad 8h 3d]
Player#6794: checks
Player#6601: bets $1.67
Player#4197: calls $1.67
Player#6794: folds
*** TURN *** [Ad 8h 3d] [Js]
Player#6601: bets $4.42
Player#4197: calls $4.42
*** RIVER *** [Ad 8h 3d] [Js] [As]
Player#6601: bets $11.45
Player#4197: folds
Player#6601: doesn't show hand
Uncalled bet ($11.45) returned to Player#6601
Player#6601 collected $13.99 from pot
*** SUMMARY ***
Total Pot $14.73 | Rake $0.74
Board [Ad 8h 3d Js As]
Seat 1: warioman (big blind) folded before the flop
Seat 2: Player#6794 folded on the flop
Seat 3: Player#6601 shows [] and won ($13.99) with 
Seat 4: Player#4197 folded on the river
Seat 5: Player#5880 (button) folded before the flop
Seat 6: Player#8905 (small blind) folded before the flop

PokerStars Hand #102f84ec-0eae-4b0a-91d8-9e7a687661ee:  Hold'em No Limit ($0.1/$0.20 USD) - 2021/11/20 22:52:00 ET
Table 'Lacey' 6-max Seat #4 is the button
Seat 1: warioman ($20.60 in chips)
Seat 2: Player#7764 ($19.70 in chips)
Seat 3: Player#6403 ($76.76 in chips)
Seat 4: Player#5570 ($31.42 in chips)
Seat 5: Player#1525 ($14.35 in chips)
Seat 6: Player#3471 ($43.05 in chips)
Player#1525: posts small blind $0.10
Player#3471: posts big blind $0.20
*** HOLE CARDS ***
Dealt to warioman [2s 4c]
warioman: folds
Player#7764: folds
Player#6403: folds
Player#5570: folds
Player#1525: folds
Player#3471 collected $0.20 from pot
*** SUMMARY ***
Total Pot $0.20 | Rake $0.00
Seat 1: warioman folded before the flop
Seat 2: Player#7764 folded before the flop
Seat 3: Player#6403 folded before the flop
Seat 4: Player#5570 (button) folded before the flop
Seat 5: Player#1525 (small blind) folded before the flop
Seat 6: Player#3471 shows [] and won ($0.20) with 

PokerStars Hand #fd490df4-054e-443f-9687-fc9cdf8d124c:  Hold'em No Limit ($0.1/$0.20 USD) - 2021/11/20 22:52:00 ET
Table 'Denver' 6-max Seat #5 is the button
Seat 1: Player#9331 ($20.60 in chips)
Seat 2: Player#1258 ($24.18 in chips)
Seat 3: Player#1246 ($46.69 in chips)
Seat 4: warioman ($24.32 in chips)
Seat 5: Player#2657 ($7.39 in chips)
Seat 6: Player#1695 ($17.00 in chips)
Player#1695: posts small blind $0.10
Player#1246: posts big blind $0.20
*** HOLE CARDS ***
Dealt to warioman [8s 9c]
Player#1695 Waiting
Player#2657: folds
Player#9331: folds
Player#1258: folds
Player#1246: calls $0.10
warioman: checks
*** FLOP *** [Jh Ac 3c]
Player#1246: bets $0.20
warioman: folds
Player#1246: doesn't show hand
Uncalled bet ($0.20) returned to Player#1246
Player#1246 collected $0.38 from pot
*** SUMMARY ***
Total Pot $0.40 | Rake $0.02
Board [Jh Ac 3c]
Seat 1: Player#9331 folded before the flop
Seat 2: Player#1258 folded before the flop
Seat 3: Player#1246 shows [] and won ($0.38) with 
Seat 4: warioman folded on the flop
Seat 5: Player#2657 (button) folded before the flop
Seat 6: Player#1695 (small blind) mucked

PokerStars Hand #620069e2-ed28-4b5b-8a5e-c7160fe06f7a:  Hold'em No Limit ($0.1/$0.20 USD) - 2021/11/20 22:51:00 ET
Table 'Lacey' 6-max Seat #3 is the button
Seat 1: warioman ($20.60 in chips)
Seat 2: Player#7235 ($19.70 in chips)
Seat 3: Player#5319 ($77.16 in chips)
Seat 4: Player#7423 ($31.82 in chips)
Seat 5: Player#4305 ($13.61 in chips)
Seat 6: Player#9051 ($43.05 in chips)
Player#7423: posts small blind $0.10
Player#4305: posts big blind $0.20
*** HOLE CARDS ***
Dealt to warioman [6d Td]
Player#9051: folds
warioman: folds
Player#7235: folds
Player#5319: calls $0.20
Player#7423: calls $0.10
Player#4305: checks
*** FLOP *** [2s Qh 7c]
Player#7423: checks
Player#4305: checks
Player#5319: checks
*** TURN *** [2s Qh 7c] [8c]
Player#7423: checks
Player#4305: bets $0.20
Player#5319: calls $0.20
Player#7423: calls $0.20
*** RIVER *** [2s Qh 7c] [8c] [Ac]
Player#7423: checks
Player#4305: bets $0.60
Player#5319: folds
Player#7423: folds
Player#4305: doesn't show hand
Uncalled bet ($0.60) returned to Player#4305
Player#4305 collected $1.14 from pot
*** SUMMARY ***
Total Pot $1.20 | Rake $0.06
Board [2s Qh 7c 8c Ac]
Seat 1: warioman folded before the flop
Seat 2: Player#7235 folded before the flop
Seat 3: Player#5319 (button) folded on the river
Seat 4: Player#7423 (small blind) folded on the river
Seat 5: Player#4305 shows [] and won ($1.14) with 
Seat 6: Player#9051 folded before the flop

PokerStars Hand #7dff12ab-e68b-48dc-9bb9-67ed89d21a16:  Hold'em No Limit ($0.1/$0.20 USD) - 2021/11/20 22:51:00 ET
Table 'Denver' 6-max Seat #5 is the button
Seat 1: Player#2450 ($21.00 in chips)
Seat 2: Player#7911 ($24.58 in chips)
Seat 3: Player#2335 ($45.89 in chips)
Seat 4: warioman ($24.32 in chips)
Seat 5: Player#4109 ($7.39 in chips)
Seat 6: Player#2102 ($17.00 in chips)
Player#2102: posts small blind $0.10
Player#7911: posts big blind $0.20
*** HOLE CARDS ***
Dealt to warioman [Jd 4s]
Player#2102 Waiting
warioman: folds
Player#4109: folds
Player#2450: raises $0.20 to $0.4
Player#7911: calls $0.30
Player#2335: raises $0.40 to $2.2
Player#2450: folds
Player#7911: folds
Player#2335: doesn't show hand
Uncalled bet ($2.20) returned to Player#2335
Player#2335 collected $0.80 from pot
*** SUMMARY ***
Total Pot $0.80 | Rake $0.00
Seat 1: Player#2450 folded before the flop
Seat 2: Player#7911 (big blind) folded before the flop
Seat 3: Player#2335 shows [] and won ($0.80) with 
Seat 4: warioman folded before the flop
Seat 5: Player#4109 (button) folded before the flop
Seat 6: Player#2102 (small blind) mucked

PokerStars Hand #fd877749-7950-4e36-9e0c-1c3629ff3c04:  Hold'em No Limit ($0.1/$0.20 USD) - 2021/11/20 22:50:00 ET
Table 'Denver' 6-max Seat #6 is the button
Seat 1: Player#0966 ($19.80 in chips)
Seat 2: Player#7010 ($24.78 in chips)
Seat 3: Player#0128 ($46.09 in chips)
Seat 4: warioman ($24.32 in chips)
Seat 5: Player#8323 ($8.19 in chips)
Seat 6: Player#4326 ($17.00 in chips)
Player#0966: posts small blind $0.10
Player#7010: posts big blind $0.20
*** HOLE CARDS ***
Dealt to warioman [Th 8d]
Player#0128: calls $0.20
warioman: folds
Player#8323: raises $0.20 to $0.8
Player#0966: raises $0.80 to $2.8
Player#7010: folds
Player#0128: folds
Player#8323: folds
Player#0966: doesn't show hand
Uncalled bet ($2.80) returned to Player#0966
Player#0966 collected $1.20 from pot
*** SUMMARY ***
Total Pot $1.20 | Rake $0.00
Seat 1: Player#0966 shows [] and won ($1.20) with 
Seat 2: Player#7010 (big blind) folded before the flop
Seat 3: Player#0128 folded before the flop
Seat 4: warioman folded before the flop
Seat 5: Player#8323 folded before the flop
Seat 6: Player#4326 (button) mucked

PokerStars Hand #813f1cff-6caf-43e0-b3e5-e919eb2fb11b:  Hold'em No Limit ($0.1/$0.20 USD) - 2021/11/20 22:50:00 ET
Table 'Lacey' 6-max Seat #2 is the button
Seat 1: warioman ($20.60 in chips)
Seat 2: Player#5221 ($19.70 in chips)
Seat 3: Player#0976 ($70.74 in chips)
Seat 4: Player#9388 ($32.02 in chips)
Seat 5: Player#5224 ($20.11 in chips)
Seat 6: Player#1768 ($43.45 in chips)
Player#0976: posts small blind $0.10
Player#9388: posts big blind $0.20
*** HOLE CARDS ***
Dealt to warioman [2d Ah]
Player#5224: raises $0.20 to $0.4
Player#1768: calls $0.40
warioman: folds
Player#5221: folds
Player#0976: calls $0.30
Player#9388: folds
*** FLOP *** [Ad 3h 4s]
Player#0976: checks
Player#5224: bets $1.00
Player#1768: folds
Player#0976: calls $1.00
*** TURN *** [Ad 3h 4s] [2s]
Player#0976: bets $1.70
Player#5224: calls $1.70
*** RIVER *** [Ad 3h 4s] [2s] [Ks]
Player#0976: bets $3.40
Player#5224: calls $3.40
*** SHOW DOWN *** 
Player#5224: doesn't show hand
Player#0976 collected $12.92 from pot
*** SUMMARY ***
Total Pot $13.60 | Rake $0.68
Board [Ad 3h 4s 2s Ks]
Seat 1: warioman folded before the flop
Seat 2: Player#5221 (button) folded before the flop
Seat 3: Player#0976 shows [6c As] and won ($12.92) with 
Seat 4: Player#9388 (big blind) folded before the flop
Seat 5: Player#5224 mucked
Seat 6: Player#1768 folded on the flop

PokerStars Hand #10c82b16-4861-4913-814e-818f9f13cf00:  Hold'em No Limit ($0.1/$0.20 USD) - 2021/11/20 22:50:00 ET
Table 'Lacey' 6-max Seat #1 is the button
Seat 1: warioman ($20.60 in chips)
Seat 2: Player#0263 ($19.80 in chips)
Seat 3: Player#3890 ($70.94 in chips)
Seat 4: Player#1242 ($32.02 in chips)
Seat 5: Player#8963 ($20.11 in chips)
Seat 6: Player#4215 ($43.15 in chips)
Player#0263: posts small blind $0.10
Player#3890: posts big blind $0.20
*** HOLE CARDS ***
Dealt to warioman [2d 9d]
Player#1242: folds
Player#8963: folds
Player#4215: raises $0.20 to $0.4
warioman: folds
Player#0263: folds
Player#3890: folds
Player#4215: doesn't show hand
Uncalled bet ($0.40) returned to Player#4215
Player#4215 collected $0.30 from pot
*** SUMMARY ***
Total Pot $0.30 | Rake $0.00
Seat 1: warioman (button) folded before the flop
Seat 2: Player#0263 (small blind) folded before the flop
Seat 3: Player#3890 (big blind) folded before the flop
Seat 4: Player#1242 folded before the flop
Seat 5: Player#8963 folded before the flop
Seat 6: Player#4215 shows [] and won ($0.30) with 

PokerStars Hand #f145d8c6-138f-4a2e-b347-4fcca652d684:  Hold'em No Limit ($0.1/$0.20 USD) - 2021/11/20 22:49:00 ET
Table 'Lacey' 6-max Seat #6 is the button
Seat 1: warioman ($20.70 in chips)
Seat 2: Player#7186 ($20.00 in chips)
Seat 3: Player#3333 ($70.94 in chips)
Seat 4: Player#3528 ($32.02 in chips)
Seat 5: Player#8663 ($20.71 in chips)
Seat 6: Player#5141 ($42.32 in chips)
warioman: posts small blind $0.10
Player#7186: posts big blind $0.20
*** HOLE CARDS ***
Dealt to warioman [5d Ac]
Player#3333: folds
Player#3528: folds
Player#8663: calls $0.20
Player#5141: calls $0.20
warioman: folds
Player#7186: checks
*** FLOP *** [Ad 7s Tc]
Player#7186: checks
Player#8663: checks
Player#5141: checks
*** TURN *** [Ad 7s Tc] [7h]
Player#7186: checks
Player#8663: bets $0.20
Player#5141: raises $0.20 to $0.4
Player#7186: folds
Player#8663: calls $0.20
*** RIVER *** [Ad 7s Tc] [7h] [Kh]
Player#8663: checks
Player#5141: checks
*** SHOW DOWN *** 
Player#5141 collected $1.43 from pot
*** SUMMARY ***
Total Pot $1.50 | Rake $0.08
Board [Ad 7s Tc 7h Kh]
Seat 1: warioman (small blind) folded before the flop
Seat 2: Player#7186 (big blind) folded on the turn
Seat 3: Player#3333 folded before the flop
Seat 4: Player#3528 folded before the flop
Seat 5: Player#8663 mucked
Seat 6: Player#5141 shows [3d 3s] and won ($1.43) with 

PokerStars Hand #4a2fc065-8f80-4d60-adb6-a12e7500efac:  Hold'em No Limit ($0.1/$0.20 USD) - 2021/11/20 22:49:00 ET
Table 'Denver' 6-max Seat #4 is the button
Seat 1: Player#0741 ($20.00 in chips)
Seat 2: Player#5793 ($24.78 in chips)
Seat 3: Player#6791 ($50.90 in chips)
Seat 4: warioman ($19.70 in chips)
Seat 5: Player#8774 ($8.29 in chips)
Player#8774: posts small blind $0.10
Player#0741: posts big blind $0.20
*** HOLE CARDS ***
Dealt to warioman [Kc Ad]
Player#5793: folds
Player#6791: raises $0.20 to $0.8
warioman: raises $0.80 to $2.7
Player#8774: folds
Player#0741: folds
Player#6791: calls $1.90
*** FLOP *** [Qs 6h Kh]
Player#6791: checks
warioman: bets $2.11
Player#6791: calls $2.11
*** TURN *** [Qs 6h Kh] [4h]
Player#6791: checks
warioman: checks
*** RIVER *** [Qs 6h Kh] [4h] [2h]
Player#6791: checks
warioman: bets $2.98
Player#6791: folds
warioman: doesn't show hand
Uncalled bet ($2.98) returned to warioman
warioman collected $9.42 from pot
*** SUMMARY ***
Total Pot $9.92 | Rake $0.50
Board [Qs 6h Kh 4h 2h]
Seat 1: Player#0741 (big blind) folded before the flop
Seat 2: Player#5793 folded before the flop
Seat 3: Player#6791 folded on the river
Seat 4: warioman (button)
Seat 5: Player#8774 (small blind) folded before the flop

PokerStars Hand #4048409e-2644-4f35-848d-292168276881:  Hold'em No Limit ($0.1/$0.20 USD) - 2021/11/20 22:48:00 ET
Table 'Denver' 6-max Seat #3 is the button
Seat 1: Player#6181 ($20.00 in chips)
Seat 2: Player#0217 ($24.78 in chips)
Seat 3: Player#2177 ($50.90 in chips)
Seat 4: warioman ($19.50 in chips)
Seat 5: Player#2640 ($8.49 in chips)
warioman: posts small blind $0.10
Player#2640: posts big blind $0.20
*** HOLE CARDS ***
Dealt to warioman [9d Jd]
Player#6181: folds
Player#0217: folds
Player#2177: folds
warioman: raises $0.20 to $0.6
Player#2640: folds
warioman: doesn't show hand
Uncalled bet ($0.60) returned to warioman
warioman collected $0.20 from pot
*** SUMMARY ***
Total Pot $0.20 | Rake $0.00
Seat 1: Player#6181 folded before the flop
Seat 2: Player#0217 folded before the flop
Seat 3: Player#2177 (button) folded before the flop
Seat 4: warioman (small blind)
Seat 5: Player#2640 (big blind) folded before the flop

PokerStars Hand #932ed41d-0bdf-4851-baaa-d9e4650e4531:  Hold'em No Limit ($0.1/$0.20 USD) - 2021/11/20 22:48:00 ET
Table 'Lacey' 6-max Seat #1 is the button
Seat 1: warioman ($21.30 in chips)
Seat 2: Player#2903 ($20.00 in chips)
Seat 3: Player#0343 ($71.34 in chips)
Seat 4: Player#5582 ($32.62 in chips)
Seat 5: Player#0565 ($20.71 in chips)
Seat 6: Player#2878 ($42.72 in chips)
Player#2903: posts small blind $0.10
Player#2878: posts big blind $0.20
*** HOLE CARDS ***
Dealt to warioman [8h 8s]
Player#2903 Waiting
Player#0343: raises $0.20 to $0.6
Player#5582: calls $0.60
Player#0565: folds
Player#2878: calls $0.50
warioman: calls $0.40
*** FLOP *** [Kh Qs Jh]
Player#2878: checks
warioman: checks
Player#0343: bets $1.00
Player#5582: folds
Player#2878: calls $1.00
warioman: folds
*** TURN *** [Kh Qs Jh] [4d]
Player#2878: checks
Player#0343: bets $2.20
Player#2878: calls $2.20
*** RIVER *** [Kh Qs Jh] [4d] [2d]
Player#2878: bets $38.92
Player#0343: calls $38.92
*** SHOW DOWN *** 
warioman: doesn't show hand
Player#0343: doesn't show hand
Player#5582: doesn't show hand
Player#0565: doesn't show hand
Player#2878: doesn't show hand
 *** SUMMARY ***
Total Pot $86.64 | Rake $1.50
Board [Kh Qs Jh 4d 2d]
Seat 1: warioman (button) folded on the flop
Seat 2: Player#2903 (small blind) mucked
Seat 3: Player#0343 mucked
Seat 4: Player#5582 folded on the flop
Seat 5: Player#0565 folded before the flop
Seat 6: Player#2878 (big blind) mucked

PokerStars Hand #a8ed25c4-dc1f-4593-bea1-82d47e905f54:  Hold'em No Limit ($0.1/$0.20 USD) - 2021/11/20 22:48:00 ET
Table 'Denver' 6-max Seat #2 is the button
Seat 1: Player#8980 ($8.69 in chips)
Seat 2: Player#2194 ($22.92 in chips)
Seat 3: Player#0875 ($52.75 in chips)
Seat 4: warioman ($19.70 in chips)
Seat 5: Player#9304 ($8.49 in chips)
Player#0875: posts small blind $0.10
warioman: posts big blind $0.20
*** HOLE CARDS ***
Dealt to warioman [8s 8d]
Player#9304: folds
Player#8980: folds
Player#2194: raises $0.20 to $0.4
Player#0875: raises $0.40 to $1.05
warioman: folds
Player#2194: calls $0.65
*** FLOP *** [4s 8h Js]
Player#0875: bets $0.80
Player#2194: raises $0.80 to $2.6
Player#0875: folds
Player#2194: doesn't show hand
Uncalled bet ($2.60) returned to Player#2194
Player#2194 collected $2.95 from pot
*** SUMMARY ***
Total Pot $3.10 | Rake $0.16
Board [4s 8h Js]
Seat 1: Player#8980 folded before the flop
Seat 2: Player#2194 shows [] and won ($2.95) with 
Seat 3: Player#0875 (small blind) folded on the flop
Seat 4: warioman (big blind) folded before the flop
Seat 5: Player#9304 folded before the flop

PokerStars Hand #8dceba80-c8da-44f9-84a0-924630ed4d87:  Hold'em No Limit ($0.1/$0.20 USD) - 2021/11/20 22:48:00 ET
Table 'Denver' 6-max Seat #1 is the button
Seat 1: Player#1501 ($8.69 in chips)
Seat 2: Player#6054 ($23.02 in chips)
Seat 3: Player#2128 ($52.65 in chips)
Seat 4: warioman ($19.70 in chips)
Seat 5: Player#8491 ($8.49 in chips)
Player#6054: posts small blind $0.10
Player#2128: posts big blind $0.20
*** HOLE CARDS ***
Dealt to warioman [7h Qd]
warioman: folds
Player#8491: folds
Player#1501: folds
Player#6054: folds
Player#2128 collected $0.20 from pot
*** SUMMARY ***
Total Pot $0.20 | Rake $0.00
Seat 1: Player#1501 (button) folded before the flop
Seat 2: Player#6054 (small blind) folded before the flop
Seat 3: Player#2128 shows [] and won ($0.20) with 
Seat 4: warioman folded before the flop
Seat 5: Player#8491 folded before the flop

PokerStars Hand #11189d3d-28e1-44f1-87b6-f89fc900d9b9:  Hold'em No Limit ($0.1/$0.20 USD) - 2021/11/20 22:47:00 ET
Table 'Lacey' 6-max Seat #1 is the button
Seat 1: warioman ($21.30 in chips)
Seat 2: Player#5189 ($20.00 in chips)
Seat 3: Player#5024 ($71.34 in chips)
Seat 4: Player#2431 ($32.62 in chips)
Seat 5: Player#5482 ($20.35 in chips)
Seat 6: Player#8354 ($43.12 in chips)
Player#5189: posts small blind $0.10
Player#5482: posts big blind $0.20
*** HOLE CARDS ***
Dealt to warioman [9d 2s]
Player#5189 Waiting
warioman: folds
Player#5024: folds
Player#2431: folds
Player#5482: raises $0.20 to $0.4
Player#8354: calls $0.20
*** FLOP *** [Ks Ah 4c]
Player#5482: bets $0.40
Player#8354: folds
Player#5482: doesn't show hand
Uncalled bet ($0.40) returned to Player#5482
Player#5482 collected $0.76 from pot
*** SUMMARY ***
Total Pot $0.80 | Rake $0.04
Board [Ks Ah 4c]
Seat 1: warioman (button) folded before the flop
Seat 2: Player#5189 (small blind) mucked
Seat 3: Player#5024 folded before the flop
Seat 4: Player#2431 folded before the flop
Seat 5: Player#5482 shows [] and won ($0.76) with 
Seat 6: Player#8354 folded on the flop

PokerStars Hand #37c8bc86-b7e8-477f-aac1-2f361e6af33b:  Hold'em No Limit ($0.1/$0.20 USD) - 2021/11/20 22:47:00 ET
Table 'Denver' 6-max Seat #6 is the button
Seat 1: Player#5249 ($8.79 in chips)
Seat 2: Player#7579 ($26.62 in chips)
Seat 3: Player#3235 ($49.31 in chips)
Seat 4: warioman ($19.70 in chips)
Seat 5: Player#7863 ($8.49 in chips)
Player#5249: posts small blind $0.10
Player#7579: posts big blind $0.20
*** HOLE CARDS ***
Dealt to warioman [As Th]
Player#3235: raises $0.20 to $0.6
warioman: folds
Player#7863: folds
Player#5249: folds
Player#7579: calls $0.40
*** FLOP *** [Qd Td 9h]
Player#7579: checks
Player#3235: bets $0.65
Player#7579: calls $0.65
*** TURN *** [Qd Td 9h] [5s]
Player#7579: checks
Player#3235: bets $2.35
Player#7579: calls $2.35
*** RIVER *** [Qd Td 9h] [5s] [Ks]
Player#7579: checks
Player#3235: checks
*** SHOW DOWN *** 
Player#3235 collected $6.94 from pot
*** SUMMARY ***
Total Pot $7.30 | Rake $0.37
Board [Qd Td 9h 5s Ks]
Seat 1: Player#5249 (small blind) folded before the flop
Seat 2: Player#7579 (big blind) mucked
Seat 3: Player#3235 shows [Qs 9s] and won ($6.94) with 
Seat 4: warioman folded before the flop
Seat 5: Player#7863 folded before the flop

PokerStars Hand #22f6524d-5c9f-44c5-a45b-87c11df9484a:  Hold'em No Limit ($0.1/$0.20 USD) - 2021/11/20 22:46:00 ET
Table 'Lacey' 6-max Seat #1 is the button
Seat 1: warioman ($21.30 in chips)
Seat 2: Player#4171 ($20.00 in chips)
Seat 3: Player#2888 ($73.54 in chips)
Seat 4: Player#2825 ($30.45 in chips)
Seat 5: Player#8674 ($20.55 in chips)
Seat 6: Player#3196 ($43.12 in chips)
Player#4171: posts small blind $0.10
Player#2825: posts big blind $0.20
*** HOLE CARDS ***
Dealt to warioman [3h 5c]
Player#4171 Waiting
Player#3196: folds
warioman: folds
Player#2888: raises $0.20 to $0.6
Player#2825: raises $0.60 to $2.2
Player#8674: folds
Player#2888: calls $1.60
*** FLOP *** [8d 2h 7d]
Player#2825: bets $2.30
Player#2888: folds
Player#2825: doesn't show hand
Uncalled bet ($2.30) returned to Player#2825
Player#2825 collected $4.37 from pot
*** SUMMARY ***
Total Pot $4.60 | Rake $0.23
Board [8d 2h 7d]
Seat 1: warioman (button) folded before the flop
Seat 2: Player#4171 (small blind) mucked
Seat 3: Player#2888 folded on the flop
Seat 4: Player#2825 shows [] and won ($4.37) with 
Seat 5: Player#8674 folded before the flop
Seat 6: Player#3196 folded before the flop

PokerStars Hand #df194cc4-1e02-41d9-a646-cffb5a04e11d:  Hold'em No Limit ($0.1/$0.20 USD) - 2021/11/20 22:46:00 ET
Table 'Denver' 6-max Seat #5 is the button
Seat 1: Player#0217 ($8.99 in chips)
Seat 2: Player#7466 ($26.62 in chips)
Seat 3: Player#3340 ($33.68 in chips)
Seat 4: warioman ($19.70 in chips)
Seat 5: Player#0107 ($8.49 in chips)
Seat 6: Player#3603 ($17.15 in chips)
Player#3603: posts small blind $0.10
Player#0217: posts big blind $0.20
*** HOLE CARDS ***
Dealt to warioman [9h Js]
Player#7466: folds
Player#3340: raises $0.20 to $0.8
warioman: folds
Player#0107: folds
Player#3603: raises $0.80 to $3.4
Player#0217: folds
Player#3340: calls $2.60
*** FLOP *** [8h 5h 4d]
Player#3603: bets $7.00
Player#3340: raises7.00 to $21
Player#3603: calls $6.75
Player#3603 Showing Pocket Cards 66
Player#3340 Showing Pocket Cards 44
*** TURN *** [8h 5h 4d] [Th]
*** RIVER *** [8h 5h 4d] [Th] [Ad]
Player#3340 collected $40.25 from pot
*** SUMMARY ***
Total Pot $41.75 | Rake $1.50
Board [8h 5h 4d Th Ad]
Seat 1: Player#0217 (big blind) folded before the flop
Seat 2: Player#7466 folded before the flop
Seat 3: Player#3340 shows [4s 4h] and won ($40.25) with 
Seat 4: warioman folded before the flop
Seat 5: Player#0107 (button) folded before the flop
Seat 6: Player#3603 (small blind) mucked

PokerStars Hand #50fa39e0-8fbc-466b-9195-8c0bcc8ed672:  Hold'em No Limit ($0.1/$0.20 USD) - 2021/11/20 22:46:00 ET
Table 'Denver' 6-max Seat #4 is the button
Seat 1: Player#0460 ($8.99 in chips)
Seat 2: Player#9502 ($26.62 in chips)
Seat 3: Player#6302 ($33.68 in chips)
Seat 4: warioman ($19.70 in chips)
Seat 5: Player#9457 ($8.29 in chips)
Seat 6: Player#0424 ($17.35 in chips)
Player#9457: posts small blind $0.10
Player#0424: posts big blind $0.20
*** HOLE CARDS ***
Dealt to warioman [8d As]
Player#0460: folds
Player#9502: folds
Player#6302: folds
warioman: folds
Player#9457: raises $0.20 to $0.6
Player#0424: folds
Player#9457: doesn't show hand
Uncalled bet ($0.60) returned to Player#9457
Player#9457 collected $0.20 from pot
*** SUMMARY ***
Total Pot $0.20 | Rake $0.00
Seat 1: Player#0460 folded before the flop
Seat 2: Player#9502 folded before the flop
Seat 3: Player#6302 folded before the flop
Seat 4: warioman (button) folded before the flop
Seat 5: Player#9457 shows [] and won ($0.20) with 
Seat 6: Player#0424 (big blind) folded before the flop

PokerStars Hand #99d27dbe-c63e-47a7-b21a-21797f8088d7:  Hold'em No Limit ($0.1/$0.20 USD) - 2021/11/20 22:46:00 ET
Table 'Lacey' 6-max Seat #1 is the button
Seat 1: warioman ($21.30 in chips)
Seat 2: Player#9171 ($73.94 in chips)
Seat 3: Player#7462 ($30.65 in chips)
Seat 4: Player#7521 ($20.00 in chips)
Seat 5: Player#9203 ($43.12 in chips)
Player#9171: posts small blind $0.10
Player#7462: posts big blind $0.20
*** HOLE CARDS ***
Dealt to warioman [9h 4c]
Player#7521 Entry Bet 0.2
Player#7521: checks
Player#9203: folds
warioman: folds
Player#9171: calls $0.10
Player#7462: checks
*** FLOP *** [2c 7h 8h]
Player#9171: checks
Player#7462: checks
Player#7521: bets $0.20
Player#9171: calls $0.20
Player#7462: folds
*** TURN *** [2c 7h 8h] [Jc]
Player#9171: checks
Player#7521: bets $0.60
Player#9171: folds
Player#7521: doesn't show hand
Uncalled bet ($0.60) returned to Player#7521
Player#7521 collected $0.76 from pot
*** SUMMARY ***
Total Pot $0.80 | Rake $0.04
Board [2c 7h 8h Jc]
Seat 1: warioman (button) folded before the flop
Seat 2: Player#9171 (small blind) folded on the turn
Seat 3: Player#7462 (big blind) folded on the flop
Seat 4: Player#7521 shows [] and won ($0.76) with 
Seat 5: Player#9203 folded before the flop

PokerStars Hand #2d4a616a-e639-4c94-b3fc-921fda59b8bf:  Hold'em No Limit ($0.1/$0.20 USD) - 2021/11/20 22:45:00 ET
Table 'Denver' 6-max Seat #3 is the button
Seat 1: Player#4952 ($8.99 in chips)
Seat 2: Player#4119 ($27.02 in chips)
Seat 3: Player#8204 ($32.98 in chips)
Seat 4: warioman ($19.80 in chips)
Seat 5: Player#6213 ($8.49 in chips)
Seat 6: Player#5535 ($17.35 in chips)
warioman: posts small blind $0.10
Player#6213: posts big blind $0.20
*** HOLE CARDS ***
Dealt to warioman [Ts 6d]
Player#5535: folds
Player#4952: folds
Player#4119: raises $0.20 to $0.4
Player#8204: raises $0.40 to $1.13
warioman: folds
Player#6213: folds
Player#4119: folds
Player#8204: doesn't show hand
Uncalled bet ($1.13) returned to Player#8204
Player#8204 collected $0.70 from pot
*** SUMMARY ***
Total Pot $0.70 | Rake $0.00
Seat 1: Player#4952 folded before the flop
Seat 2: Player#4119 folded before the flop
Seat 3: Player#8204 shows [] and won ($0.70) with 
Seat 4: warioman (small blind) folded before the flop
Seat 5: Player#6213 (big blind) folded before the flop
Seat 6: Player#5535 folded before the flop

PokerStars Hand #69217ae1-147f-4bcb-9d65-d43de77d0429:  Hold'em No Limit ($0.1/$0.20 USD) - 2021/11/20 22:45:00 ET
Table 'Lacey' 6-max Seat #6 is the button
Seat 1: warioman ($20.94 in chips)
Seat 2: Player#1656 ($74.34 in chips)
Seat 3: Player#6674 ($30.65 in chips)
Seat 4: Player#6376 ($43.12 in chips)
warioman: posts small blind $0.10
Player#1656: posts big blind $0.20
*** HOLE CARDS ***
Dealt to warioman [Th Jd]
Player#6674: folds
Player#6376: folds
warioman: calls $0.10
Player#1656: checks
*** FLOP *** [2h Ts 3s]
warioman: checks
Player#1656: checks
*** TURN *** [2h Ts 3s] [8h]
warioman: bets $0.20
Player#1656: calls $0.20
*** RIVER *** [2h Ts 3s] [8h] [3h]
warioman: checks
Player#1656: checks
*** SHOW DOWN *** 
warioman collected $0.76 from pot
*** SUMMARY ***
Total Pot $0.80 | Rake $0.04
Board [2h Ts 3s 8h 3h]
Seat 1: warioman (small blind)
Seat 2: Player#1656 (big blind) mucked
Seat 3: Player#6674 folded before the flop
Seat 4: Player#6376 folded before the flop

PokerStars Hand #4ada9d38-82f0-4150-a655-5cfee01a37bb:  Hold'em No Limit ($0.1/$0.20 USD) - 2021/11/20 22:45:00 ET
Table 'Lacey' 6-max Seat #3 is the button
Seat 1: warioman ($21.14 in chips)
Seat 2: Player#0738 ($74.34 in chips)
Seat 3: Player#4747 ($30.65 in chips)
Seat 4: Player#0130 ($42.94 in chips)
Player#0130: posts small blind $0.10
warioman: posts big blind $0.20
*** HOLE CARDS ***
Dealt to warioman [2d Kh]
Player#0738: folds
Player#4747: folds
Player#0130: calls $0.10
warioman: checks
*** FLOP *** [9s Js 6c]
Player#0130: bets $0.40
warioman: folds
Player#0130: doesn't show hand
Uncalled bet ($0.40) returned to Player#0130
Player#0130 collected $0.38 from pot
*** SUMMARY ***
Total Pot $0.40 | Rake $0.02
Board [9s Js 6c]
Seat 1: warioman (big blind) folded on the flop
Seat 2: Player#0738 folded before the flop
Seat 3: Player#4747 (button) folded before the flop
Seat 4: Player#0130 shows [] and won ($0.38) with 

PokerStars Hand #0b43cb34-6ae1-4a84-aaae-75f5d09a22ea:  Hold'em No Limit ($0.1/$0.20 USD) - 2021/11/20 22:44:00 ET
Table 'Denver' 6-max Seat #4 is the button
Seat 1: Player#0511 ($10.89 in chips)
Seat 2: Player#2113 ($23.98 in chips)
Seat 3: Player#7491 ($33.58 in chips)
Seat 4: warioman ($20.00 in chips)
Seat 5: Player#8197 ($8.49 in chips)
Seat 6: Player#8143 ($17.95 in chips)
Player#8197: posts small blind $0.10
Player#7491: posts big blind $0.20
*** HOLE CARDS ***
Dealt to warioman [9c 2h]
Player#8197 Waiting
Player#8143: raises $0.20 to $0.6
Player#0511: calls $0.60
Player#2113: calls $0.60
Player#7491: calls $0.50
warioman: folds
*** FLOP *** [Kd 5h 3c]
Player#7491: checks
Player#8143: checks
Player#0511: bets $1.30
Player#2113: calls $1.30
Player#7491: folds
Player#8143: folds
*** TURN *** [Kd 5h 3c] [Qs]
Player#0511: checks
Player#2113: bets $1.00
Player#0511: folds
Player#2113: doesn't show hand
Uncalled bet ($1.00) returned to Player#2113
Player#2113 collected $4.94 from pot
*** SUMMARY ***
Total Pot $5.20 | Rake $0.26
Board [Kd 5h 3c Qs]
Seat 1: Player#0511 folded on the turn
Seat 2: Player#2113 shows [] and won ($4.94) with 
Seat 3: Player#7491 (big blind) folded on the flop
Seat 4: warioman (button) folded before the flop
Seat 5: Player#8197 (small blind) mucked
Seat 6: Player#8143 folded on the flop

PokerStars Hand #1a578888-ab3e-454a-bd8f-c80746e1a5ed:  Hold'em No Limit ($0.1/$0.20 USD) - 2021/11/20 22:44:00 ET
Table 'Lacey' 6-max Seat #2 is the button
Seat 1: warioman ($21.14 in chips)
Seat 2: Player#3500 ($74.31 in chips)
Seat 3: Player#6723 ($30.62 in chips)
Seat 4: Player#5803 ($43.14 in chips)
Player#6723: posts small blind $0.10
Player#5803: posts big blind $0.20
*** HOLE CARDS ***
Dealt to warioman [4c Jh]
warioman: folds
Player#3500: raises $0.20 to $0.6
Player#6723: calls $0.50
Player#5803: folds
*** FLOP *** [4d Jc Ks]
Player#6723: checks
Player#3500: checks
*** TURN *** [4d Jc Ks] [2s]
Player#6723: bets $0.70
Player#3500: calls $0.70
*** RIVER *** [4d Jc Ks] [2s] [4s]
Player#6723: checks
Player#3500: checks
*** SHOW DOWN *** 
Player#6723 collected $2.66 from pot
*** SUMMARY ***
Total Pot $2.80 | Rake $0.14
Board [4d Jc Ks 2s 4s]
Seat 1: warioman folded before the flop
Seat 2: Player#3500 (button) mucked
Seat 3: Player#6723 shows [Js Ts] and won ($2.66) with 
Seat 4: Player#5803 (big blind) folded before the flop

PokerStars Hand #c57dc5db-bbd9-4651-baea-04f7f5b1e391:  Hold'em No Limit ($0.1/$0.20 USD) - 2021/11/20 22:43:00 ET
Table 'Denver' 6-max Seat #3 is the button
Seat 1: Player#4911 ($10.89 in chips)
Seat 2: Player#1871 ($32.43 in chips)
Seat 3: Player#9176 ($25.40 in chips)
Seat 4: warioman ($20.00 in chips)
Seat 5: Player#2736 ($8.49 in chips)
Seat 6: Player#7246 ($18.55 in chips)
warioman: posts small blind $0.10
Player#2736: posts big blind $0.20
*** HOLE CARDS ***
Dealt to warioman []
warioman Waiting
Player#2736 Waiting
Player#7246: raises $0.20 to $0.6
Player#4911: folds
Player#1871: calls $0.50
Player#9176: calls $0.40
*** FLOP *** [Tc 2c 5h]
Player#1871: checks
Player#9176: checks
Player#7246: checks
*** TURN *** [Tc 2c 5h] [2h]
Player#1871: bets $0.80
Player#9176: calls $0.80
Player#7246: folds
*** RIVER *** [Tc 2c 5h] [2h] [Kh]
Player#1871: bets $2.00
Player#9176: raises $2.00 to $7.05
Player#1871: calls $5.05
*** SHOW DOWN *** 
Player#1871: doesn't show hand
Player#9176 collected $16.62 from pot
*** SUMMARY ***
Total Pot $17.50 | Rake $0.88
Board [Tc 2c 5h 2h Kh]
Seat 1: Player#4911 folded before the flop
Seat 2: Player#1871 mucked
Seat 3: Player#9176 shows [2s Ts] and won ($16.62) with 
Seat 4: warioman (small blind)
Seat 5: Player#2736 (big blind) mucked
Seat 6: Player#7246 folded on the turn

PokerStars Hand #736ef161-6c02-468e-9160-96ddda1735bc:  Hold'em No Limit ($0.1/$0.20 USD) - 2021/11/20 22:43:00 ET
Table 'Lacey' 6-max Seat #1 is the button
Seat 1: warioman ($21.14 in chips)
Seat 2: Player#1646 ($74.13 in chips)
Seat 3: Player#2326 ($30.82 in chips)
Seat 4: Player#0429 ($43.14 in chips)
Player#1646: posts small blind $0.10
Player#2326: posts big blind $0.20
*** HOLE CARDS ***
Dealt to warioman [Jd 8s]
Player#0429: folds
warioman: folds
Player#1646: calls $0.10
Player#2326: checks
*** FLOP *** [Tc 7d Jc]
Player#1646: checks
Player#2326: checks
*** TURN *** [Tc 7d Jc] [4s]
Player#1646: checks
Player#2326: checks
*** RIVER *** [Tc 7d Jc] [4s] [As]
Player#1646: checks
Player#2326: checks
*** SHOW DOWN *** 
Player#1646 collected $0.38 from pot
*** SUMMARY ***
Total Pot $0.40 | Rake $0.02
Board [Tc 7d Jc 4s As]
Seat 1: warioman (button) folded before the flop
Seat 2: Player#1646 shows [5d Td] and won ($0.38) with 
Seat 3: Player#2326 (big blind) mucked
Seat 4: Player#0429 folded before the flop

PokerStars Hand #e1adf8e2-b44f-485b-ba47-b58bae8c673f:  Hold'em No Limit ($0.1/$0.20 USD) - 2021/11/20 22:43:00 ET
Table 'Lacey' 6-max Seat #6 is the button
Seat 1: warioman ($20.54 in chips)
Seat 2: Player#6445 ($74.33 in chips)
Seat 3: Player#2914 ($30.82 in chips)
Seat 4: Player#0057 ($43.54 in chips)
warioman: posts small blind $0.10
Player#6445: posts big blind $0.20
*** HOLE CARDS ***
Dealt to warioman [Kh Th]
Player#2914: folds
Player#0057: raises $0.20 to $0.4
warioman: raises $0.40 to $1.6
Player#6445: folds
Player#0057: folds
warioman: doesn't show hand
Uncalled bet ($1.60) returned to warioman
warioman collected $0.60 from pot
*** SUMMARY ***
Total Pot $0.60 | Rake $0.00
Seat 1: warioman (small blind)
Seat 2: Player#6445 (big blind) folded before the flop
Seat 3: Player#2914 folded before the flop
Seat 4: Player#0057 folded before the flop

PokerStars Hand #05ce61d4-499a-4f32-9e11-e0be376ce210:  Hold'em No Limit ($0.1/$0.20 USD) - 2021/11/20 22:43:00 ET
Table 'Denver' 6-max Seat #3 is the button
Seat 1: Player#5118 ($10.99 in chips)
Seat 2: Player#4147 ($32.63 in chips)
Seat 3: Player#4196 ($25.60 in chips)
Seat 4: warioman ($20.00 in chips)
Seat 5: Player#9158 ($8.49 in chips)
Seat 6: Player#4594 ($18.08 in chips)
warioman: posts small blind $0.10
Player#9158: posts big blind $0.20
*** HOLE CARDS ***
Dealt to warioman []
warioman Waiting
Player#9158 Waiting
Player#4196: calls $0.20
Player#4594: calls $0.20
Player#5118: folds
Player#4147: checks
*** FLOP *** [6c Kd Kc]
Player#4147: checks
Player#4196: checks
Player#4594: bets $0.60
Player#4147: folds
Player#4196: folds
Player#4594: doesn't show hand
Uncalled bet ($0.60) returned to Player#4594
Player#4594 collected $0.66 from pot
*** SUMMARY ***
Total Pot $0.70 | Rake $0.03
Board [6c Kd Kc]
Seat 1: Player#5118 folded before the flop
Seat 2: Player#4147 folded on the flop
Seat 3: Player#4196 (button) folded on the flop
Seat 4: warioman (small blind)
Seat 5: Player#9158 (big blind) mucked
Seat 6: Player#4594 shows [] and won ($0.66) with 

PokerStars Hand #187dca79-7b7c-45ed-a334-79a9f4104a23:  Hold'em No Limit ($0.1/$0.20 USD) - 2021/11/20 22:43:00 ET
Table 'Lacey' 6-max Seat #3 is the button
Seat 1: warioman ($20.00 in chips)
Seat 2: Player#0334 ($74.33 in chips)
Seat 3: Player#9284 ($30.82 in chips)
Seat 4: Player#4416 ($44.14 in chips)
Player#4416: posts small blind $0.10
warioman: posts big blind $0.20
*** HOLE CARDS ***
Dealt to warioman [Kh 5c]
Player#0334: folds
Player#9284: folds
Player#4416: calls $0.10
warioman: checks
*** FLOP *** [3d 2c 6d]
Player#4416: checks
warioman: checks
*** TURN *** [3d 2c 6d] [2h]
Player#4416: bets $0.20
warioman: calls $0.20
*** RIVER *** [3d 2c 6d] [2h] [Kh]
Player#4416: bets $0.20
warioman: calls $0.20
*** SHOW DOWN *** 
warioman collected $1.14 from pot
*** SUMMARY ***
Total Pot $1.20 | Rake $0.06
Board [3d 2c 6d 2h Kh]
Seat 1: warioman (big blind)
Seat 2: Player#0334 folded before the flop
Seat 3: Player#9284 (button) folded before the flop
Seat 4: Player#4416 (small blind) mucked

PokerStars Hand #ec0d2961-7a47-488a-af4e-49ff413ac535:  Hold'em No Limit ($0.1/$0.20 USD) - 2021/11/20 22:43:00 ET
Table 'Denver' 6-max Seat #5 is the button
Seat 1: Player#8895 ($11.19 in chips)
Seat 2: Player#4693 ($32.63 in chips)
Seat 3: Player#3990 ($25.32 in chips)
Seat 4: warioman ($20.00 in chips)
Seat 5: Player#8934 ($8.49 in chips)
Seat 6: Player#7055 ($18.18 in chips)
Player#7055: posts small blind $0.10
Player#8895: posts big blind $0.20
*** HOLE CARDS ***
Dealt to warioman []
Player#4693: folds
Player#3990: calls $0.20
Player#7055: folds
Player#8895: checks
*** FLOP *** [4h Kd Kc]
Player#8895: checks
Player#3990: bets $0.40
Player#8895: folds
Player#3990: doesn't show hand
Uncalled bet ($0.40) returned to Player#3990
Player#3990 collected $0.47 from pot
*** SUMMARY ***
Total Pot $0.50 | Rake $0.03
Board [4h Kd Kc]
Seat 1: Player#8895 (big blind) folded on the flop
Seat 2: Player#4693 folded before the flop
Seat 3: Player#3990 shows [] and won ($0.47) with 
Seat 4: warioman
Seat 5: Player#8934 (button) mucked
Seat 6: Player#7055 (small blind) folded before the flop

PokerStars Hand #69599a44-fe4c-460f-9b5c-2459f70fc67a:  Hold'em No Limit ($0.1/$0.20 USD) - 2021/11/20 15:55:00 ET
Table 'Bel Air' 6-max Seat #6 is the button
Seat 1: warioman ($20.18 in chips)
Seat 2: Player#2424 ($16.90 in chips)
Seat 3: Player#0730 ($27.57 in chips)
Seat 4: Player#8217 ($23.10 in chips)
Seat 5: Player#0939 ($107.09 in chips)
warioman: posts small blind $0.10
Player#2424: posts big blind $0.20
*** HOLE CARDS ***
Dealt to warioman [Qc 9s]
Player#0730: folds
Player#8217: folds
Player#0939: raises0.20 to $1
warioman: folds
Player#2424: calls $0.80
*** FLOP *** [3d 7d 6c]
Player#2424: bets $0.20
Player#0939: raises $ 100.20 to $06.09
Player#2424: folds
Player#0939: doesn't show hand
Uncalled bet ($106.09) returned to Player#0939
Player#0939 collected $2.18 from pot
*** SUMMARY ***
Total Pot $2.30 | Rake $0.11
Board [3d 7d 6c]
Seat 1: warioman (small blind) folded before the flop
Seat 2: Player#2424 (big blind) folded on the flop
Seat 3: Player#0730 folded before the flop
Seat 4: Player#8217 folded before the flop
Seat 5: Player#0939 shows [] and won ($2.18) with 

PokerStars Hand #74d27c3d-be19-4f53-b3ca-98275f592e29:  Hold'em No Limit ($0.1/$0.20 USD) - 2021/11/20 15:55:00 ET
Table 'Bel Air' 6-max Seat #4 is the button
Seat 1: warioman ($20.00 in chips)
Seat 2: Player#8169 ($16.90 in chips)
Seat 3: Player#1623 ($27.57 in chips)
Seat 4: Player#9884 ($23.10 in chips)
Seat 5: Player#3794 ($107.29 in chips)
Player#3794: posts small blind $0.10
warioman: posts big blind $0.20
*** HOLE CARDS ***
Dealt to warioman [Ks 6h]
Player#8169: folds
Player#1623: folds
Player#9884: folds
Player#3794: calls $0.10
warioman: checks
*** FLOP *** [7d Qh 7c]
Player#3794: checks
warioman: checks
*** TURN *** [7d Qh 7c] [7h]
Player#3794: checks
warioman: checks
*** RIVER *** [7d Qh 7c] [7h] [8h]
Player#3794: checks
warioman: checks
*** SHOW DOWN *** 
warioman collected $0.38 from pot
*** SUMMARY ***
Total Pot $0.40 | Rake $0.02
Board [7d Qh 7c 7h 8h]
Seat 1: warioman (big blind)
Seat 2: Player#8169 folded before the flop
Seat 3: Player#1623 folded before the flop
Seat 4: Player#9884 (button) folded before the flop
Seat 5: Player#3794 (small blind) mucked

PokerStars Hand #8219c604-a931-4067-bf0b-57e52312a633:  Hold'em No Limit ($0.05/$0.10 USD) - 2021/11/20 15:55:00 ET
Table 'Cathedral City' 6-max Seat #1 is the button
Seat 1: Player#5043 ($7.20 in chips)
Seat 2: warioman ($8.85 in chips)
Seat 3: Player#5716 ($32.38 in chips)
Seat 4: Player#9188 ($9.70 in chips)
Seat 5: Player#0070 ($29.72 in chips)
Seat 6: Player#9416 ($9.10 in chips)
warioman: posts small blind $0.05
Player#5716: posts big blind $0.10
*** HOLE CARDS ***
Dealt to warioman [6h 5h]
Player#9188: calls $0.10
Player#0070: folds
Player#9416: folds
Player#5043: calls $0.10
warioman: calls $0.05
Player#5716: checks
*** FLOP *** [2d Qc Kh]
warioman: checks
Player#5716: checks
Player#9188: checks
Player#5043: checks
*** TURN *** [2d Qc Kh] [Qd]
warioman: checks
Player#5716: checks
Player#9188: checks
Player#5043: checks
*** RIVER *** [2d Qc Kh] [Qd] [2d]
warioman: checks
Player#5716: checks
Player#9188: bets $0.40
Player#5043: folds
warioman: folds
Player#5716: calls $0.40
*** SHOW DOWN *** 
Player#5716 collected $1.14 from pot
*** SUMMARY ***
Total Pot $1.20 | Rake $0.06
Board [2d Qc Kh Qd 2d]
Seat 1: Player#5043 (button) folded on the river
Seat 2: warioman (small blind) folded on the river
Seat 3: Player#5716 shows [Ac Ts] and won ($1.14) with 
Seat 4: Player#9188 mucked
Seat 5: Player#0070 folded before the flop
Seat 6: Player#9416 folded before the flop

PokerStars Hand #11cb3498-f745-4daa-868d-7011517aaa2c:  Hold'em No Limit ($0.1/$0.20 USD) - 2021/11/20 15:55:00 ET
Table 'Bel Air' 6-max Seat #3 is the button
Seat 1: warioman ($8.00 in chips)
Seat 2: Player#0995 ($16.90 in chips)
Seat 3: Player#7183 ($27.57 in chips)
Seat 4: Player#7027 ($23.20 in chips)
Seat 5: Player#1962 ($107.19 in chips)
Player#7027: posts small blind $0.10
Player#1962: posts big blind $0.20
*** HOLE CARDS ***
Dealt to warioman [2h 9d]
warioman: folds
Player#0995: folds
Player#7183: folds
Player#7027: folds
Player#1962 collected $0.20 from pot
*** SUMMARY ***
Total Pot $0.20 | Rake $0.00
Seat 1: warioman folded before the flop
Seat 2: Player#0995 folded before the flop
Seat 3: Player#7183 (button) folded before the flop
Seat 4: Player#7027 (small blind) folded before the flop
Seat 5: Player#1962 shows [] and won ($0.20) with 

PokerStars Hand #faf4de34-b6e1-43ef-bbfd-ac8b28397c2b:  Hold'em No Limit ($0.1/$0.20 USD) - 2021/11/20 15:54:00 ET
Table 'Bel Air' 6-max Seat #2 is the button
Seat 1: warioman ($8.00 in chips)
Seat 2: Player#8905 ($16.90 in chips)
Seat 3: Player#4977 ($27.67 in chips)
Seat 4: Player#1053 ($23.40 in chips)
Seat 5: Player#3615 ($106.89 in chips)
Player#4977: posts small blind $0.10
Player#1053: posts big blind $0.20
*** HOLE CARDS ***
Dealt to warioman [As 5d]
Player#3615: raises0.20 to $1
warioman: folds
Player#8905: folds
Player#4977: folds
Player#1053: folds
Player#3615: doesn't show hand
Uncalled bet ($1.00) returned to Player#3615
Player#3615 collected $0.30 from pot
*** SUMMARY ***
Total Pot $0.30 | Rake $0.00
Seat 1: warioman folded before the flop
Seat 2: Player#8905 (button) folded before the flop
Seat 3: Player#4977 (small blind) folded before the flop
Seat 4: Player#1053 (big blind) folded before the flop
Seat 5: Player#3615 shows [] and won ($0.30) with 

PokerStars Hand #e6c318ab-27ae-4f85-9c64-0788cb56d070:  Hold'em No Limit ($0.1/$0.20 USD) - 2021/11/20 15:54:00 ET
Table 'Bel Air' 6-max Seat #1 is the button
Seat 1: warioman ($8.00 in chips)
Seat 2: Player#2382 ($17.00 in chips)
Seat 3: Player#4089 ($27.87 in chips)
Seat 4: Player#8309 ($22.57 in chips)
Seat 5: Player#9495 ($107.49 in chips)
Player#2382: posts small blind $0.10
Player#4089: posts big blind $0.20
*** HOLE CARDS ***
Dealt to warioman [3s Kd]
Player#8309: raises $0.20 to $0.6
Player#9495: calls $0.60
warioman: folds
Player#2382: folds
Player#4089: folds
*** FLOP *** [8s 4c 4h]
Player#8309: bets $1.00
Player#9495: folds
Player#8309: doesn't show hand
Uncalled bet ($1.00) returned to Player#8309
Player#8309 collected $1.43 from pot
*** SUMMARY ***
Total Pot $1.50 | Rake $0.08
Board [8s 4c 4h]
Seat 1: warioman (button) folded before the flop
Seat 2: Player#2382 (small blind) folded before the flop
Seat 3: Player#4089 (big blind) folded before the flop
Seat 4: Player#8309 shows [] and won ($1.43) with 
Seat 5: Player#9495 folded on the flop

PokerStars Hand #5968da25-98db-4170-8f3e-58c6f758fcbb:  Hold'em No Limit ($0.05/$0.10 USD) - 2021/11/20 15:53:00 ET
Table 'Cathedral City' 6-max Seat #6 is the button
Seat 1: Player#7966 ($7.25 in chips)
Seat 2: warioman ($10.00 in chips)
Seat 3: Player#1250 ($30.63 in chips)
Seat 4: Player#0583 ($10.05 in chips)
Seat 5: Player#9097 ($29.72 in chips)
Seat 6: Player#0265 ($9.45 in chips)
Player#7966: posts small blind $0.05
warioman: posts big blind $0.10
*** HOLE CARDS ***
Dealt to warioman [Ah 8c]
Player#1250: raises $0.10 to $0.35
Player#0583: calls $0.35
Player#9097: folds
Player#0265: calls $0.35
Player#7966: folds
warioman: calls $0.25
*** FLOP *** [As Jc 3c]
warioman: checks
Player#1250: bets $0.80
Player#0583: folds
Player#0265: folds
warioman: calls $0.80
*** TURN *** [As Jc 3c] [Qs]
warioman: checks
Player#1250: bets $2.00
warioman: folds
Player#1250: doesn't show hand
Uncalled bet ($2.00) returned to Player#1250
Player#1250 collected $2.90 from pot
*** SUMMARY ***
Total Pot $3.05 | Rake $0.15
Board [As Jc 3c Qs]
Seat 1: Player#7966 (small blind) folded before the flop
Seat 2: warioman (big blind) folded on the turn
Seat 3: Player#1250 shows [] and won ($2.90) with 
Seat 4: Player#0583 folded on the flop
Seat 5: Player#9097 folded before the flop
Seat 6: Player#0265 (button) folded on the flop

PokerStars Hand #2e4a49e9-37f9-403a-95c0-484cbb6f97fd:  Hold'em No Limit ($0.05/$0.10 USD) - 2021/11/20 15:53:00 ET
Table 'Cathedral City' 6-max Seat #1 is the button
Seat 1: Player#6533 ($7.20 in chips)
Seat 2: warioman ($10.00 in chips)
Seat 3: Player#2803 ($30.63 in chips)
Seat 4: Player#7785 ($10.05 in chips)
Seat 5: Player#3277 ($29.72 in chips)
Seat 6: Player#9804 ($9.50 in chips)
warioman: posts small blind $0.05
Player#9804: posts big blind $0.10
*** HOLE CARDS ***
Dealt to warioman []
warioman Waiting
Player#2803: folds
Player#7785: folds
Player#3277: folds
Player#9804: folds
Player#6533 collected $0.10 from pot
*** SUMMARY ***
Total Pot $0.10 | Rake $0.00
Seat 1: Player#6533 shows [] and won ($0.10) with 
Seat 2: warioman (small blind)
Seat 3: Player#2803 folded before the flop
Seat 4: Player#7785 folded before the flop
Seat 5: Player#3277 folded before the flop
Seat 6: Player#9804 (big blind) folded before the flop

PokerStars Hand #bd8865f8-6838-4506-b20f-e2aee61bdc04:  Hold'em No Limit ($0.1/$0.20 USD) - 2021/11/20 15:53:00 ET
Table 'Bel Air' 6-max Seat #6 is the button
Seat 1: warioman ($19.80 in chips)
Seat 2: Player#2918 ($17.20 in chips)
Seat 3: Player#2759 ($27.87 in chips)
Seat 4: Player#9950 ($22.57 in chips)
Seat 5: Player#2097 ($89.48 in chips)
warioman: posts small blind $0.10
Player#2918: posts big blind $0.20
*** HOLE CARDS ***
Dealt to warioman [Kc Ah]
Player#2759: folds
Player#9950: folds
Player#2097: raises0.20 to $1
warioman: raises1.00 to $4
Player#2918: folds
Player#2097: calls $3.00
*** FLOP *** [3h 3s Jc]
warioman: bets $4.06
Player#2097: raises $ 84.06 to $85.48
warioman: calls $11.74
warioman Showing Pocket Cards KA
Player#2097 Showing Pocket Cards QJ
*** TURN *** [3h 3s Jc] [8d]
*** RIVER *** [3h 3s Jc] [8d] [4s]
Player#2097 collected $107.98 from pot
*** SUMMARY ***
Total Pot $109.48 | Rake $1.50
Board [3h 3s Jc 8d 4s]
Seat 1: warioman (small blind)
Seat 2: Player#2918 (big blind) folded before the flop
Seat 3: Player#2759 folded before the flop
Seat 4: Player#9950 folded before the flop
Seat 5: Player#2097 shows [Qs Jd] and won ($107.98) with 

PokerStars Hand #19ae1f2f-90e3-4057-9ad6-f909599c1835:  Hold'em No Limit ($0.1/$0.20 USD) - 2021/11/20 15:52:00 ET
Table 'Bel Air' 6-max Seat #5 is the button
Seat 1: warioman ($20.00 in chips)
Seat 2: Player#8933 ($19.40 in chips)
Seat 3: Player#4785 ($27.87 in chips)
Seat 4: Player#6160 ($20.30 in chips)
Seat 5: Player#1701 ($89.48 in chips)
Seat 6: Player#6998 ($38.07 in chips)
Player#6998: posts small blind $0.10
warioman: posts big blind $0.20
*** HOLE CARDS ***
Dealt to warioman [6d 9h]
Player#8933: calls $0.20
Player#4785: folds
Player#6160: raises $0.20 to $0.8
Player#1701: folds
Player#6998: folds
warioman: folds
Player#8933: calls $0.60
*** FLOP *** [9s Qs 3d]
Player#8933: checks
Player#6160: bets $1.20
Player#8933: calls $1.20
*** TURN *** [9s Qs 3d] [Td]
Player#8933: checks
Player#6160: checks
*** RIVER *** [9s Qs 3d] [Td] [7d]
Player#8933: bets $0.20
Player#6160: raises0.20 to $3
Player#8933: folds
Player#6160: doesn't show hand
Uncalled bet ($3.00) returned to Player#6160
Player#6160 collected $4.28 from pot
*** SUMMARY ***
Total Pot $4.50 | Rake $0.23
Board [9s Qs 3d Td 7d]
Seat 1: warioman (big blind) folded before the flop
Seat 2: Player#8933 folded on the river
Seat 3: Player#4785 folded before the flop
Seat 4: Player#6160 shows [] and won ($4.28) with 
Seat 5: Player#1701 (button) folded before the flop
Seat 6: Player#6998 (small blind) folded before the flop

PokerStars Hand #b93f8c67-b1e8-4750-8e63-876fe55bc954:  Hold'em No Limit ($0.1/$0.20 USD) - 2021/11/20 15:51:00 ET
Table 'Bel Air' 6-max Seat #6 is the button
Seat 1: warioman ($20.00 in chips)
Seat 2: Player#4840 ($19.40 in chips)
Seat 3: Player#8145 ($27.87 in chips)
Seat 4: Player#8957 ($20.00 in chips)
Seat 5: Player#1882 ($89.58 in chips)
Seat 6: Player#7615 ($38.27 in chips)
warioman: posts small blind $0.10
Player#1882: posts big blind $0.20
*** HOLE CARDS ***
Dealt to warioman []
warioman Waiting
Player#4840: folds
Player#8145: folds
Player#8957: raises $0.20 to $0.6
Player#1882: folds
Player#7615: folds
Player#8957: doesn't show hand
Uncalled bet ($0.60) returned to Player#8957
Player#8957 collected $0.30 from pot
*** SUMMARY ***
Total Pot $0.30 | Rake $0.00
Seat 1: warioman (small blind)
Seat 2: Player#4840 folded before the flop
Seat 3: Player#8145 folded before the flop
Seat 4: Player#8957 shows [] and won ($0.30) with 
Seat 5: Player#1882 (big blind) folded before the flop
Seat 6: Player#7615 (button) folded before the flop

PokerStars Hand #3c41bdcc-28f2-42c2-86cc-ed2c1022f0ff:  Hold'em No Limit ($0.1/$0.20 USD) - 2021/11/20 12:18:00 ET
Table 'Bel Air' 6-max Seat #1 is the button
Seat 1: Player#0565 ($30.72 in chips)
Seat 2: Player#5511 ($58.55 in chips)
Seat 3: warioman ($21.91 in chips)
Seat 4: Player#1179 ($25.20 in chips)
Seat 5: Player#1776 ($8.12 in chips)
Player#5511: posts small blind $0.10
Player#1179: posts big blind $0.20
*** HOLE CARDS ***
Dealt to warioman []
warioman Decline Entry Bet
Player#1776: calls $0.20
Player#0565: folds
Player#5511: folds
Player#1179: checks
*** FLOP *** [7d 3c 3h]
Player#1179: checks
Player#1776: checks
*** TURN *** [7d 3c 3h] [Qc]
Player#1179: checks
Player#1776: checks
*** RIVER *** [7d 3c 3h] [Qc] [8c]
Player#1179: checks
Player#1776: checks
*** SHOW DOWN *** 
Player#1776 collected $0.47 from pot
*** SUMMARY ***
Total Pot $0.50 | Rake $0.03
Board [7d 3c 3h Qc 8c]
Seat 1: Player#0565 (button) folded before the flop
Seat 2: Player#5511 (small blind) folded before the flop
Seat 3: warioman
Seat 4: Player#1179 (big blind) mucked
Seat 5: Player#1776 shows [Tc 5c] and won ($0.47) with 

PokerStars Hand #5f0bc7e9-48d8-4943-8edc-52516fb17fe5:  Hold'em No Limit ($0.1/$0.20 USD) - 2021/11/20 12:17:00 ET
Table 'Bel Air' 6-max Seat #6 is the button
Seat 1: Player#7342 ($30.82 in chips)
Seat 2: Player#3514 ($52.11 in chips)
Seat 3: warioman ($21.91 in chips)
Seat 4: Player#1566 ($25.20 in chips)
Seat 5: Player#7482 ($7.05 in chips)
Seat 6: Player#3656 ($8.12 in chips)
Player#7342: posts small blind $0.10
Player#3514: posts big blind $0.20
*** HOLE CARDS ***
Dealt to warioman [Kh 2h]
warioman: folds
Player#1566: folds
Player#7482: calls $0.20
Player#3656: folds
Player#7342: folds
Player#3514: raises $0.20 to $0.7
Player#7482: calls $0.50
*** FLOP *** [5d 3c Kd]
Player#3514: bets $0.75
Player#7482: calls $0.75
*** TURN *** [5d 3c Kd] [7c]
Player#3514: bets $1.50
Player#7482: raises $1.50 to $5.6
Player#3514: calls $4.10
Player#3514 Showing Pocket Cards 57
Player#7482 Showing Pocket Cards K4
*** RIVER *** [5d 3c Kd] [7c] [8s]
Player#3514 collected $13.49 from pot
*** SUMMARY ***
Total Pot $14.20 | Rake $0.71
Board [5d 3c Kd 7c 8s]
Seat 1: Player#7342 (small blind) folded before the flop
Seat 2: Player#3514 shows [5s 7h] and won ($13.49) with 
Seat 3: warioman folded before the flop
Seat 4: Player#1566 folded before the flop
Seat 5: Player#7482 mucked
Seat 6: Player#3656 (button) folded before the flop

PokerStars Hand #34546683-39fe-4a91-a27d-16b3fcc39177:  Hold'em No Limit ($0.1/$0.20 USD) - 2021/11/20 12:17:00 ET
Table 'Bel Air' 6-max Seat #5 is the button
Seat 1: Player#8731 ($31.02 in chips)
Seat 2: Player#6420 ($52.11 in chips)
Seat 3: warioman ($21.61 in chips)
Seat 4: Player#4677 ($25.20 in chips)
Seat 5: Player#5871 ($7.05 in chips)
Seat 6: Player#0028 ($8.22 in chips)
Player#0028: posts small blind $0.10
Player#8731: posts big blind $0.20
*** HOLE CARDS ***
Dealt to warioman [9d 9h]
Player#6420: folds
warioman: raises $0.20 to $0.5
Player#4677: folds
Player#5871: folds
Player#0028: folds
Player#8731: folds
warioman: doesn't show hand
Uncalled bet ($0.50) returned to warioman
warioman collected $0.30 from pot
*** SUMMARY ***
Total Pot $0.30 | Rake $0.00
Seat 1: Player#8731 (big blind) folded before the flop
Seat 2: Player#6420 folded before the flop
Seat 3: warioman
Seat 4: Player#4677 folded before the flop
Seat 5: Player#5871 (button) folded before the flop
Seat 6: Player#0028 (small blind) folded before the flop

PokerStars Hand #c6c16241-14d5-4dc9-a6e8-059ea9fc19df:  Hold'em No Limit ($0.1/$0.20 USD) - 2021/11/20 12:17:00 ET
Table 'Minneapolis' 6-max Seat #5 is the button
Seat 1: warioman ($23.58 in chips)
Seat 2: Player#7635 ($24.41 in chips)
Seat 3: Player#9845 ($19.49 in chips)
Seat 4: Player#8990 ($6.21 in chips)
Seat 5: Player#5359 ($35.21 in chips)
Seat 6: Player#2364 ($23.49 in chips)
Player#2364: posts small blind $0.10
Player#7635: posts big blind $0.20
*** HOLE CARDS ***
Dealt to warioman []
warioman Decline Entry Bet
Player#9845: folds
Player#8990: folds
Player#5359: folds
Player#2364: folds
Player#7635 collected $0.20 from pot
*** SUMMARY ***
Total Pot $0.20 | Rake $0.00
Seat 1: warioman
Seat 2: Player#7635 shows [] and won ($0.20) with 
Seat 3: Player#9845 folded before the flop
Seat 4: Player#8990 folded before the flop
Seat 5: Player#5359 (button) folded before the flop
Seat 6: Player#2364 (small blind) folded before the flop

PokerStars Hand #341c6a57-14c8-4e84-912f-07fa1414aa0d:  Hold'em No Limit ($0.1/$0.20 USD) - 2021/11/20 12:16:00 ET
Table 'Minneapolis' 6-max Seat #4 is the button
Seat 1: warioman ($23.58 in chips)
Seat 2: Player#6988 ($25.01 in chips)
Seat 3: Player#0069 ($19.49 in chips)
Seat 4: Player#2456 ($7.76 in chips)
Seat 5: Player#7705 ($35.31 in chips)
Seat 6: Player#0554 ($21.43 in chips)
Player#7705: posts small blind $0.10
Player#0554: posts big blind $0.20
*** HOLE CARDS ***
Dealt to warioman [5d 6d]
warioman: folds
Player#6988: raises $0.20 to $0.6
Player#0069: folds
Player#2456: calls $0.60
Player#7705: folds
Player#0554: calls $0.40
*** FLOP *** [Kh 9c Ks]
Player#0554: checks
Player#6988: checks
Player#2456: checks
*** TURN *** [Kh 9c Ks] [Qh]
Player#0554: bets $0.95
Player#6988: folds
Player#2456: calls $0.95
*** RIVER *** [Kh 9c Ks] [Qh] [Th]
Player#0554: bets $1.25
Player#2456: folds
Player#0554: doesn't show hand
Uncalled bet ($1.25) returned to Player#0554
Player#0554 collected $3.61 from pot
*** SUMMARY ***
Total Pot $3.80 | Rake $0.19
Board [Kh 9c Ks Qh Th]
Seat 1: warioman folded before the flop
Seat 2: Player#6988 folded on the turn
Seat 3: Player#0069 folded before the flop
Seat 4: Player#2456 (button) folded on the river
Seat 5: Player#7705 (small blind) folded before the flop
Seat 6: Player#0554 shows [] and won ($3.61) with 

PokerStars Hand #145c3648-1619-4bbe-b51b-a6057d7388a5:  Hold'em No Limit ($0.1/$0.20 USD) - 2021/11/20 12:15:00 ET
Table 'Bel Air' 6-max Seat #4 is the button
Seat 1: Player#4678 ($22.73 in chips)
Seat 2: Player#8912 ($52.11 in chips)
Seat 3: warioman ($21.61 in chips)
Seat 4: Player#3413 ($25.20 in chips)
Seat 5: Player#8672 ($16.05 in chips)
Seat 6: Player#1292 ($8.42 in chips)
Player#8672: posts small blind $0.10
Player#1292: posts big blind $0.20
*** HOLE CARDS ***
Dealt to warioman [8s Ks]
Player#4678: raises $0.20 to $0.6
Player#8912: folds
warioman: folds
Player#3413: folds
Player#8672: calls $0.50
Player#1292: folds
*** FLOP *** [9s Kh 7d]
Player#8672: checks
Player#4678: bets $0.60
Player#8672: calls $0.60
*** TURN *** [9s Kh 7d] [6h]
Player#8672: bets $1.00
Player#4678: raises $1.00 to $2.8
Player#8672: calls $1.80
*** RIVER *** [9s Kh 7d] [6h] [Th]
Player#8672: bets $5.00
Player#4678: calls $5.00
*** SHOW DOWN *** 
Player#4678 collected $17.29 from pot
*** SUMMARY ***
Total Pot $18.20 | Rake $0.91
Board [9s Kh 7d 6h Th]
Seat 1: Player#4678 shows [8h Th] and won ($17.29) with 
Seat 2: Player#8912 folded before the flop
Seat 3: warioman folded before the flop
Seat 4: Player#3413 (button) folded before the flop
Seat 5: Player#8672 (small blind) mucked
Seat 6: Player#1292 (big blind) folded before the flop

PokerStars Hand #958aaa30-8cf3-4c7f-aa8a-eb0d4445f59a:  Hold'em No Limit ($0.1/$0.20 USD) - 2021/11/20 12:15:00 ET
Table 'Minneapolis' 6-max Seat #3 is the button
Seat 1: warioman ($23.58 in chips)
Seat 2: Player#1910 ($25.01 in chips)
Seat 3: Player#7335 ($19.49 in chips)
Seat 4: Player#5651 ($7.96 in chips)
Seat 5: Player#9000 ($35.13 in chips)
Seat 6: Player#2896 ($21.43 in chips)
Player#5651: posts small blind $0.10
Player#9000: posts big blind $0.20
*** HOLE CARDS ***
Dealt to warioman [Ad 5h]
Player#2896: folds
warioman: folds
Player#1910: folds
Player#7335: folds
Player#5651: calls $0.10
Player#9000: checks
*** FLOP *** [7h Qd Jd]
Player#5651: checks
Player#9000: bets $0.40
Player#5651: folds
Player#9000: doesn't show hand
Uncalled bet ($0.40) returned to Player#9000
Player#9000 collected $0.38 from pot
*** SUMMARY ***
Total Pot $0.40 | Rake $0.02
Board [7h Qd Jd]
Seat 1: warioman folded before the flop
Seat 2: Player#1910 folded before the flop
Seat 3: Player#7335 (button) folded before the flop
Seat 4: Player#5651 (small blind) folded on the flop
Seat 5: Player#9000 shows [] and won ($0.38) with 
Seat 6: Player#2896 folded before the flop

PokerStars Hand #47d7262c-5737-4fe3-a846-d472cd2c2185:  Hold'em No Limit ($0.1/$0.20 USD) - 2021/11/20 12:15:00 ET
Table 'Bel Air' 6-max Seat #3 is the button
Seat 1: Player#5932 ($22.73 in chips)
Seat 2: Player#0075 ($53.51 in chips)
Seat 3: warioman ($21.61 in chips)
Seat 4: Player#7593 ($25.30 in chips)
Seat 5: Player#8895 ($14.69 in chips)
Seat 6: Player#1489 ($8.42 in chips)
Player#7593: posts small blind $0.10
Player#8895: posts big blind $0.20
*** HOLE CARDS ***
Dealt to warioman [Jd 9s]
Player#1489: folds
Player#5932: folds
Player#0075: calls $0.20
warioman: folds
Player#7593: folds
Player#8895: raises $0.20 to $0.4
Player#0075: calls $0.20
*** FLOP *** [5s 6c Qc]
Player#8895: bets $0.40
Player#0075: calls $0.40
*** TURN *** [5s 6c Qc] [Ad]
Player#8895: bets $0.60
Player#0075: calls $0.60
*** RIVER *** [5s 6c Qc] [Ad] [Td]
Player#8895: bets $1.40
Player#0075: folds
Player#8895: doesn't show hand
Uncalled bet ($1.40) returned to Player#8895
Player#8895 collected $2.76 from pot
*** SUMMARY ***
Total Pot $2.90 | Rake $0.15
Board [5s 6c Qc Ad Td]
Seat 1: Player#5932 folded before the flop
Seat 2: Player#0075 folded on the river
Seat 3: warioman (button) folded before the flop
Seat 4: Player#7593 (small blind) folded before the flop
Seat 5: Player#8895 shows [] and won ($2.76) with 
Seat 6: Player#1489 folded before the flop

PokerStars Hand #35a2131f-41cc-494e-925c-7710692c3eb7:  Hold'em No Limit ($0.1/$0.20 USD) - 2021/11/20 12:14:00 ET
Table 'Bel Air' 6-max Seat #2 is the button
Seat 1: Player#6715 ($22.73 in chips)
Seat 2: Player#5751 ($53.51 in chips)
Seat 3: warioman ($21.71 in chips)
Seat 4: Player#4960 ($25.50 in chips)
Seat 5: Player#5082 ($14.69 in chips)
Seat 6: Player#6155 ($8.14 in chips)
warioman: posts small blind $0.10
Player#4960: posts big blind $0.20
*** HOLE CARDS ***
Dealt to warioman [7c 5s]
Player#5082: folds
Player#6155: calls $0.20
Player#6715: folds
Player#5751: folds
warioman: folds
Player#4960: checks
*** FLOP *** [2h 4s 4d]
Player#4960: checks
Player#6155: bets $0.80
Player#4960: folds
Player#6155: doesn't show hand
Uncalled bet ($0.80) returned to Player#6155
Player#6155 collected $0.47 from pot
*** SUMMARY ***
Total Pot $0.50 | Rake $0.03
Board [2h 4s 4d]
Seat 1: Player#6715 folded before the flop
Seat 2: Player#5751 (button) folded before the flop
Seat 3: warioman (small blind) folded before the flop
Seat 4: Player#4960 (big blind) folded on the flop
Seat 5: Player#5082 folded before the flop
Seat 6: Player#6155 shows [] and won ($0.47) with 

PokerStars Hand #a6d0830d-6579-453a-b702-900c7563ba22:  Hold'em No Limit ($0.1/$0.20 USD) - 2021/11/20 12:14:00 ET
Table 'Minneapolis' 6-max Seat #2 is the button
Seat 1: warioman ($21.50 in chips)
Seat 2: Player#8205 ($25.21 in chips)
Seat 3: Player#4015 ($19.59 in chips)
Seat 4: Player#2082 ($9.96 in chips)
Seat 5: Player#3520 ($35.13 in chips)
Seat 6: Player#7441 ($21.43 in chips)
Player#4015: posts small blind $0.10
Player#2082: posts big blind $0.20
*** HOLE CARDS ***
Dealt to warioman [Qc 7s]
warioman BB + Dead Small 0.3
Player#3520: folds
Player#7441: folds
warioman: checks
Player#8205: calls $0.20
Player#4015: folds
Player#2082: checks
*** FLOP *** [7c Qd 8c]
Player#2082: checks
warioman: bets $0.60
Player#8205: folds
Player#2082: calls $0.60
*** TURN *** [7c Qd 8c] [7d]
Player#2082: checks
warioman: checks
*** RIVER *** [7c Qd 8c] [7d] [Td]
Player#2082: bets $1.20
warioman: raises $1.20 to $3.8
Player#2082: folds
warioman: doesn't show hand
Uncalled bet ($3.80) returned to warioman
warioman collected $2.76 from pot
*** SUMMARY ***
Total Pot $2.90 | Rake $0.15
Board [7c Qd 8c 7d Td]
Seat 1: warioman
Seat 2: Player#8205 (button) folded on the flop
Seat 3: Player#4015 (small blind) folded before the flop
Seat 4: Player#2082 (big blind) folded on the river
Seat 5: Player#3520 folded before the flop
Seat 6: Player#7441 folded before the flop

PokerStars Hand #fd8094a2-d987-4f42-b72e-498e2fd3ed0f:  Hold'em No Limit ($0.1/$0.20 USD) - 2021/11/20 12:14:00 ET
Table 'Leominster' 6-max Seat #4 is the button
Seat 1: Player#5814 ($20.39 in chips)
Seat 2: Player#6607 ($43.90 in chips)
Seat 3: Player#6366 ($20.00 in chips)
Seat 4: Player#6288 ($22.28 in chips)
Seat 5: Player#7764 ($19.52 in chips)
Seat 6: warioman ($21.03 in chips)
Player#7764: posts small blind $0.10
Player#5814: posts big blind $0.20
*** HOLE CARDS ***
Dealt to warioman []
warioman Decline Entry Bet
Player#6607: folds
Player#6366: calls $0.20
Player#6288: calls $0.20
Player#7764: folds
Player#5814: checks
*** FLOP *** [9s Ts 2d]
Player#5814: checks
Player#6366: checks
Player#6288: checks
*** TURN *** [9s Ts 2d] [2s]
Player#5814: checks
Player#6366: checks
Player#6288: bets $0.60
Player#5814: folds
Player#6366: calls $0.60
*** RIVER *** [9s Ts 2d] [2s] [Ks]
Player#6366: checks
Player#6288: checks
*** SHOW DOWN *** 
Player#6366 collected $1.80 from pot
*** SUMMARY ***
Total Pot $1.90 | Rake $0.10
Board [9s Ts 2d 2s Ks]
Seat 1: Player#5814 (big blind) folded on the turn
Seat 2: Player#6607 folded before the flop
Seat 3: Player#6366 shows [Qh Qd] and won ($1.80) with 
Seat 4: Player#6288 (button) mucked
Seat 5: Player#7764 (small blind) folded before the flop
Seat 6: warioman

PokerStars Hand #f911c02a-3fbe-46f1-8043-3ed6535a006a:  Hold'em No Limit ($0.1/$0.20 USD) - 2021/11/20 12:14:00 ET
Table 'Leominster' 6-max Seat #2 is the button
Seat 1: Player#5937 ($20.39 in chips)
Seat 2: Player#7764 ($43.90 in chips)
Seat 3: Player#3355 ($22.38 in chips)
Seat 4: Player#3992 ($19.42 in chips)
Seat 5: warioman ($21.03 in chips)
Player#3355: posts small blind $0.10
Player#3992: posts big blind $0.20
*** HOLE CARDS ***
Dealt to warioman [As 7h]
warioman: folds
Player#5937: folds
Player#7764: folds
Player#3355: folds
Player#3992 collected $0.20 from pot
*** SUMMARY ***
Total Pot $0.20 | Rake $0.00
Seat 1: Player#5937 folded before the flop
Seat 2: Player#7764 (button) folded before the flop
Seat 3: Player#3355 (small blind) folded before the flop
Seat 4: Player#3992 shows [] and won ($0.20) with 
Seat 5: warioman folded before the flop

PokerStars Hand #468cdf68-02a7-48be-bcc6-f60bc79adb7c:  Hold'em No Limit ($0.1/$0.20 USD) - 2021/11/20 12:14:00 ET
Table 'Bel Air' 6-max Seat #1 is the button
Seat 1: Player#5383 ($21.83 in chips)
Seat 2: Player#7333 ($53.61 in chips)
Seat 3: warioman ($21.91 in chips)
Seat 4: Player#9464 ($25.70 in chips)
Seat 5: Player#4220 ($14.89 in chips)
Seat 6: Player#2749 ($8.34 in chips)
Player#7333: posts small blind $0.10
warioman: posts big blind $0.20
*** HOLE CARDS ***
Dealt to warioman [Kc Jh]
Player#4220 Entry Bet 0.2
Player#9464: calls $0.20
Player#4220: checks
Player#2749: calls $0.20
Player#5383: raises $0.20 to $1.3
Player#7333: folds
warioman: folds
Player#9464: folds
Player#4220: folds
Player#2749: folds
Player#5383: doesn't show hand
Uncalled bet ($1.30) returned to Player#5383
Player#5383 collected $0.70 from pot
*** SUMMARY ***
Total Pot $0.70 | Rake $0.00
Seat 1: Player#5383 shows [] and won ($0.70) with 
Seat 2: Player#7333 (small blind) folded before the flop
Seat 3: warioman (big blind) folded before the flop
Seat 4: Player#9464 folded before the flop
Seat 5: Player#4220 folded before the flop
Seat 6: Player#2749 folded before the flop

PokerStars Hand #1455033a-9f71-4afb-b5ee-f991b0905113:  Hold'em No Limit ($0.1/$0.20 USD) - 2021/11/20 12:14:00 ET
Table 'Minneapolis' 6-max Seat #1 is the button
Seat 1: warioman ($21.50 in chips)
Seat 2: Player#1159 ($25.31 in chips)
Seat 3: Player#0023 ($19.79 in chips)
Seat 4: Player#0303 ($9.96 in chips)
Seat 5: Player#9030 ($35.13 in chips)
Seat 6: Player#9188 ($21.13 in chips)
Player#1159: posts small blind $0.10
Player#0023: posts big blind $0.20
*** HOLE CARDS ***
Dealt to warioman []
Player#0303: folds
Player#9030: folds
Player#9188: raises $0.20 to $0.6
Player#1159: folds
Player#0023: folds
Player#9188: doesn't show hand
Uncalled bet ($0.60) returned to Player#9188
Player#9188 collected $0.30 from pot
*** SUMMARY ***
Total Pot $0.30 | Rake $0.00
Seat 1: warioman (button)
Seat 2: Player#1159 (small blind) folded before the flop
Seat 3: Player#0023 (big blind) folded before the flop
Seat 4: Player#0303 folded before the flop
Seat 5: Player#9030 folded before the flop
Seat 6: Player#9188 shows [] and won ($0.30) with 

PokerStars Hand #0b8bfa97-afbb-4380-926c-e641dab8dc41:  Hold'em No Limit ($0.1/$0.20 USD) - 2021/11/20 12:13:00 ET
Table 'Minneapolis' 6-max Seat #5 is the button
Seat 1: warioman ($21.50 in chips)
Seat 2: Player#1090 ($25.51 in chips)
Seat 3: Player#0907 ($19.79 in chips)
Seat 4: Player#7363 ($9.96 in chips)
Seat 5: Player#3614 ($37.13 in chips)
Seat 6: Player#0831 ($19.14 in chips)
Player#0831: posts small blind $0.10
Player#1090: posts big blind $0.20
*** HOLE CARDS ***
Dealt to warioman []
warioman Decline Entry Bet
Player#0907: folds
Player#7363: folds
Player#3614: raises $0.20 to $0.6
Player#0831: raises0.60 to $2
Player#1090: folds
Player#3614: calls $1.40
*** FLOP *** [4d As 7d]
Player#0831: bets $2.50
Player#3614: folds
Player#0831: doesn't show hand
Uncalled bet ($2.50) returned to Player#0831
Player#0831 collected $3.99 from pot
*** SUMMARY ***
Total Pot $4.20 | Rake $0.21
Board [4d As 7d]
Seat 1: warioman
Seat 2: Player#1090 (big blind) folded before the flop
Seat 3: Player#0907 folded before the flop
Seat 4: Player#7363 folded before the flop
Seat 5: Player#3614 (button) folded on the flop
Seat 6: Player#0831 shows [] and won ($3.99) with 

PokerStars Hand #2334b87f-586a-4c47-9d22-6c3ca20d76bd:  Hold'em No Limit ($0.1/$0.20 USD) - 2021/11/20 12:13:00 ET
Table 'Odessa' 6-max Seat #5 is the button
Seat 1: warioman ($22.33 in chips)
Seat 2: Player#7269 ($70.46 in chips)
Seat 3: Player#4621 ($25.67 in chips)
Seat 4: Player#3408 ($9.91 in chips)
Seat 5: Player#7877 ($20.03 in chips)
Seat 6: Player#3506 ($7.20 in chips)
Player#3506: posts small blind $0.10
Player#7269: posts big blind $0.20
*** HOLE CARDS ***
Dealt to warioman []
warioman Decline Entry Bet
Player#4621: folds
Player#3408: calls $0.20
Player#7877: folds
Player#3506: calls $0.10
Player#7269: raises $0.20 to $1.2
Player#3408: calls $1.00
Player#3506: folds
*** FLOP *** [2s 7d 5d]
Player#7269: bets $1.30
Player#3408: calls $1.30
*** TURN *** [2s 7d 5d] [Jc]
Player#7269: bets $67.96
Player#3408: folds
Player#7269: doesn't show hand
Uncalled bet ($67.96) returned to Player#7269
Player#7269 collected $4.94 from pot
*** SUMMARY ***
Total Pot $5.20 | Rake $0.26
Board [2s 7d 5d Jc]
Seat 1: warioman
Seat 2: Player#7269 shows [] and won ($4.94) with 
Seat 3: Player#4621 folded before the flop
Seat 4: Player#3408 folded on the turn
Seat 5: Player#7877 (button) folded before the flop
Seat 6: Player#3506 (small blind) folded before the flop

PokerStars Hand #f10e206b-e4a4-4b2f-9e06-b7d4bc1d4e02:  Hold'em No Limit ($0.1/$0.20 USD) - 2021/11/20 12:13:00 ET
Table 'Leominster' 6-max Seat #2 is the button
Seat 1: Player#0244 ($20.39 in chips)
Seat 2: Player#7983 ($25.89 in chips)
Seat 3: Player#6569 ($19.80 in chips)
Seat 4: Player#1702 ($22.58 in chips)
Seat 5: Player#9764 ($19.42 in chips)
Seat 6: warioman ($21.03 in chips)
Player#6569: posts small blind $0.10
Player#1702: posts big blind $0.20
*** HOLE CARDS ***
Dealt to warioman [Kd 5h]
Player#9764: folds
warioman: folds
Player#0244: folds
Player#7983: raises $0.20 to $0.7
Player#6569: calls $0.60
Player#1702: folds
*** FLOP *** [8s Js Qh]
Player#6569: bets $0.20
Player#7983: calls $0.20
*** TURN *** [8s Js Qh] [2s]
Player#6569: checks
Player#7983: bets $1.00
Player#6569: calls $1.00
*** RIVER *** [8s Js Qh] [2s] [Js]
Player#6569: bets $3.00
Player#7983: raises $ 23.00 to $23.99
Player#6569: calls $14.90
*** SHOW DOWN *** 
Player#6569: doesn't show hand
Player#7983 collected $44.39 from pot
*** SUMMARY ***
Total Pot $45.89 | Rake $1.50
Board [8s Js Qh 2s Js]
Seat 1: Player#0244 folded before the flop
Seat 2: Player#7983 shows [Jc Qd] and won ($44.39) with 
Seat 3: Player#6569 (small blind) mucked
Seat 4: Player#1702 (big blind) folded before the flop
Seat 5: Player#9764 folded before the flop
Seat 6: warioman folded before the flop

PokerStars Hand #9e60d41f-3a91-4d6a-83bc-edf5fafd418c:  Hold'em No Limit ($0.1/$0.20 USD) - 2021/11/20 12:13:00 ET
Table 'Odessa' 6-max Seat #4 is the button
Seat 1: warioman ($22.33 in chips)
Seat 2: Player#4575 ($70.46 in chips)
Seat 3: Player#1476 ($25.67 in chips)
Seat 4: Player#4536 ($9.61 in chips)
Seat 5: Player#6785 ($20.13 in chips)
Seat 6: Player#4514 ($7.40 in chips)
Player#6785: posts small blind $0.10
Player#4514: posts big blind $0.20
*** HOLE CARDS ***
Dealt to warioman [Jh 8d]
warioman: folds
Player#4575: folds
Player#1476: folds
Player#4536: raises $0.20 to $0.6
Player#6785: folds
Player#4514: folds
Player#4536: doesn't show hand
Uncalled bet ($0.60) returned to Player#4536
Player#4536 collected $0.30 from pot
*** SUMMARY ***
Total Pot $0.30 | Rake $0.00
Seat 1: warioman folded before the flop
Seat 2: Player#4575 folded before the flop
Seat 3: Player#1476 folded before the flop
Seat 4: Player#4536 shows [] and won ($0.30) with 
Seat 5: Player#6785 (small blind) folded before the flop
Seat 6: Player#4514 (big blind) folded before the flop

PokerStars Hand #69239931-30cc-4b79-8d3a-15f935f235b4:  Hold'em No Limit ($0.1/$0.20 USD) - 2021/11/20 12:12:00 ET
Table 'Leominster' 6-max Seat #1 is the button
Seat 1: Player#3506 ($20.39 in chips)
Seat 2: Player#9986 ($25.99 in chips)
Seat 3: Player#4192 ($20.00 in chips)
Seat 4: Player#6299 ($21.57 in chips)
Seat 5: Player#2970 ($20.22 in chips)
Seat 6: warioman ($21.03 in chips)
Player#9986: posts small blind $0.10
Player#4192: posts big blind $0.20
*** HOLE CARDS ***
Dealt to warioman [8d 8c]
Player#6299: calls $0.20
Player#2970: raises $0.20 to $0.8
warioman: folds
Player#3506: folds
Player#9986: folds
Player#4192: folds
Player#6299: calls $0.60
*** FLOP *** [4d Tc 9h]
Player#6299: bets $1.42
Player#2970: folds
Player#6299: doesn't show hand
Uncalled bet ($1.42) returned to Player#6299
Player#6299 collected $1.81 from pot
*** SUMMARY ***
Total Pot $1.90 | Rake $0.10
Board [4d Tc 9h]
Seat 1: Player#3506 (button) folded before the flop
Seat 2: Player#9986 (small blind) folded before the flop
Seat 3: Player#4192 (big blind) folded before the flop
Seat 4: Player#6299 shows [] and won ($1.81) with 
Seat 5: Player#2970 folded on the flop
Seat 6: warioman folded before the flop

PokerStars Hand #a4aaeb9b-5104-4ede-976f-9a2c8627d6b8:  Hold'em No Limit ($0.1/$0.20 USD) - 2021/11/20 12:12:00 ET
Table 'Minneapolis' 6-max Seat #4 is the button
Seat 1: warioman ($21.50 in chips)
Seat 2: Player#4277 ($25.51 in chips)
Seat 3: Player#7921 ($19.79 in chips)
Seat 4: Player#2977 ($10.76 in chips)
Seat 5: Player#2053 ($35.65 in chips)
Seat 6: Player#6809 ($19.94 in chips)
Player#2053: posts small blind $0.10
Player#6809: posts big blind $0.20
*** HOLE CARDS ***
Dealt to warioman [Ts 4s]
warioman: folds
Player#4277: folds
Player#7921: folds
Player#2977: calls $0.20
Player#2053: raises $0.20 to $0.8
Player#6809: calls $0.60
Player#2977: calls $0.60
*** FLOP *** [Ks Qc 3h]
Player#2053: checks
Player#6809: checks
Player#2977: checks
*** TURN *** [Ks Qc 3h] [Tc]
Player#2053: bets $1.20
Player#6809: folds
Player#2977: folds
Player#2053: doesn't show hand
Uncalled bet ($1.20) returned to Player#2053
Player#2053 collected $2.28 from pot
*** SUMMARY ***
Total Pot $2.40 | Rake $0.12
Board [Ks Qc 3h Tc]
Seat 1: warioman folded before the flop
Seat 2: Player#4277 folded before the flop
Seat 3: Player#7921 folded before the flop
Seat 4: Player#2977 (button) folded on the turn
Seat 5: Player#2053 shows [] and won ($2.28) with 
Seat 6: Player#6809 (big blind) folded on the turn

PokerStars Hand #5a8f576e-5e62-4459-8cc8-e51dee608411:  Hold'em No Limit ($0.1/$0.20 USD) - 2021/11/20 12:12:00 ET
Table 'Odessa' 6-max Seat #3 is the button
Seat 1: warioman ($22.33 in chips)
Seat 2: Player#5020 ($70.46 in chips)
Seat 3: Player#4783 ($24.22 in chips)
Seat 4: Player#2685 ($11.01 in chips)
Seat 5: Player#7089 ($20.33 in chips)
Seat 6: Player#5607 ($7.40 in chips)
Player#2685: posts small blind $0.10
Player#7089: posts big blind $0.20
*** HOLE CARDS ***
Dealt to warioman [Jd 2d]
Player#5607: folds
warioman: folds
Player#5020: folds
Player#4783: raises $0.20 to $0.6
Player#2685: calls $0.50
Player#7089: folds
*** FLOP *** [Qc 3h 4d]
Player#2685: checks
Player#4783: bets $0.80
Player#2685: calls $0.80
*** TURN *** [Qc 3h 4d] [5h]
Player#2685: checks
Player#4783: checks
*** RIVER *** [Qc 3h 4d] [5h] [8h]
Player#2685: checks
Player#4783: checks
*** SHOW DOWN *** 
Player#4783 collected $2.85 from pot
*** SUMMARY ***
Total Pot $3.00 | Rake $0.15
Board [Qc 3h 4d 5h 8h]
Seat 1: warioman folded before the flop
Seat 2: Player#5020 folded before the flop
Seat 3: Player#4783 shows [Tc 8s] and won ($2.85) with 
Seat 4: Player#2685 (small blind) mucked
Seat 5: Player#7089 (big blind) folded before the flop
Seat 6: Player#5607 folded before the flop

PokerStars Hand #6633019f-162a-44ca-a216-5180a8450e69:  Hold'em No Limit ($0.1/$0.20 USD) - 2021/11/20 12:12:00 ET
Table 'Leominster' 6-max Seat #6 is the button
Seat 1: Player#1976 ($20.49 in chips)
Seat 2: Player#4323 ($26.19 in chips)
Seat 3: Player#9213 ($21.29 in chips)
Seat 4: Player#8129 ($20.22 in chips)
Seat 5: warioman ($21.03 in chips)
Player#1976: posts small blind $0.10
Player#4323: posts big blind $0.20
*** HOLE CARDS ***
Dealt to warioman [5h 6d]
Player#9213: calls $0.20
Player#8129: folds
warioman: folds
Player#1976: folds
Player#4323: checks
*** FLOP *** [Qd 2d Kh]
Player#4323: checks
Player#9213: bets $0.20
Player#4323: folds
Player#9213: doesn't show hand
Uncalled bet ($0.20) returned to Player#9213
Player#9213 collected $0.47 from pot
*** SUMMARY ***
Total Pot $0.50 | Rake $0.02
Board [Qd 2d Kh]
Seat 1: Player#1976 (small blind) folded before the flop
Seat 2: Player#4323 (big blind) folded on the flop
Seat 3: Player#9213 shows [] and won ($0.47) with 
Seat 4: Player#8129 folded before the flop
Seat 5: warioman folded before the flop

PokerStars Hand #e6f7f2aa-f9e0-4bfd-8e24-a4116a2b636c:  Hold'em No Limit ($0.1/$0.20 USD) - 2021/11/20 12:12:00 ET
Table 'Odessa' 6-max Seat #2 is the button
Seat 1: warioman ($22.33 in chips)
Seat 2: Player#7831 ($70.46 in chips)
Seat 3: Player#2877 ($24.32 in chips)
Seat 4: Player#7177 ($10.91 in chips)
Seat 5: Player#1534 ($20.33 in chips)
Seat 6: Player#9557 ($7.40 in chips)
Player#2877: posts small blind $0.10
Player#7177: posts big blind $0.20
*** HOLE CARDS ***
Dealt to warioman [Js 6s]
Player#1534: folds
Player#9557: folds
warioman: folds
Player#7831: folds
Player#2877: folds
Player#7177 collected $0.20 from pot
*** SUMMARY ***
Total Pot $0.20 | Rake $0.00
Seat 1: warioman folded before the flop
Seat 2: Player#7831 (button) folded before the flop
Seat 3: Player#2877 (small blind) folded before the flop
Seat 4: Player#7177 shows [] and won ($0.20) with 
Seat 5: Player#1534 folded before the flop
Seat 6: Player#9557 folded before the flop

PokerStars Hand #6073e035-edce-4ed0-a3ba-06da841d3e99:  Hold'em No Limit ($0.1/$0.20 USD) - 2021/11/20 12:12:00 ET
Table 'Odessa' 6-max Seat #1 is the button
Seat 1: warioman ($22.33 in chips)
Seat 2: Player#8682 ($70.56 in chips)
Seat 3: Player#3955 ($24.52 in chips)
Seat 4: Player#6368 ($10.91 in chips)
Seat 5: Player#5540 ($20.33 in chips)
Seat 6: Player#6931 ($7.10 in chips)
Player#8682: posts small blind $0.10
Player#3955: posts big blind $0.20
*** HOLE CARDS ***
Dealt to warioman [Qd Tc]
Player#6368: folds
Player#5540: folds
Player#6931: raises $0.20 to $0.6
warioman: folds
Player#8682: folds
Player#3955: folds
Player#6931: doesn't show hand
Uncalled bet ($0.60) returned to Player#6931
Player#6931 collected $0.30 from pot
*** SUMMARY ***
Total Pot $0.30 | Rake $0.00
Seat 1: warioman (button) folded before the flop
Seat 2: Player#8682 (small blind) folded before the flop
Seat 3: Player#3955 (big blind) folded before the flop
Seat 4: Player#6368 folded before the flop
Seat 5: Player#5540 folded before the flop
Seat 6: Player#6931 shows [] and won ($0.30) with 

PokerStars Hand #29d1f360-7bc4-4d17-96e8-fb8301ed475f:  Hold'em No Limit ($0.1/$0.20 USD) - 2021/11/20 12:11:00 ET
Table 'Minneapolis' 6-max Seat #3 is the button
Seat 1: warioman ($21.50 in chips)
Seat 2: Player#9514 ($25.51 in chips)
Seat 3: Player#3502 ($19.79 in chips)
Seat 4: Player#6456 ($8.96 in chips)
Seat 5: Player#7664 ($37.65 in chips)
Seat 6: Player#1426 ($19.94 in chips)
Player#6456: posts small blind $0.10
Player#7664: posts big blind $0.20
*** HOLE CARDS ***
Dealt to warioman [Kh 3d]
Player#1426: folds
warioman: folds
Player#9514: folds
Player#3502: folds
Player#6456: calls $0.10
Player#7664: checks
*** FLOP *** [Kc 3c Qd]
Player#6456: bets $0.20
Player#7664: calls $0.20
*** TURN *** [Kc 3c Qd] [Kd]
Player#6456: bets $0.60
Player#7664: calls $0.60
*** RIVER *** [Kc 3c Qd] [Kd] [7d]
Player#6456: bets $1.00
Player#7664: calls $1.00
*** SHOW DOWN *** 
Player#7664: doesn't show hand
Player#6456 collected $3.80 from pot
*** SUMMARY ***
Total Pot $4.00 | Rake $0.20
Board [Kc 3c Qd Kd 7d]
Seat 1: warioman folded before the flop
Seat 2: Player#9514 folded before the flop
Seat 3: Player#3502 (button) folded before the flop
Seat 4: Player#6456 shows [Ac 9c] and won ($3.80) with 
Seat 5: Player#7664 (big blind) mucked
Seat 6: Player#1426 folded before the flop

PokerStars Hand #1fd0d1bc-d3ce-42f2-8549-0ffea603dd33:  Hold'em No Limit ($0.1/$0.20 USD) - 2021/11/20 12:11:00 ET
Table 'Minneapolis' 6-max Seat #2 is the button
Seat 1: warioman ($21.50 in chips)
Seat 2: Player#3203 ($25.51 in chips)
Seat 3: Player#9429 ($19.89 in chips)
Seat 4: Player#8676 ($8.86 in chips)
Seat 5: Player#4579 ($37.65 in chips)
Seat 6: Player#3014 ($19.94 in chips)
Player#9429: posts small blind $0.10
Player#8676: posts big blind $0.20
*** HOLE CARDS ***
Dealt to warioman [2d Jd]
Player#4579: folds
Player#3014: folds
warioman: folds
Player#3203: folds
Player#9429: folds
Player#8676 collected $0.20 from pot
*** SUMMARY ***
Total Pot $0.20 | Rake $0.00
Seat 1: warioman folded before the flop
Seat 2: Player#3203 (button) folded before the flop
Seat 3: Player#9429 (small blind) folded before the flop
Seat 4: Player#8676 shows [] and won ($0.20) with 
Seat 5: Player#4579 folded before the flop
Seat 6: Player#3014 folded before the flop

PokerStars Hand #166c2e6e-20e3-488a-bc56-5b59e0d3e6ce:  Hold'em No Limit ($0.1/$0.20 USD) - 2021/11/20 12:11:00 ET
Table 'Leominster' 6-max Seat #4 is the button
Seat 1: Player#6612 ($21.19 in chips)
Seat 2: Player#3975 ($26.19 in chips)
Seat 3: Player#3185 ($21.29 in chips)
Seat 4: Player#2754 ($20.22 in chips)
Seat 5: warioman ($20.40 in chips)
warioman: posts small blind $0.10
Player#6612: posts big blind $0.20
*** HOLE CARDS ***
Dealt to warioman [4c 4s]
Player#3975: folds
Player#3185: folds
Player#2754: folds
warioman: calls $0.10
Player#6612: raises $0.20 to $0.7
warioman: calls $0.50
*** FLOP *** [Ad 8s Td]
warioman: checks
Player#6612: checks
*** TURN *** [Ad 8s Td] [2s]
warioman: checks
Player#6612: checks
*** RIVER *** [Ad 8s Td] [2s] [Ts]
warioman: checks
Player#6612: checks
*** SHOW DOWN *** 
warioman collected $1.33 from pot
*** SUMMARY ***
Total Pot $1.40 | Rake $0.07
Board [Ad 8s Td 2s Ts]
Seat 1: Player#6612 (big blind) mucked
Seat 2: Player#3975 folded before the flop
Seat 3: Player#3185 folded before the flop
Seat 4: Player#2754 (button) folded before the flop
Seat 5: warioman (small blind)

PokerStars Hand #ccdc2279-ede9-4598-8274-1f9d6895443d:  Hold'em No Limit ($0.1/$0.20 USD) - 2021/11/20 12:11:00 ET
Table 'Odessa' 6-max Seat #6 is the button
Seat 1: warioman ($19.30 in chips)
Seat 2: Player#4047 ($70.76 in chips)
Seat 3: Player#2750 ($24.52 in chips)
Seat 4: Player#8919 ($14.06 in chips)
Seat 5: Player#4785 ($20.33 in chips)
Seat 6: Player#5596 ($7.10 in chips)
warioman: posts small blind $0.10
Player#4047: posts big blind $0.20
*** HOLE CARDS ***
Dealt to warioman [Ad Qs]
Player#2750: folds
Player#8919: calls $0.20
Player#4785: folds
Player#5596: folds
warioman: raises $0.20 to $1.2
Player#4047: folds
Player#8919: calls $1.00
*** FLOP *** [Ac Qd Tc]
warioman: checks
Player#8919: checks
*** TURN *** [Ac Qd Tc] [4d]
warioman: bets $1.95
Player#8919: calls $1.95
*** RIVER *** [Ac Qd Tc] [4d] [5d]
warioman: checks
Player#8919: checks
*** SHOW DOWN *** 
warioman collected $6.17 from pot
*** SUMMARY ***
Total Pot $6.50 | Rake $0.33
Board [Ac Qd Tc 4d 5d]
Seat 1: warioman (small blind)
Seat 2: Player#4047 (big blind) folded before the flop
Seat 3: Player#2750 folded before the flop
Seat 4: Player#8919 mucked
Seat 5: Player#4785 folded before the flop
Seat 6: Player#5596 (button) folded before the flop

PokerStars Hand #c58dd9eb-7859-4c15-8117-d5fd37a00f69:  Hold'em No Limit ($0.1/$0.20 USD) - 2021/11/20 12:11:00 ET
Table 'Leominster' 6-max Seat #3 is the button
Seat 1: Player#1160 ($21.19 in chips)
Seat 2: Player#6733 ($26.89 in chips)
Seat 3: Player#7322 ($20.37 in chips)
Seat 4: Player#9270 ($20.32 in chips)
Seat 5: warioman ($20.60 in chips)
Player#9270: posts small blind $0.10
warioman: posts big blind $0.20
*** HOLE CARDS ***
Dealt to warioman [Ts 7s]
Player#1160: folds
Player#6733: raises $0.20 to $0.7
Player#7322: calls $0.70
Player#9270: folds
warioman: folds
*** FLOP *** [4d 7c 2h]
Player#6733: checks
Player#7322: checks
*** TURN *** [4d 7c 2h] [3d]
Player#6733: checks
Player#7322: checks
*** RIVER *** [4d 7c 2h] [3d] [8d]
Player#6733: checks
Player#7322: checks
*** SHOW DOWN *** 
Player#7322 collected $1.61 from pot
*** SUMMARY ***
Total Pot $1.70 | Rake $0.09
Board [4d 7c 2h 3d 8d]
Seat 1: Player#1160 folded before the flop
Seat 2: Player#6733 mucked
Seat 3: Player#7322 shows [8s Ks] and won ($1.61) with 
Seat 4: Player#9270 (small blind) folded before the flop
Seat 5: warioman (big blind) folded before the flop

PokerStars Hand #ced41eae-de6d-4ecf-9cda-e40f841ebcde:  Hold'em No Limit ($0.1/$0.20 USD) - 2021/11/20 12:10:00 ET
Table 'Leominster' 6-max Seat #2 is the button
Seat 1: Player#1303 ($21.19 in chips)
Seat 2: Player#7512 ($26.89 in chips)
Seat 3: Player#9603 ($20.47 in chips)
Seat 4: Player#4726 ($20.22 in chips)
Seat 5: warioman ($20.60 in chips)
Player#9603: posts small blind $0.10
Player#4726: posts big blind $0.20
*** HOLE CARDS ***
Dealt to warioman [8s 3d]
warioman: folds
Player#1303: folds
Player#7512: folds
Player#9603: folds
Player#4726 collected $0.20 from pot
*** SUMMARY ***
Total Pot $0.20 | Rake $0.00
Seat 1: Player#1303 folded before the flop
Seat 2: Player#7512 (button) folded before the flop
Seat 3: Player#9603 (small blind) folded before the flop
Seat 4: Player#4726 shows [] and won ($0.20) with 
Seat 5: warioman folded before the flop

PokerStars Hand #46c6d012-52a7-4ee9-a22a-f81cdd3c51b7:  Hold'em No Limit ($0.1/$0.20 USD) - 2021/11/20 12:10:00 ET
Table 'Odessa' 6-max Seat #5 is the button
Seat 1: warioman ($19.50 in chips)
Seat 2: Player#0970 ($70.76 in chips)
Seat 3: Player#6496 ($24.52 in chips)
Seat 4: Player#6549 ($13.76 in chips)
Seat 5: Player#5153 ($20.33 in chips)
Seat 6: Player#3523 ($7.20 in chips)
Player#3523: posts small blind $0.10
warioman: posts big blind $0.20
*** HOLE CARDS ***
Dealt to warioman [Th 7d]
Player#0970: folds
Player#6496: folds
Player#6549: raises $0.20 to $0.6
Player#5153: folds
Player#3523: folds
warioman: folds
Player#6549: doesn't show hand
Uncalled bet ($0.60) returned to Player#6549
Player#6549 collected $0.30 from pot
*** SUMMARY ***
Total Pot $0.30 | Rake $0.00
Seat 1: warioman (big blind) folded before the flop
Seat 2: Player#0970 folded before the flop
Seat 3: Player#6496 folded before the flop
Seat 4: Player#6549 shows [] and won ($0.30) with 
Seat 5: Player#5153 (button) folded before the flop
Seat 6: Player#3523 (small blind) folded before the flop

PokerStars Hand #14d0d054-5f57-4482-aca5-9f47c1d0b527:  Hold'em No Limit ($0.1/$0.20 USD) - 2021/11/20 12:10:00 ET
Table 'Leominster' 6-max Seat #1 is the button
Seat 1: Player#6989 ($21.19 in chips)
Seat 2: Player#1259 ($26.69 in chips)
Seat 3: Player#0875 ($20.67 in chips)
Seat 4: Player#7817 ($20.22 in chips)
Seat 5: warioman ($20.60 in chips)
Player#1259: posts small blind $0.10
Player#0875: posts big blind $0.20
*** HOLE CARDS ***
Dealt to warioman [8d Td]
Player#7817: folds
warioman: folds
Player#6989: folds
Player#1259: raises $0.20 to $0.6
Player#0875: folds
Player#1259: doesn't show hand
Uncalled bet ($0.60) returned to Player#1259
Player#1259 collected $0.20 from pot
*** SUMMARY ***
Total Pot $0.20 | Rake $0.00
Seat 1: Player#6989 (button) folded before the flop
Seat 2: Player#1259 shows [] and won ($0.20) with 
Seat 3: Player#0875 (big blind) folded before the flop
Seat 4: Player#7817 folded before the flop
Seat 5: warioman folded before the flop

PokerStars Hand #a1136cb5-ea82-4c42-bcb9-758e26e185b0:  Hold'em No Limit ($0.1/$0.20 USD) - 2021/11/20 12:10:00 ET
Table 'Odessa' 6-max Seat #4 is the button
Seat 1: warioman ($19.50 in chips)
Seat 2: Player#2251 ($70.76 in chips)
Seat 3: Player#8966 ($24.52 in chips)
Seat 4: Player#5433 ($13.46 in chips)
Seat 5: Player#9244 ($20.43 in chips)
Seat 6: Player#5212 ($7.40 in chips)
Player#9244: posts small blind $0.10
Player#5212: posts big blind $0.20
*** HOLE CARDS ***
Dealt to warioman [9s 8h]
warioman: folds
Player#2251: folds
Player#8966: folds
Player#5433: raises $0.20 to $0.7
Player#9244: folds
Player#5212: folds
Player#5433: doesn't show hand
Uncalled bet ($0.70) returned to Player#5433
Player#5433 collected $0.30 from pot
*** SUMMARY ***
Total Pot $0.30 | Rake $0.00
Seat 1: warioman folded before the flop
Seat 2: Player#2251 folded before the flop
Seat 3: Player#8966 folded before the flop
Seat 4: Player#5433 shows [] and won ($0.30) with 
Seat 5: Player#9244 (small blind) folded before the flop
Seat 6: Player#5212 (big blind) folded before the flop

PokerStars Hand #1f5d8efd-5fa2-41d4-a6dd-e92e33f99765:  Hold'em No Limit ($0.1/$0.20 USD) - 2021/11/20 12:10:00 ET
Table 'Minneapolis' 6-max Seat #1 is the button
Seat 1: warioman ($19.40 in chips)
Seat 2: Player#0241 ($25.61 in chips)
Seat 3: Player#9268 ($21.59 in chips)
Seat 4: Player#2753 ($9.36 in chips)
Seat 5: Player#0396 ($37.65 in chips)
Seat 6: Player#1195 ($19.94 in chips)
Player#0241: posts small blind $0.10
Player#9268: posts big blind $0.20
*** HOLE CARDS ***
Dealt to warioman [7c 9c]
Player#2753: calls $0.20
Player#0396: folds
Player#1195: folds
warioman: raises $0.20 to $0.5
Player#0241: folds
Player#9268: calls $0.30
Player#2753: calls $0.30
*** FLOP *** [8d Tc Qc]
Player#9268: checks
Player#2753: checks
warioman: bets $1.20
Player#9268: calls $1.20
Player#2753: folds
*** TURN *** [8d Tc Qc] [Ts]
Player#9268: checks
warioman: checks
*** RIVER *** [8d Tc Qc] [Ts] [Js]
Player#9268: checks
warioman: bets $3.00
Player#9268: folds
warioman: doesn't show hand
Uncalled bet ($3.00) returned to warioman
warioman collected $3.80 from pot
*** SUMMARY ***
Total Pot $4.00 | Rake $0.20
Board [8d Tc Qc Ts Js]
Seat 1: warioman (button)
Seat 2: Player#0241 (small blind) folded before the flop
Seat 3: Player#9268 (big blind) folded on the river
Seat 4: Player#2753 folded on the flop
Seat 5: Player#0396 folded before the flop
Seat 6: Player#1195 folded before the flop

PokerStars Hand #20aef1a0-1413-49c2-900c-7d62b66acc0e:  Hold'em No Limit ($0.1/$0.20 USD) - 2021/11/20 12:10:00 ET
Table 'Odessa' 6-max Seat #3 is the button
Seat 1: warioman ($19.50 in chips)
Seat 2: Player#8201 ($70.76 in chips)
Seat 3: Player#8921 ($24.52 in chips)
Seat 4: Player#1200 ($13.26 in chips)
Seat 5: Player#1526 ($20.63 in chips)
Seat 6: Player#1150 ($7.40 in chips)
Player#1200: posts small blind $0.10
Player#1526: posts big blind $0.20
*** HOLE CARDS ***
Dealt to warioman [Qs 6h]
Player#1150: folds
warioman: folds
Player#8201: folds
Player#8921: folds
Player#1200: raises $0.20 to $0.6
Player#1526: folds
Player#1200: doesn't show hand
Uncalled bet ($0.60) returned to Player#1200
Player#1200 collected $0.20 from pot
*** SUMMARY ***
Total Pot $0.20 | Rake $0.00
Seat 1: warioman folded before the flop
Seat 2: Player#8201 folded before the flop
Seat 3: Player#8921 (button) folded before the flop
Seat 4: Player#1200 shows [] and won ($0.20) with 
Seat 5: Player#1526 (big blind) folded before the flop
Seat 6: Player#1150 folded before the flop

PokerStars Hand #583081ae-ca29-47db-97a2-431797f89126:  Hold'em No Limit ($0.1/$0.20 USD) - 2021/11/20 12:10:00 ET
Table 'Leominster' 6-max Seat #6 is the button
Seat 1: Player#8882 ($21.29 in chips)
Seat 2: Player#5176 ($26.89 in chips)
Seat 3: Player#8315 ($20.39 in chips)
Seat 4: Player#6399 ($20.22 in chips)
Seat 5: warioman ($20.60 in chips)
Player#8882: posts small blind $0.10
Player#5176: posts big blind $0.20
*** HOLE CARDS ***
Dealt to warioman [7s 5c]
Player#8315: calls $0.20
Player#6399: folds
warioman: folds
Player#8882: folds
Player#5176: checks
*** FLOP *** [Qs Tc 8s]
Player#5176: checks
Player#8315: checks
*** TURN *** [Qs Tc 8s] [2d]
Player#5176: checks
Player#8315: checks
*** RIVER *** [Qs Tc 8s] [2d] [3d]
Player#5176: checks
Player#8315: bets $1.00
Player#5176: folds
Player#8315: doesn't show hand
Uncalled bet ($1.00) returned to Player#8315
Player#8315 collected $0.47 from pot
*** SUMMARY ***
Total Pot $0.50 | Rake $0.03
Board [Qs Tc 8s 2d 3d]
Seat 1: Player#8882 (small blind) folded before the flop
Seat 2: Player#5176 (big blind) folded on the river
Seat 3: Player#8315 shows [] and won ($0.47) with 
Seat 4: Player#6399 folded before the flop
Seat 5: warioman folded before the flop

PokerStars Hand #e8a60577-4809-4a80-9d63-09aadadfd7ff:  Hold'em No Limit ($0.1/$0.20 USD) - 2021/11/20 12:09:00 ET
Table 'Leominster' 6-max Seat #4 is the button
Seat 1: Player#1673 ($21.19 in chips)
Seat 2: Player#2115 ($26.89 in chips)
Seat 3: Player#4184 ($20.39 in chips)
Seat 4: Player#1558 ($20.22 in chips)
Seat 5: warioman ($20.70 in chips)
warioman: posts small blind $0.10
Player#1673: posts big blind $0.20
*** HOLE CARDS ***
Dealt to warioman [Jc 2h]
Player#2115: folds
Player#4184: folds
Player#1558: folds
warioman: folds
Player#1673 collected $0.20 from pot
*** SUMMARY ***
Total Pot $0.20 | Rake $0.00
Seat 1: Player#1673 shows [] and won ($0.20) with 
Seat 2: Player#2115 folded before the flop
Seat 3: Player#4184 folded before the flop
Seat 4: Player#1558 (button) folded before the flop
Seat 5: warioman (small blind) folded before the flop

PokerStars Hand #7ba193c5-fbee-44cf-8efd-fb0e12a20f83:  Hold'em No Limit ($0.1/$0.20 USD) - 2021/11/20 12:09:00 ET
Table 'Minneapolis' 6-max Seat #6 is the button
Seat 1: warioman ($19.80 in chips)
Seat 2: Player#2090 ($25.25 in chips)
Seat 3: Player#6098 ($21.59 in chips)
Seat 4: Player#4344 ($9.36 in chips)
Seat 5: Player#7449 ($37.65 in chips)
Seat 6: Player#7543 ($19.94 in chips)
warioman: posts small blind $0.10
Player#2090: posts big blind $0.20
*** HOLE CARDS ***
Dealt to warioman [As 9d]
Player#6098: folds
Player#4344: folds
Player#7449: folds
Player#7543: folds
warioman: calls $0.10
Player#2090: checks
*** FLOP *** [6d 2c 8s]
warioman: checks
Player#2090: checks
*** TURN *** [6d 2c 8s] [6c]
warioman: checks
Player#2090: bets $0.20
warioman: calls $0.20
*** RIVER *** [6d 2c 8s] [6c] [4c]
warioman: checks
Player#2090: checks
*** SHOW DOWN *** 
Player#2090 collected $0.76 from pot
*** SUMMARY ***
Total Pot $0.80 | Rake $0.04
Board [6d 2c 8s 6c 4c]
Seat 1: warioman (small blind)
Seat 2: Player#2090 shows [Jd 2d] and won ($0.76) with 
Seat 3: Player#6098 folded before the flop
Seat 4: Player#4344 folded before the flop
Seat 5: Player#7449 folded before the flop
Seat 6: Player#7543 (button) folded before the flop

PokerStars Hand #a65d418a-6c24-42be-9ae3-3709e24cd5b0:  Hold'em No Limit ($0.1/$0.20 USD) - 2021/11/20 12:09:00 ET
Table 'Minneapolis' 6-max Seat #5 is the button
Seat 1: warioman ($20.00 in chips)
Seat 2: Player#2069 ($24.95 in chips)
Seat 3: Player#7277 ($21.59 in chips)
Seat 4: Player#4637 ($9.36 in chips)
Seat 5: Player#9025 ($37.65 in chips)
Seat 6: Player#9153 ($20.04 in chips)
Player#9153: posts small blind $0.10
warioman: posts big blind $0.20
*** HOLE CARDS ***
Dealt to warioman [2c 7s]
Player#2069: raises $0.20 to $0.6
Player#7277: folds
Player#4637: folds
Player#9025: folds
Player#9153: folds
warioman: folds
Player#2069: doesn't show hand
Uncalled bet ($0.60) returned to Player#2069
Player#2069 collected $0.30 from pot
*** SUMMARY ***
Total Pot $0.30 | Rake $0.00
Seat 1: warioman (big blind) folded before the flop
Seat 2: Player#2069 shows [] and won ($0.30) with 
Seat 3: Player#7277 folded before the flop
Seat 4: Player#4637 folded before the flop
Seat 5: Player#9025 (button) folded before the flop
Seat 6: Player#9153 (small blind) folded before the flop

PokerStars Hand #7e04609c-ee36-4cb4-b6dd-a67805888ad7:  Hold'em No Limit ($0.1/$0.20 USD) - 2021/11/20 12:09:00 ET
Table 'Odessa' 6-max Seat #2 is the button
Seat 1: warioman ($19.50 in chips)
Seat 2: Player#6364 ($72.86 in chips)
Seat 3: Player#5737 ($20.63 in chips)
Seat 4: Player#7189 ($15.36 in chips)
Seat 5: Player#7763 ($20.63 in chips)
Seat 6: Player#3956 ($7.40 in chips)
Player#5737: posts small blind $0.10
Player#7189: posts big blind $0.20
*** HOLE CARDS ***
Dealt to warioman [6h 2h]
Player#7763: folds
Player#3956: folds
warioman: folds
Player#6364: raises $0.20 to $0.7
Player#5737: calls $0.60
Player#7189: calls $0.50
*** FLOP *** [Ac Kd 6s]
Player#5737: checks
Player#7189: checks
Player#6364: checks
*** TURN *** [Ac Kd 6s] [Jd]
Player#5737: bets $1.40
Player#7189: calls $1.40
Player#6364: calls $1.40
*** RIVER *** [Ac Kd 6s] [Jd] [9d]
Player#5737: checks
Player#7189: checks
Player#6364: checks
*** SHOW DOWN *** 
Player#5737 collected $5.98 from pot
*** SUMMARY ***
Total Pot $6.30 | Rake $0.31
Board [Ac Kd 6s Jd 9d]
Seat 1: warioman folded before the flop
Seat 2: Player#6364 (button) mucked
Seat 3: Player#5737 shows [Jc Ks] and won ($5.98) with 
Seat 4: Player#7189 (big blind) mucked
Seat 5: Player#7763 folded before the flop
Seat 6: Player#3956 folded before the flop

PokerStars Hand #b8fb8560-909e-4530-8ea5-565912df3861:  Hold'em No Limit ($0.1/$0.20 USD) - 2021/11/20 12:09:00 ET
Table 'Leominster' 6-max Seat #3 is the button
Seat 1: Player#7972 ($20.50 in chips)
Seat 2: Player#9826 ($26.89 in chips)
Seat 3: Player#9914 ($20.84 in chips)
Seat 4: Player#7671 ($20.32 in chips)
Seat 5: warioman ($20.90 in chips)
Player#7671: posts small blind $0.10
warioman: posts big blind $0.20
*** HOLE CARDS ***
Dealt to warioman [8c 4c]
Player#7972: raises $0.20 to $0.45
Player#9826: folds
Player#9914: calls $0.45
Player#7671: folds
warioman: folds
*** FLOP *** [7c 3s 5s]
Player#7972: checks
Player#9914: checks
*** TURN *** [7c 3s 5s] [4s]
Player#7972: checks
Player#9914: checks
*** RIVER *** [7c 3s 5s] [4s] [Qs]
Player#7972: bets $0.40
Player#9914: folds
Player#7972: doesn't show hand
Uncalled bet ($0.40) returned to Player#7972
Player#7972 collected $1.14 from pot
*** SUMMARY ***
Total Pot $1.20 | Rake $0.06
Board [7c 3s 5s 4s Qs]
Seat 1: Player#7972 shows [] and won ($1.14) with 
Seat 2: Player#9826 folded before the flop
Seat 3: Player#9914 (button) folded on the river
Seat 4: Player#7671 (small blind) folded before the flop
Seat 5: warioman (big blind) folded before the flop

PokerStars Hand #f2892800-6f68-4586-a501-12a6c58a5b14:  Hold'em No Limit ($0.1/$0.20 USD) - 2021/11/20 12:09:00 ET
Table 'Odessa' 6-max Seat #1 is the button
Seat 1: warioman ($20.00 in chips)
Seat 2: Player#8967 ($72.96 in chips)
Seat 3: Player#0159 ($20.83 in chips)
Seat 4: Player#3888 ($14.62 in chips)
Seat 5: Player#5018 ($20.63 in chips)
Seat 6: Player#0577 ($7.40 in chips)
Player#8967: posts small blind $0.10
Player#0159: posts big blind $0.20
*** HOLE CARDS ***
Dealt to warioman [Ac 7c]
Player#3888: calls $0.20
Player#5018: folds
Player#0577: folds
warioman: raises $0.20 to $0.5
Player#8967: folds
Player#0159: folds
Player#3888: calls $0.30
*** FLOP *** [Jc 5d 6d]
Player#3888: checks
warioman: checks
*** TURN *** [Jc 5d 6d] [3d]
Player#3888: checks
warioman: checks
*** RIVER *** [Jc 5d 6d] [3d] [9d]
Player#3888: checks
warioman: checks
*** SHOW DOWN *** 
Player#3888 collected $1.24 from pot
*** SUMMARY ***
Total Pot $1.30 | Rake $0.07
Board [Jc 5d 6d 3d 9d]
Seat 1: warioman (button)
Seat 2: Player#8967 (small blind) folded before the flop
Seat 3: Player#0159 (big blind) folded before the flop
Seat 4: Player#3888 shows [6h Kh] and won ($1.24) with 
Seat 5: Player#5018 folded before the flop
Seat 6: Player#0577 folded before the flop

PokerStars Hand #34da9365-770f-4137-b5e1-1baa0f154368:  Hold'em No Limit ($0.1/$0.20 USD) - 2021/11/20 12:08:00 ET
Table 'Leominster' 6-max Seat #2 is the button
Seat 1: Player#5788 ($20.50 in chips)
Seat 2: Player#5789 ($26.89 in chips)
Seat 3: Player#0322 ($20.94 in chips)
Seat 4: Player#7955 ($20.22 in chips)
Seat 5: warioman ($20.90 in chips)
Player#0322: posts small blind $0.10
Player#7955: posts big blind $0.20
*** HOLE CARDS ***
Dealt to warioman [Th 2d]
warioman: folds
Player#5788: folds
Player#5789: folds
Player#0322: folds
Player#7955 collected $0.20 from pot
*** SUMMARY ***
Total Pot $0.20 | Rake $0.00
Seat 1: Player#5788 folded before the flop
Seat 2: Player#5789 (button) folded before the flop
Seat 3: Player#0322 (small blind) folded before the flop
Seat 4: Player#7955 shows [] and won ($0.20) with 
Seat 5: warioman folded before the flop

PokerStars Hand #09c3f058-9cee-4fe9-b70f-032c13935704:  Hold'em No Limit ($0.1/$0.20 USD) - 2021/11/20 12:08:00 ET
Table 'Leominster' 6-max Seat #1 is the button
Seat 1: Player#3333 ($20.20 in chips)
Seat 2: Player#6487 ($26.99 in chips)
Seat 3: Player#7845 ($21.14 in chips)
Seat 4: Player#5515 ($20.22 in chips)
Seat 5: warioman ($20.90 in chips)
Player#6487: posts small blind $0.10
Player#7845: posts big blind $0.20
*** HOLE CARDS ***
Dealt to warioman [Ks 3d]
Player#5515: folds
warioman: folds
Player#3333: raises $0.20 to $0.5
Player#6487: folds
Player#7845: folds
Player#3333: doesn't show hand
Uncalled bet ($0.50) returned to Player#3333
Player#3333 collected $0.30 from pot
*** SUMMARY ***
Total Pot $0.30 | Rake $0.00
Seat 1: Player#3333 shows [] and won ($0.30) with 
Seat 2: Player#6487 (small blind) folded before the flop
Seat 3: Player#7845 (big blind) folded before the flop
Seat 4: Player#5515 folded before the flop
Seat 5: warioman folded before the flop

PokerStars Hand #4311a020-a89f-477a-88a7-457276dab14c:  Hold'em No Limit ($0.1/$0.20 USD) - 2021/11/20 12:08:00 ET
Table 'Minneapolis' 6-max Seat #4 is the button
Seat 1: warioman ($20.00 in chips)
Seat 2: Player#5817 ($24.95 in chips)
Seat 3: Player#6248 ($21.59 in chips)
Seat 4: Player#3146 ($9.96 in chips)
Seat 5: Player#1139 ($36.54 in chips)
Seat 6: Player#2331 ($20.64 in chips)
Player#1139: posts small blind $0.10
Player#2331: posts big blind $0.20
*** HOLE CARDS ***
Dealt to warioman [Th Qd]
warioman: folds
Player#5817: folds
Player#6248: folds
Player#3146: calls $0.20
Player#1139: calls $0.10
Player#2331: checks
*** FLOP *** [As 8h 9d]
Player#1139: checks
Player#2331: checks
Player#3146: checks
*** TURN *** [As 8h 9d] [7c]
Player#1139: bets $0.40
Player#2331: calls $0.40
Player#3146: calls $0.40
*** RIVER *** [As 8h 9d] [7c] [8c]
Player#1139: bets $1.00
Player#2331: folds
Player#3146: folds
Player#1139: doesn't show hand
Uncalled bet ($1.00) returned to Player#1139
Player#1139 collected $1.71 from pot
*** SUMMARY ***
Total Pot $1.80 | Rake $0.09
Board [As 8h 9d 7c 8c]
Seat 1: warioman folded before the flop
Seat 2: Player#5817 folded before the flop
Seat 3: Player#6248 folded before the flop
Seat 4: Player#3146 (button) folded on the river
Seat 5: Player#1139 shows [] and won ($1.71) with 
Seat 6: Player#2331 (big blind) folded on the river

PokerStars Hand #963e1f9c-4443-4db0-a8d3-4fdfb2f9d0fa:  Hold'em No Limit ($0.1/$0.20 USD) - 2021/11/20 12:08:00 ET
Table 'Minneapolis' 6-max Seat #3 is the button
Seat 1: warioman ($20.00 in chips)
Seat 2: Player#5334 ($24.95 in chips)
Seat 3: Player#8828 ($21.29 in chips)
Seat 4: Player#2155 ($10.06 in chips)
Seat 5: Player#1914 ($36.74 in chips)
Seat 6: Player#2106 ($20.64 in chips)
Player#2155: posts small blind $0.10
Player#1914: posts big blind $0.20
*** HOLE CARDS ***
Dealt to warioman [Qd 6h]
Player#2106: folds
warioman: folds
Player#5334: folds
Player#8828: raises $0.20 to $0.6
Player#2155: folds
Player#1914: folds
Player#8828: doesn't show hand
Uncalled bet ($0.60) returned to Player#8828
Player#8828 collected $0.30 from pot
*** SUMMARY ***
Total Pot $0.30 | Rake $0.00
Seat 1: warioman folded before the flop
Seat 2: Player#5334 folded before the flop
Seat 3: Player#8828 shows [] and won ($0.30) with 
Seat 4: Player#2155 (small blind) folded before the flop
Seat 5: Player#1914 (big blind) folded before the flop
Seat 6: Player#2106 folded before the flop

PokerStars Hand #822b0440-20c4-4bc1-941c-91d62a06f9e1:  Hold'em No Limit ($0.1/$0.20 USD) - 2021/11/20 12:07:00 ET
Table 'Minneapolis' 6-max Seat #2 is the button
Seat 1: warioman ($20.00 in chips)
Seat 2: Player#6475 ($24.95 in chips)
Seat 3: Player#8542 ($21.39 in chips)
Seat 4: Player#3978 ($10.26 in chips)
Seat 5: Player#5135 ($36.74 in chips)
Seat 6: Player#1245 ($20.34 in chips)
Player#8542: posts small blind $0.10
Player#3978: posts big blind $0.20
*** HOLE CARDS ***
Dealt to warioman [2c Jd]
Player#5135: folds
Player#1245: raises $0.20 to $0.6
warioman: folds
Player#6475: folds
Player#8542: folds
Player#3978: folds
Player#1245: doesn't show hand
Uncalled bet ($0.60) returned to Player#1245
Player#1245 collected $0.30 from pot
*** SUMMARY ***
Total Pot $0.30 | Rake $0.00
Seat 1: warioman folded before the flop
Seat 2: Player#6475 (button) folded before the flop
Seat 3: Player#8542 (small blind) folded before the flop
Seat 4: Player#3978 (big blind) folded before the flop
Seat 5: Player#5135 folded before the flop
Seat 6: Player#1245 shows [] and won ($0.30) with 

PokerStars Hand #e88240ad-cd85-40b7-bbd4-c5bcbe9b0b24:  Hold'em No Limit ($0.1/$0.20 USD) - 2021/11/20 12:07:00 ET
Table 'Leominster' 6-max Seat #6 is the button
Seat 1: Player#9363 ($20.30 in chips)
Seat 2: Player#2961 ($27.19 in chips)
Seat 3: Player#9625 ($20.86 in chips)
Seat 4: Player#3954 ($20.22 in chips)
Seat 5: warioman ($20.90 in chips)
Player#9363: posts small blind $0.10
Player#2961: posts big blind $0.20
*** HOLE CARDS ***
Dealt to warioman [3s 2h]
Player#9625: calls $0.20
Player#3954: folds
warioman: folds
Player#9363: folds
Player#2961: checks
*** FLOP *** [9d Qh 4s]
Player#2961: checks
Player#9625: checks
*** TURN *** [9d Qh 4s] [Td]
Player#2961: checks
Player#9625: checks
*** RIVER *** [9d Qh 4s] [Td] [2d]
Player#2961: checks
Player#9625: checks
*** SHOW DOWN *** 
Player#9625 collected $0.47 from pot
*** SUMMARY ***
Total Pot $0.50 | Rake $0.03
Board [9d Qh 4s Td 2d]
Seat 1: Player#9363 (small blind) folded before the flop
Seat 2: Player#2961 (big blind) mucked
Seat 3: Player#9625 shows [Ad 9c] and won ($0.47) with 
Seat 4: Player#3954 folded before the flop
Seat 5: warioman folded before the flop

PokerStars Hand #095ec6c9-658e-4123-b3b1-676ba6d07e8c:  Hold'em No Limit ($0.1/$0.20 USD) - 2021/11/20 12:07:00 ET
Table 'Odessa' 6-max Seat #6 is the button
Seat 1: warioman ($19.20 in chips)
Seat 2: Player#5539 ($55.49 in chips)
Seat 3: Player#4590 ($20.83 in chips)
Seat 4: Player#6384 ($14.82 in chips)
Seat 5: Player#8677 ($20.63 in chips)
Seat 6: Player#8497 ($7.40 in chips)
warioman: posts small blind $0.10
Player#5539: posts big blind $0.20
*** HOLE CARDS ***
Dealt to warioman [Qh Ah]
Player#4590: folds
Player#6384: calls $0.20
Player#8677: folds
Player#8497: folds
warioman: raises $0.20 to $1.2
Player#5539: calls $1.00
Player#6384: folds
*** FLOP *** [2h Ac Qs]
warioman: bets $0.78
Player#5539: calls $0.78
*** TURN *** [2h Ac Qs] [2s]
warioman: bets $3.12
Player#5539: calls $3.12
*** RIVER *** [2h Ac Qs] [2s] [8s]
warioman: bets $14.10
Player#5539: calls $14.10
*** SHOW DOWN *** 
Player#5539 collected $37.10 from pot
*** SUMMARY ***
Total Pot $38.60 | Rake $1.50
Board [2h Ac Qs 2s 8s]
Seat 1: warioman (small blind)
Seat 2: Player#5539 shows [Ts Ks] and won ($37.10) with 
Seat 3: Player#4590 folded before the flop
Seat 4: Player#6384 folded before the flop
Seat 5: Player#8677 folded before the flop
Seat 6: Player#8497 (button) folded before the flop

PokerStars Hand #0f24a218-10bc-45f4-a925-e60d3e0e9bf7:  Hold'em No Limit ($0.1/$0.20 USD) - 2021/11/20 12:07:00 ET
Table 'Leominster' 6-max Seat #4 is the button
Seat 1: Player#6467 ($20.50 in chips)
Seat 2: Player#3783 ($27.19 in chips)
Seat 3: Player#3918 ($20.86 in chips)
Seat 4: Player#8363 ($19.92 in chips)
Seat 5: warioman ($21.00 in chips)
warioman: posts small blind $0.10
Player#6467: posts big blind $0.20
*** HOLE CARDS ***
Dealt to warioman [5h Qh]
Player#3783: folds
Player#3918: folds
Player#8363: raises $0.20 to $0.6
warioman: folds
Player#6467: folds
Player#8363: doesn't show hand
Uncalled bet ($0.60) returned to Player#8363
Player#8363 collected $0.30 from pot
*** SUMMARY ***
Total Pot $0.30 | Rake $0.00
Seat 1: Player#6467 (big blind) folded before the flop
Seat 2: Player#3783 folded before the flop
Seat 3: Player#3918 folded before the flop
Seat 4: Player#8363 shows [] and won ($0.30) with 
Seat 5: warioman (small blind) folded before the flop

PokerStars Hand #95fb906f-4a55-48aa-9953-e6e5e136e561:  Hold'em No Limit ($0.1/$0.20 USD) - 2021/11/20 12:07:00 ET
Table 'Odessa' 6-max Seat #5 is the button
Seat 1: warioman ($19.40 in chips)
Seat 2: Player#4259 ($55.49 in chips)
Seat 3: Player#5501 ($20.83 in chips)
Seat 4: Player#0276 ($14.82 in chips)
Seat 5: Player#6748 ($20.33 in chips)
Seat 6: Player#2582 ($7.50 in chips)
Player#2582: posts small blind $0.10
warioman: posts big blind $0.20
*** HOLE CARDS ***
Dealt to warioman [2s Jc]
Player#4259: folds
Player#5501: folds
Player#0276: folds
Player#6748: raises $0.20 to $0.6
Player#2582: folds
warioman: folds
Player#6748: doesn't show hand
Uncalled bet ($0.60) returned to Player#6748
Player#6748 collected $0.30 from pot
*** SUMMARY ***
Total Pot $0.30 | Rake $0.00
Seat 1: warioman (big blind) folded before the flop
Seat 2: Player#4259 folded before the flop
Seat 3: Player#5501 folded before the flop
Seat 4: Player#0276 folded before the flop
Seat 5: Player#6748 shows [] and won ($0.30) with 
Seat 6: Player#2582 (small blind) folded before the flop

PokerStars Hand #97462104-08b9-4ec8-9d1d-f301032037fe:  Hold'em No Limit ($0.1/$0.20 USD) - 2021/11/20 12:07:00 ET
Table 'Odessa' 6-max Seat #4 is the button
Seat 1: warioman ($19.40 in chips)
Seat 2: Player#6304 ($55.19 in chips)
Seat 3: Player#6496 ($20.83 in chips)
Seat 4: Player#9627 ($14.82 in chips)
Seat 5: Player#8634 ($20.43 in chips)
Seat 6: Player#9784 ($7.70 in chips)
Player#8634: posts small blind $0.10
Player#9784: posts big blind $0.20
*** HOLE CARDS ***
Dealt to warioman [6h Jd]
warioman: folds
Player#6304: raises $0.20 to $0.7
Player#6496: folds
Player#9627: folds
Player#8634: folds
Player#9784: folds
Player#6304: doesn't show hand
Uncalled bet ($0.70) returned to Player#6304
Player#6304 collected $0.30 from pot
*** SUMMARY ***
Total Pot $0.30 | Rake $0.00
Seat 1: warioman folded before the flop
Seat 2: Player#6304 shows [] and won ($0.30) with 
Seat 3: Player#6496 folded before the flop
Seat 4: Player#9627 (button) folded before the flop
Seat 5: Player#8634 (small blind) folded before the flop
Seat 6: Player#9784 (big blind) folded before the flop

PokerStars Hand #1978e9aa-c37a-4e28-a465-d6d3863d136b:  Hold'em No Limit ($0.1/$0.20 USD) - 2021/11/20 12:07:00 ET
Table 'Minneapolis' 6-max Seat #1 is the button
Seat 1: warioman ($20.00 in chips)
Seat 2: Player#0316 ($25.85 in chips)
Seat 3: Player#3955 ($21.59 in chips)
Seat 4: Player#2356 ($9.26 in chips)
Seat 5: Player#3399 ($36.74 in chips)
Seat 6: Player#8363 ($20.34 in chips)
Player#0316: posts small blind $0.10
Player#3955: posts big blind $0.20
*** HOLE CARDS ***
Dealt to warioman [Ks Jd]
Player#2356: raises $0.20 to $0.4
Player#3399: folds
Player#8363: folds
warioman: folds
Player#0316: calls $0.30
Player#3955: folds
*** FLOP *** [7d 5s 4c]
Player#0316: checks
Player#2356: checks
*** TURN *** [7d 5s 4c] [Qh]
Player#0316: checks
Player#2356: bets $0.50
Player#0316: calls $0.50
*** RIVER *** [7d 5s 4c] [Qh] [3h]
Player#0316: checks
Player#2356: checks
*** SHOW DOWN *** 
Player#2356 collected $1.90 from pot
*** SUMMARY ***
Total Pot $2.00 | Rake $0.10
Board [7d 5s 4c Qh 3h]
Seat 1: warioman (button) folded before the flop
Seat 2: Player#0316 (small blind) mucked
Seat 3: Player#3955 (big blind) folded before the flop
Seat 4: Player#2356 shows [Qs Kh] and won ($1.90) with 
Seat 5: Player#3399 folded before the flop
Seat 6: Player#8363 folded before the flop

PokerStars Hand #2d647448-05fa-4831-83fb-f5aa726b6f34:  Hold'em No Limit ($0.1/$0.20 USD) - 2021/11/20 12:06:00 ET
Table 'Odessa' 6-max Seat #3 is the button
Seat 1: warioman ($19.40 in chips)
Seat 2: Player#9408 ($55.19 in chips)
Seat 3: Player#9156 ($20.00 in chips)
Seat 4: Player#6507 ($14.92 in chips)
Seat 5: Player#5538 ($20.63 in chips)
Seat 6: Player#2563 ($8.30 in chips)
Player#6507: posts small blind $0.10
Player#5538: posts big blind $0.20
*** HOLE CARDS ***
Dealt to warioman [4c 6s]
Player#2563: raises $0.20 to $0.6
warioman: folds
Player#9408: folds
Player#9156: calls $0.60
Player#6507: folds
Player#5538: folds
*** FLOP *** [7d 6c 4d]
Player#2563: checks
Player#9156: bets $1.00
Player#2563: folds
Player#9156: doesn't show hand
Uncalled bet ($1.00) returned to Player#9156
Player#9156 collected $1.43 from pot
*** SUMMARY ***
Total Pot $1.50 | Rake $0.08
Board [7d 6c 4d]
Seat 1: warioman folded before the flop
Seat 2: Player#9408 folded before the flop
Seat 3: Player#9156 shows [] and won ($1.43) with 
Seat 4: Player#6507 (small blind) folded before the flop
Seat 5: Player#5538 (big blind) folded before the flop
Seat 6: Player#2563 folded on the flop

PokerStars Hand #f8b0975a-4669-4018-b025-01f91840139c:  Hold'em No Limit ($0.1/$0.20 USD) - 2021/11/20 12:06:00 ET
Table 'Leominster' 6-max Seat #4 is the button
Seat 1: Player#8870 ($20.50 in chips)
Seat 2: Player#4766 ($27.19 in chips)
Seat 3: Player#9844 ($18.57 in chips)
Seat 4: Player#2370 ($19.38 in chips)
Seat 5: Player#1237 ($20.72 in chips)
Seat 6: warioman ($21.80 in chips)
Player#1237: posts small blind $0.10
warioman: posts big blind $0.20
*** HOLE CARDS ***
Dealt to warioman [Jc Qs]
Player#8870: folds
Player#4766: folds
Player#9844: folds
Player#2370: calls $0.20
Player#1237: raises $0.20 to $0.8
warioman: calls $0.60
Player#2370: calls $0.60
*** FLOP *** [7c 6s 5h]
Player#1237: checks
warioman: checks
Player#2370: bets $1.20
Player#1237: folds
warioman: folds
Player#2370: doesn't show hand
Uncalled bet ($1.20) returned to Player#2370
Player#2370 collected $2.28 from pot
*** SUMMARY ***
Total Pot $2.40 | Rake $0.12
Board [7c 6s 5h]
Seat 1: Player#8870 folded before the flop
Seat 2: Player#4766 folded before the flop
Seat 3: Player#9844 folded before the flop
Seat 4: Player#2370 shows [] and won ($2.28) with 
Seat 5: Player#1237 (small blind) folded on the flop
Seat 6: warioman (big blind) folded on the flop

PokerStars Hand #8491a054-6518-4fa4-b6f0-ce0e3f0eb6ab:  Hold'em No Limit ($0.1/$0.20 USD) - 2021/11/20 12:06:00 ET
Table 'Odessa' 6-max Seat #2 is the button
Seat 1: warioman ($19.40 in chips)
Seat 2: Player#6827 ($55.19 in chips)
Seat 3: Player#8683 ($20.10 in chips)
Seat 4: Player#8559 ($12.53 in chips)
Seat 5: Player#7610 ($23.18 in chips)
Seat 6: Player#0860 ($8.30 in chips)
Player#8683: posts small blind $0.10
Player#8559: posts big blind $0.20
*** HOLE CARDS ***
Dealt to warioman [Qd 4s]
Player#7610: raises $0.20 to $0.6
Player#0860: folds
warioman: folds
Player#6827: folds
Player#8683: folds
Player#8559: calls $0.40
*** FLOP *** [9c 3h 6d]
Player#8559: checks
Player#7610: bets $0.65
Player#8559: calls $0.65
*** TURN *** [9c 3h 6d] [As]
Player#8559: checks
Player#7610: bets $1.30
Player#8559: calls $1.30
*** RIVER *** [9c 3h 6d] [As] [Ks]
Player#8559: checks
Player#7610: checks
*** SHOW DOWN *** 
Player#8559 collected $4.94 from pot
*** SUMMARY ***
Total Pot $5.20 | Rake $0.26
Board [9c 3h 6d As Ks]
Seat 1: warioman folded before the flop
Seat 2: Player#6827 (button) folded before the flop
Seat 3: Player#8683 (small blind) folded before the flop
Seat 4: Player#8559 shows [Ac Jd] and won ($4.94) with 
Seat 5: Player#7610 mucked
Seat 6: Player#0860 folded before the flop

PokerStars Hand #adaeb9f5-d50e-4ed8-b3f5-cb9cf18ef49a:  Hold'em No Limit ($0.1/$0.20 USD) - 2021/11/20 12:06:00 ET
Table 'Minneapolis' 6-max Seat #6 is the button
Seat 1: warioman ($19.40 in chips)
Seat 2: Player#9522 ($22.61 in chips)
Seat 3: Player#1187 ($21.59 in chips)
Seat 4: Player#3090 ($9.26 in chips)
Seat 5: Player#7524 ($36.74 in chips)
Seat 6: Player#0960 ($20.34 in chips)
warioman: posts small blind $0.10
Player#9522: posts big blind $0.20
*** HOLE CARDS ***
Dealt to warioman [Kc 7c]
Player#1187: folds
Player#3090: folds
Player#7524: folds
Player#0960: folds
warioman: calls $0.10
Player#9522: checks
*** FLOP *** [Th 6d 9s]
warioman: checks
Player#9522: bets $0.40
warioman: calls $0.40
*** TURN *** [Th 6d 9s] [Qs]
warioman: checks
Player#9522: bets $1.20
warioman: raises1.20 to $3
Player#9522: calls $1.80
*** RIVER *** [Th 6d 9s] [Qs] [3s]
warioman: checks
Player#9522: checks
*** SHOW DOWN *** 
Player#9522 collected $6.84 from pot
*** SUMMARY ***
Total Pot $7.20 | Rake $0.36
Board [Th 6d 9s Qs 3s]
Seat 1: warioman (small blind)
Seat 2: Player#9522 shows [7h Qh] and won ($6.84) with 
Seat 3: Player#1187 folded before the flop
Seat 4: Player#3090 folded before the flop
Seat 5: Player#7524 folded before the flop
Seat 6: Player#0960 (button) folded before the flop

PokerStars Hand #7a4b85f5-12ed-4100-bedb-d7c9877df4dd:  Hold'em No Limit ($0.1/$0.20 USD) - 2021/11/20 12:05:00 ET
Table 'Odessa' 6-max Seat #1 is the button
Seat 1: warioman ($19.40 in chips)
Seat 2: Player#5959 ($55.29 in chips)
Seat 3: Player#3357 ($20.00 in chips)
Seat 4: Player#2374 ($12.53 in chips)
Seat 5: Player#8798 ($23.18 in chips)
Seat 6: Player#7887 ($8.30 in chips)
Player#5959: posts small blind $0.10
Player#3357: posts big blind $0.20
*** HOLE CARDS ***
Dealt to warioman [7c Js]
Player#2374: folds
Player#8798: folds
Player#7887: folds
warioman: folds
Player#5959: folds
Player#3357 collected $0.20 from pot
*** SUMMARY ***
Total Pot $0.20 | Rake $0.00
Seat 1: warioman (button) folded before the flop
Seat 2: Player#5959 (small blind) folded before the flop
Seat 3: Player#3357 shows [] and won ($0.20) with 
Seat 4: Player#2374 folded before the flop
Seat 5: Player#8798 folded before the flop
Seat 6: Player#7887 folded before the flop

PokerStars Hand #d55383e6-23c3-485a-8ef5-443c0fcefc6b:  Hold'em No Limit ($0.1/$0.20 USD) - 2021/11/20 12:05:00 ET
Table 'Odessa' 6-max Seat #6 is the button
Seat 1: warioman ($19.50 in chips)
Seat 2: Player#6675 ($55.49 in chips)
Seat 3: Player#7329 ($20.00 in chips)
Seat 4: Player#0426 ($12.53 in chips)
Seat 5: Player#1988 ($22.88 in chips)
Seat 6: Player#7233 ($8.30 in chips)
warioman: posts small blind $0.10
Player#6675: posts big blind $0.20
*** HOLE CARDS ***
Dealt to warioman [Ts 6h]
Player#7329: folds
Player#0426: folds
Player#1988: raises $0.20 to $0.6
Player#7233: folds
warioman: folds
Player#6675: folds
Player#1988: doesn't show hand
Uncalled bet ($0.60) returned to Player#1988
Player#1988 collected $0.30 from pot
*** SUMMARY ***
Total Pot $0.30 | Rake $0.00
Seat 1: warioman (small blind) folded before the flop
Seat 2: Player#6675 (big blind) folded before the flop
Seat 3: Player#7329 folded before the flop
Seat 4: Player#0426 folded before the flop
Seat 5: Player#1988 shows [] and won ($0.30) with 
Seat 6: Player#7233 (button) folded before the flop

PokerStars Hand #982d8f66-77f2-44bf-ae54-60d2ec0b9157:  Hold'em No Limit ($0.1/$0.20 USD) - 2021/11/20 12:05:00 ET
Table 'Leominster' 6-max Seat #3 is the button
Seat 1: Player#7624 ($19.90 in chips)
Seat 2: Player#4964 ($27.19 in chips)
Seat 3: Player#4012 ($18.57 in chips)
Seat 4: Player#6769 ($19.83 in chips)
Seat 5: Player#6146 ($20.92 in chips)
Seat 6: warioman ($21.80 in chips)
Player#6769: posts small blind $0.10
Player#6146: posts big blind $0.20
*** HOLE CARDS ***
Dealt to warioman [4c 2h]
warioman: folds
Player#7624: raises $0.20 to $0.45
Player#4964: folds
Player#4012: folds
Player#6769: calls $0.35
Player#6146: folds
*** FLOP *** [Qd 6s Qc]
Player#6769: checks
Player#7624: checks
*** TURN *** [Qd 6s Qc] [7h]
Player#6769: checks
Player#7624: bets $0.40
Player#6769: folds
Player#7624: doesn't show hand
Uncalled bet ($0.40) returned to Player#7624
Player#7624 collected $1.05 from pot
*** SUMMARY ***
Total Pot $1.10 | Rake $0.06
Board [Qd 6s Qc 7h]
Seat 1: Player#7624 shows [] and won ($1.05) with 
Seat 2: Player#4964 folded before the flop
Seat 3: Player#4012 (button) folded before the flop
Seat 4: Player#6769 (small blind) folded on the turn
Seat 5: Player#6146 (big blind) folded before the flop
Seat 6: warioman folded before the flop

PokerStars Hand #e9546554-905a-4601-9fb3-9f99df958ecc:  Hold'em No Limit ($0.1/$0.20 USD) - 2021/11/20 12:05:00 ET
Table 'Odessa' 6-max Seat #5 is the button
Seat 1: warioman ($19.70 in chips)
Seat 2: Player#8825 ($55.49 in chips)
Seat 3: Player#0024 ($20.00 in chips)
Seat 4: Player#9077 ($12.23 in chips)
Seat 5: Player#5889 ($22.88 in chips)
Seat 6: Player#3903 ($8.40 in chips)
Player#3903: posts small blind $0.10
warioman: posts big blind $0.20
*** HOLE CARDS ***
Dealt to warioman [Js 7h]
Player#8825: folds
Player#0024: folds
Player#9077: raises $0.20 to $0.6
Player#5889: folds
Player#3903: folds
warioman: folds
Player#9077: doesn't show hand
Uncalled bet ($0.60) returned to Player#9077
Player#9077 collected $0.30 from pot
*** SUMMARY ***
Total Pot $0.30 | Rake $0.00
Seat 1: warioman (big blind) folded before the flop
Seat 2: Player#8825 folded before the flop
Seat 3: Player#0024 folded before the flop
Seat 4: Player#9077 shows [] and won ($0.30) with 
Seat 5: Player#5889 (button) folded before the flop
Seat 6: Player#3903 (small blind) folded before the flop

PokerStars Hand #824f18de-26d5-4a4a-8536-89e7eed89ca6:  Hold'em No Limit ($0.1/$0.20 USD) - 2021/11/20 12:05:00 ET
Table 'Minneapolis' 6-max Seat #5 is the button
Seat 1: warioman ($20.00 in chips)
Seat 2: Player#1462 ($22.61 in chips)
Seat 3: Player#4255 ($21.59 in chips)
Seat 4: Player#7345 ($9.26 in chips)
Seat 5: Player#5744 ($36.74 in chips)
Seat 6: Player#4182 ($19.80 in chips)
Player#4182: posts small blind $0.10
warioman: posts big blind $0.20
*** HOLE CARDS ***
Dealt to warioman [Kh 2h]
Player#1462: folds
Player#4255: folds
Player#7345: folds
Player#5744: folds
Player#4182: raises $0.20 to $0.6
warioman: calls $0.40
*** FLOP *** [Ac Qd 5d]
Player#4182: bets $0.45
warioman: folds
Player#4182: doesn't show hand
Uncalled bet ($0.45) returned to Player#4182
Player#4182 collected $1.14 from pot
*** SUMMARY ***
Total Pot $1.20 | Rake $0.06
Board [Ac Qd 5d]
Seat 1: warioman (big blind) folded on the flop
Seat 2: Player#1462 folded before the flop
Seat 3: Player#4255 folded before the flop
Seat 4: Player#7345 folded before the flop
Seat 5: Player#5744 (button) folded before the flop
Seat 6: Player#4182 shows [] and won ($1.14) with 

PokerStars Hand #6c627584-24aa-4985-ab95-d6f4da7247e2:  Hold'em No Limit ($0.1/$0.20 USD) - 2021/11/20 12:05:00 ET
Table 'Leominster' 6-max Seat #2 is the button
Seat 1: Player#1919 ($19.90 in chips)
Seat 2: Player#4060 ($27.19 in chips)
Seat 3: Player#7729 ($18.67 in chips)
Seat 4: Player#3362 ($21.08 in chips)
Seat 5: Player#7743 ($19.70 in chips)
Seat 6: warioman ($21.80 in chips)
Player#7729: posts small blind $0.10
Player#3362: posts big blind $0.20
*** HOLE CARDS ***
Dealt to warioman [Jh 3c]
Player#7743: raises $0.20 to $0.6
warioman: folds
Player#1919: folds
Player#4060: folds
Player#7729: folds
Player#3362: calls $0.40
*** FLOP *** [Js 9d 4d]
Player#3362: bets $0.65
Player#7743: raises $0.65 to $2.1
Player#3362: folds
Player#7743: doesn't show hand
Uncalled bet ($2.10) returned to Player#7743
Player#7743 collected $1.85 from pot
*** SUMMARY ***
Total Pot $1.95 | Rake $0.10
Board [Js 9d 4d]
Seat 1: Player#1919 folded before the flop
Seat 2: Player#4060 (button) folded before the flop
Seat 3: Player#7729 (small blind) folded before the flop
Seat 4: Player#3362 (big blind) folded on the flop
Seat 5: Player#7743 shows [] and won ($1.85) with 
Seat 6: warioman folded before the flop

PokerStars Hand #2efa9afd-a72c-4b3b-b870-88e523b9cf40:  Hold'em No Limit ($0.1/$0.20 USD) - 2021/11/20 12:05:00 ET
Table 'Odessa' 6-max Seat #4 is the button
Seat 1: warioman ($19.70 in chips)
Seat 2: Player#8681 ($55.49 in chips)
Seat 3: Player#6917 ($20.00 in chips)
Seat 4: Player#4090 ($12.23 in chips)
Seat 5: Player#3826 ($22.98 in chips)
Seat 6: Player#5944 ($8.30 in chips)
Player#3826: posts small blind $0.10
Player#5944: posts big blind $0.20
*** HOLE CARDS ***
Dealt to warioman [2d 9s]
warioman: folds
Player#8681: folds
Player#6917: folds
Player#4090: folds
Player#3826: folds
Player#5944 collected $0.20 from pot
*** SUMMARY ***
Total Pot $0.20 | Rake $0.00
Seat 1: warioman folded before the flop
Seat 2: Player#8681 folded before the flop
Seat 3: Player#6917 folded before the flop
Seat 4: Player#4090 (button) folded before the flop
Seat 5: Player#3826 (small blind) folded before the flop
Seat 6: Player#5944 shows [] and won ($0.20) with 

PokerStars Hand #2a05990f-49d2-4da2-abfc-7688dfc3a7d2:  Hold'em No Limit ($0.1/$0.20 USD) - 2021/11/20 12:04:00 ET
Table 'Odessa' 6-max Seat #3 is the button
Seat 1: warioman ($19.70 in chips)
Seat 2: Player#8832 ($55.49 in chips)
Seat 3: Player#2053 ($20.40 in chips)
Seat 4: Player#6482 ($11.63 in chips)
Seat 5: Player#0155 ($23.18 in chips)
Seat 6: Player#7958 ($8.30 in chips)
Player#6482: posts small blind $0.10
Player#0155: posts big blind $0.20
*** HOLE CARDS ***
Dealt to warioman [2s 7d]
Player#7958: folds
warioman: folds
Player#8832: folds
Player#2053: raises $0.20 to $0.4
Player#6482: raises $0.40 to $1.4
Player#0155: folds
Player#2053: folds
Player#6482: doesn't show hand
Uncalled bet ($1.40) returned to Player#6482
Player#6482 collected $0.60 from pot
*** SUMMARY ***
Total Pot $0.60 | Rake $0.00
Seat 1: warioman folded before the flop
Seat 2: Player#8832 folded before the flop
Seat 3: Player#2053 (button) folded before the flop
Seat 4: Player#6482 shows [] and won ($0.60) with 
Seat 5: Player#0155 (big blind) folded before the flop
Seat 6: Player#7958 folded before the flop

PokerStars Hand #eb809ebe-772f-44d6-a33a-09e78d4456af:  Hold'em No Limit ($0.1/$0.20 USD) - 2021/11/20 12:04:00 ET
Table 'Leominster' 6-max Seat #1 is the button
Seat 1: Player#8213 ($19.90 in chips)
Seat 2: Player#1479 ($27.29 in chips)
Seat 3: Player#8731 ($18.87 in chips)
Seat 4: Player#2804 ($20.80 in chips)
Seat 5: Player#6809 ($19.70 in chips)
Seat 6: warioman ($21.80 in chips)
Player#1479: posts small blind $0.10
Player#8731: posts big blind $0.20
*** HOLE CARDS ***
Dealt to warioman [Kc 4c]
Player#2804: calls $0.20
Player#6809: folds
warioman: folds
Player#8213: folds
Player#1479: folds
Player#8731: checks
*** FLOP *** [Kh 3c 9h]
Player#8731: checks
Player#2804: checks
*** TURN *** [Kh 3c 9h] [6c]
Player#8731: checks
Player#2804: bets $0.20
Player#8731: folds
Player#2804: doesn't show hand
Uncalled bet ($0.20) returned to Player#2804
Player#2804 collected $0.47 from pot
*** SUMMARY ***
Total Pot $0.50 | Rake $0.02
Board [Kh 3c 9h 6c]
Seat 1: Player#8213 (button) folded before the flop
Seat 2: Player#1479 (small blind) folded before the flop
Seat 3: Player#8731 (big blind) folded on the turn
Seat 4: Player#2804 shows [] and won ($0.47) with 
Seat 5: Player#6809 folded before the flop
Seat 6: warioman folded before the flop

PokerStars Hand #b41e3100-1dd8-469f-8574-e9a41be8a00e:  Hold'em No Limit ($0.1/$0.20 USD) - 2021/11/20 12:04:00 ET
Table 'Leominster' 6-max Seat #6 is the button
Seat 1: Player#1189 ($20.00 in chips)
Seat 2: Player#4443 ($27.49 in chips)
Seat 3: Player#5322 ($18.57 in chips)
Seat 4: Player#0380 ($20.80 in chips)
Seat 5: Player#8003 ($19.70 in chips)
Seat 6: warioman ($21.80 in chips)
Player#1189: posts small blind $0.10
Player#4443: posts big blind $0.20
*** HOLE CARDS ***
Dealt to warioman [7h As]
Player#5322: raises $0.20 to $0.45
Player#0380: folds
Player#8003: folds
warioman: folds
Player#1189: folds
Player#4443: folds
Player#5322: doesn't show hand
Uncalled bet ($0.45) returned to Player#5322
Player#5322 collected $0.30 from pot
*** SUMMARY ***
Total Pot $0.30 | Rake $0.00
Seat 1: Player#1189 (small blind) folded before the flop
Seat 2: Player#4443 (big blind) folded before the flop
Seat 3: Player#5322 shows [] and won ($0.30) with 
Seat 4: Player#0380 folded before the flop
Seat 5: Player#8003 folded before the flop
Seat 6: warioman (button) folded before the flop

PokerStars Hand #8a3a8269-c11a-4904-bfdc-06b85e149c1a:  Hold'em No Limit ($0.1/$0.20 USD) - 2021/11/20 12:03:00 ET
Table 'Minneapolis' 6-max Seat #4 is the button
Seat 1: warioman ($20.00 in chips)
Seat 2: Player#0105 ($22.61 in chips)
Seat 3: Player#3092 ($21.59 in chips)
Seat 4: Player#9146 ($7.81 in chips)
Seat 5: Player#0643 ($38.14 in chips)
Seat 6: Player#0465 ($20.00 in chips)
Player#0643: posts small blind $0.10
Player#0465: posts big blind $0.20
*** HOLE CARDS ***
Dealt to warioman [9d 8h]
warioman: folds
Player#0105: folds
Player#3092: folds
Player#9146: calls $0.20
Player#0643: calls $0.10
Player#0465: checks
*** FLOP *** [Jc Kc 2c]
Player#0643: checks
Player#0465: checks
Player#9146: bets $0.40
Player#0643: calls $0.40
Player#0465: folds
*** TURN *** [Jc Kc 2c] [Js]
Player#0643: checks
Player#9146: checks
*** RIVER *** [Jc Kc 2c] [Js] [3s]
Player#0643: bets $0.80
Player#9146: raises $0.80 to $7.21
Player#0643: folds
Player#9146: doesn't show hand
Uncalled bet ($7.21) returned to Player#9146
Player#9146 collected $2.09 from pot
*** SUMMARY ***
Total Pot $2.20 | Rake $0.11
Board [Jc Kc 2c Js 3s]
Seat 1: warioman folded before the flop
Seat 2: Player#0105 folded before the flop
Seat 3: Player#3092 folded before the flop
Seat 4: Player#9146 shows [] and won ($2.09) with 
Seat 5: Player#0643 (small blind) folded on the river
Seat 6: Player#0465 (big blind) folded on the flop

PokerStars Hand #291c0cd1-6324-4da2-9f7e-f9afc3df4692:  Hold'em No Limit ($0.1/$0.20 USD) - 2021/11/20 12:03:00 ET
Table 'Odessa' 6-max Seat #2 is the button
Seat 1: warioman ($19.70 in chips)
Seat 2: Player#7588 ($55.49 in chips)
Seat 3: Player#8739 ($21.00 in chips)
Seat 4: Player#8371 ($11.83 in chips)
Seat 5: Player#9772 ($22.45 in chips)
Seat 6: Player#0862 ($8.30 in chips)
Player#8739: posts small blind $0.10
Player#8371: posts big blind $0.20
*** HOLE CARDS ***
Dealt to warioman [2s 6d]
Player#9772: raises $0.20 to $0.6
Player#0862: folds
warioman: folds
Player#7588: folds
Player#8739: calls $0.50
Player#8371: folds
*** FLOP *** [8d 3s 5c]
Player#8739: checks
Player#9772: checks
*** TURN *** [8d 3s 5c] [4d]
Player#8739: checks
Player#9772: bets $0.70
Player#8739: folds
Player#9772: doesn't show hand
Uncalled bet ($0.70) returned to Player#9772
Player#9772 collected $1.33 from pot
*** SUMMARY ***
Total Pot $1.40 | Rake $0.07
Board [8d 3s 5c 4d]
Seat 1: warioman folded before the flop
Seat 2: Player#7588 (button) folded before the flop
Seat 3: Player#8739 (small blind) folded on the turn
Seat 4: Player#8371 (big blind) folded before the flop
Seat 5: Player#9772 shows [] and won ($1.33) with 
Seat 6: Player#0862 folded before the flop

PokerStars Hand #2e8b71f8-fd01-42f1-b3bd-a622730206d0:  Hold'em No Limit ($0.1/$0.20 USD) - 2021/11/20 12:03:00 ET
Table 'Odessa' 6-max Seat #1 is the button
Seat 1: warioman ($19.70 in chips)
Seat 2: Player#6952 ($55.29 in chips)
Seat 3: Player#4639 ($21.20 in chips)
Seat 4: Player#6133 ($11.83 in chips)
Seat 5: Player#9056 ($22.45 in chips)
Seat 6: Player#8594 ($8.30 in chips)
Player#6952: posts small blind $0.10
Player#4639: posts big blind $0.20
*** HOLE CARDS ***
Dealt to warioman [Kh 2h]
Player#6133: folds
Player#9056: folds
Player#8594: folds
warioman: folds
Player#6952: raises $0.20 to $0.6
Player#4639: folds
Player#6952: doesn't show hand
Uncalled bet ($0.60) returned to Player#6952
Player#6952 collected $0.20 from pot
*** SUMMARY ***
Total Pot $0.20 | Rake $0.00
Seat 1: warioman (button) folded before the flop
Seat 2: Player#6952 shows [] and won ($0.20) with 
Seat 3: Player#4639 (big blind) folded before the flop
Seat 4: Player#6133 folded before the flop
Seat 5: Player#9056 folded before the flop
Seat 6: Player#8594 folded before the flop

PokerStars Hand #9c72da0f-4c57-4f2d-82bf-e3c4c78823f9:  Hold'em No Limit ($0.1/$0.20 USD) - 2021/11/20 12:03:00 ET
Table 'Leominster' 6-max Seat #5 is the button
Seat 1: Player#4209 ($20.69 in chips)
Seat 2: Player#1116 ($27.49 in chips)
Seat 3: Player#0811 ($18.57 in chips)
Seat 4: Player#6499 ($20.80 in chips)
Seat 5: Player#8215 ($19.70 in chips)
Seat 6: warioman ($21.00 in chips)
warioman: posts small blind $0.10
Player#4209: posts big blind $0.20
*** HOLE CARDS ***
Dealt to warioman [9d Qd]
Player#1116: folds
Player#0811: folds
Player#6499: folds
Player#8215: folds
warioman: calls $0.10
Player#4209: raises $0.20 to $0.8
warioman: raises $0.80 to $3.2
Player#4209: folds
warioman: doesn't show hand
Uncalled bet ($3.20) returned to warioman
warioman collected $0.80 from pot
*** SUMMARY ***
Total Pot $0.80 | Rake $0.00
Seat 1: Player#4209 (big blind) folded before the flop
Seat 2: Player#1116 folded before the flop
Seat 3: Player#0811 folded before the flop
Seat 4: Player#6499 folded before the flop
Seat 5: Player#8215 (button) folded before the flop
Seat 6: warioman (small blind)

PokerStars Hand #2de5abe6-3aa3-4733-8d70-618a2e037d3d:  Hold'em No Limit ($0.1/$0.20 USD) - 2021/11/20 12:03:00 ET
Table 'Odessa' 6-max Seat #6 is the button
Seat 1: warioman ($19.80 in chips)
Seat 2: Player#0116 ($55.49 in chips)
Seat 3: Player#8994 ($21.20 in chips)
Seat 4: Player#1492 ($11.83 in chips)
Seat 5: Player#6734 ($22.15 in chips)
Seat 6: Player#0535 ($8.30 in chips)
warioman: posts small blind $0.10
Player#0116: posts big blind $0.20
*** HOLE CARDS ***
Dealt to warioman [4c 9d]
Player#8994: folds
Player#1492: folds
Player#6734: raises $0.20 to $0.6
Player#0535: folds
warioman: folds
Player#0116: folds
Player#6734: doesn't show hand
Uncalled bet ($0.60) returned to Player#6734
Player#6734 collected $0.30 from pot
*** SUMMARY ***
Total Pot $0.30 | Rake $0.00
Seat 1: warioman (small blind) folded before the flop
Seat 2: Player#0116 (big blind) folded before the flop
Seat 3: Player#8994 folded before the flop
Seat 4: Player#1492 folded before the flop
Seat 5: Player#6734 shows [] and won ($0.30) with 
Seat 6: Player#0535 (button) folded before the flop

PokerStars Hand #6e904d27-1124-4ce7-8429-ea0e9516ee7c:  Hold'em No Limit ($0.1/$0.20 USD) - 2021/11/20 12:02:00 ET
Table 'Minneapolis' 6-max Seat #3 is the button
Seat 1: warioman ($19.20 in chips)
Seat 2: Player#6574 ($24.31 in chips)
Seat 3: Player#6781 ($19.30 in chips)
Seat 4: Player#5680 ($7.91 in chips)
Seat 5: Player#7529 ($38.34 in chips)
Seat 6: Player#2891 ($20.00 in chips)
Player#5680: posts small blind $0.10
Player#7529: posts big blind $0.20
*** HOLE CARDS ***
Dealt to warioman [Tc Ah]
Player#2891: folds
warioman: raises $0.20 to $0.5
Player#6574: calls $0.50
Player#6781: calls $0.50
Player#5680: folds
Player#7529: folds
*** FLOP *** [4s 8h Ks]
warioman: checks
Player#6574: checks
Player#6781: bets $1.20
warioman: folds
Player#6574: calls $1.20
*** TURN *** [4s 8h Ks] [8d]
Player#6574: checks
Player#6781: bets $2.90
Player#6574: folds
Player#6781: doesn't show hand
Uncalled bet ($2.90) returned to Player#6781
Player#6781 collected $3.99 from pot
*** SUMMARY ***
Total Pot $4.20 | Rake $0.21
Board [4s 8h Ks 8d]
Seat 1: warioman folded on the flop
Seat 2: Player#6574 folded on the turn
Seat 3: Player#6781 shows [] and won ($3.99) with 
Seat 4: Player#5680 (small blind) folded before the flop
Seat 5: Player#7529 (big blind) folded before the flop
Seat 6: Player#2891 folded before the flop

PokerStars Hand #150aaf08-8ff4-4549-a268-bbf4a4cf812a:  Hold'em No Limit ($0.1/$0.20 USD) - 2021/11/20 12:02:00 ET
Table 'Leominster' 6-max Seat #4 is the button
Seat 1: Player#3347 ($20.00 in chips)
Seat 2: Player#8088 ($27.49 in chips)
Seat 3: Player#1833 ($18.57 in chips)
Seat 4: Player#5091 ($21.25 in chips)
Seat 5: Player#5803 ($19.80 in chips)
Seat 6: warioman ($21.20 in chips)
Player#5803: posts small blind $0.10
warioman: posts big blind $0.20
*** HOLE CARDS ***
Dealt to warioman [4c 9c]
Player#3347: raises $0.20 to $0.45
Player#8088: folds
Player#1833: folds
Player#5091: calls $0.45
Player#5803: folds
warioman: folds
*** FLOP *** [5c Qh 6c]
Player#3347: bets $0.50
Player#5091: folds
Player#3347: doesn't show hand
Uncalled bet ($0.50) returned to Player#3347
Player#3347 collected $1.14 from pot
*** SUMMARY ***
Total Pot $1.20 | Rake $0.06
Board [5c Qh 6c]
Seat 1: Player#3347 shows [] and won ($1.14) with 
Seat 2: Player#8088 folded before the flop
Seat 3: Player#1833 folded before the flop
Seat 4: Player#5091 (button) folded on the flop
Seat 5: Player#5803 (small blind) folded before the flop
Seat 6: warioman (big blind) folded before the flop

PokerStars Hand #1bc79b63-9b2b-4649-ada8-5b4eae704ee0:  Hold'em No Limit ($0.1/$0.20 USD) - 2021/11/20 12:02:00 ET
Table 'Minneapolis' 6-max Seat #2 is the button
Seat 1: warioman ($19.20 in chips)
Seat 2: Player#6830 ($24.01 in chips)
Seat 3: Player#2948 ($19.40 in chips)
Seat 4: Player#5413 ($8.11 in chips)
Seat 5: Player#0669 ($38.34 in chips)
Seat 6: Player#7587 ($20.00 in chips)
Player#2948: posts small blind $0.10
Player#5413: posts big blind $0.20
*** HOLE CARDS ***
Dealt to warioman [8s Jc]
Player#0669: folds
Player#7587: folds
warioman: folds
Player#6830: raises $0.20 to $0.6
Player#2948: folds
Player#5413: folds
Player#6830: doesn't show hand
Uncalled bet ($0.60) returned to Player#6830
Player#6830 collected $0.30 from pot
*** SUMMARY ***
Total Pot $0.30 | Rake $0.00
Seat 1: warioman folded before the flop
Seat 2: Player#6830 shows [] and won ($0.30) with 
Seat 3: Player#2948 (small blind) folded before the flop
Seat 4: Player#5413 (big blind) folded before the flop
Seat 5: Player#0669 folded before the flop
Seat 6: Player#7587 folded before the flop

PokerStars Hand #b3e930ac-d78a-4468-88e3-34ea23963fb2:  Hold'em No Limit ($0.1/$0.20 USD) - 2021/11/20 12:02:00 ET
Table 'Odessa' 6-max Seat #5 is the button
Seat 1: warioman ($20.00 in chips)
Seat 2: Player#1540 ($55.49 in chips)
Seat 3: Player#9218 ($21.20 in chips)
Seat 4: Player#4388 ($10.92 in chips)
Seat 5: Player#5450 ($22.15 in chips)
Seat 6: Player#5318 ($9.10 in chips)
Player#5318: posts small blind $0.10
warioman: posts big blind $0.20
*** HOLE CARDS ***
Dealt to warioman [Ks 7d]
Player#1540: folds
Player#9218: folds
Player#4388: calls $0.20
Player#5450: folds
Player#5318: calls $0.10
warioman: checks
*** FLOP *** [7s 4d 8c]
Player#5318: checks
warioman: checks
Player#4388: checks
*** TURN *** [7s 4d 8c] [Tc]
Player#5318: checks
warioman: checks
Player#4388: checks
*** RIVER *** [7s 4d 8c] [Tc] [Jc]
Player#5318: bets $0.60
warioman: folds
Player#4388: raises $0.60 to $2.4
Player#5318: folds
Player#4388: doesn't show hand
Uncalled bet ($2.40) returned to Player#4388
Player#4388 collected $1.14 from pot
*** SUMMARY ***
Total Pot $1.20 | Rake $0.06
Board [7s 4d 8c Tc Jc]
Seat 1: warioman (big blind) folded on the river
Seat 2: Player#1540 folded before the flop
Seat 3: Player#9218 folded before the flop
Seat 4: Player#4388 shows [] and won ($1.14) with 
Seat 5: Player#5450 (button) folded before the flop
Seat 6: Player#5318 (small blind) folded on the river

PokerStars Hand #59f5be88-0f05-4d02-b330-34d718a299b6:  Hold'em No Limit ($0.1/$0.20 USD) - 2021/11/20 12:02:00 ET
Table 'Minneapolis' 6-max Seat #1 is the button
Seat 1: warioman ($19.20 in chips)
Seat 2: Player#4884 ($23.47 in chips)
Seat 3: Player#7105 ($20.00 in chips)
Seat 4: Player#7521 ($8.11 in chips)
Seat 5: Player#2106 ($38.34 in chips)
Seat 6: Player#2810 ($20.00 in chips)
Player#4884: posts small blind $0.10
Player#7105: posts big blind $0.20
*** HOLE CARDS ***
Dealt to warioman [9d 2h]
Player#7521: folds
Player#2106: folds
Player#2810: folds
warioman: folds
Player#4884: raises $0.20 to $0.6
Player#7105: calls $0.40
*** FLOP *** [Th 9s 3h]
Player#4884: bets $0.90
Player#7105: folds
Player#4884: doesn't show hand
Uncalled bet ($0.90) returned to Player#4884
Player#4884 collected $1.14 from pot
*** SUMMARY ***
Total Pot $1.20 | Rake $0.06
Board [Th 9s 3h]
Seat 1: warioman (button) folded before the flop
Seat 2: Player#4884 shows [] and won ($1.14) with 
Seat 3: Player#7105 (big blind) folded on the flop
Seat 4: Player#7521 folded before the flop
Seat 5: Player#2106 folded before the flop
Seat 6: Player#2810 folded before the flop

PokerStars Hand #12391471-ebcb-47ae-8765-ee435f76d36b:  Hold'em No Limit ($0.1/$0.20 USD) - 2021/11/20 12:01:00 ET
Table 'Minneapolis' 6-max Seat #6 is the button
Seat 1: warioman ($19.30 in chips)
Seat 2: Player#6319 ($23.67 in chips)
Seat 3: Player#8139 ($20.00 in chips)
Seat 4: Player#4979 ($8.11 in chips)
Seat 5: Player#0900 ($38.04 in chips)
Seat 6: Player#4578 ($20.00 in chips)
warioman: posts small blind $0.10
Player#6319: posts big blind $0.20
*** HOLE CARDS ***
Dealt to warioman [Kc 6s]
Player#8139: folds
Player#4979: folds
Player#0900: raises $0.20 to $0.6
Player#4578: folds
warioman: folds
Player#6319: folds
Player#0900: doesn't show hand
Uncalled bet ($0.60) returned to Player#0900
Player#0900 collected $0.30 from pot
*** SUMMARY ***
Total Pot $0.30 | Rake $0.00
Seat 1: warioman (small blind) folded before the flop
Seat 2: Player#6319 (big blind) folded before the flop
Seat 3: Player#8139 folded before the flop
Seat 4: Player#4979 folded before the flop
Seat 5: Player#0900 shows [] and won ($0.30) with 
Seat 6: Player#4578 (button) folded before the flop

PokerStars Hand #0c97fd4b-a0df-4bde-a7dc-6fe9d5105b5e:  Hold'em No Limit ($0.1/$0.20 USD) - 2021/11/20 12:01:00 ET
Table 'Leominster' 6-max Seat #3 is the button
Seat 1: Player#6828 ($19.90 in chips)
Seat 2: Player#4365 ($27.49 in chips)
Seat 3: Player#0088 ($18.57 in chips)
Seat 4: Player#3593 ($20.16 in chips)
Seat 5: Player#8080 ($20.00 in chips)
Seat 6: warioman ($21.20 in chips)
Player#3593: posts small blind $0.10
Player#8080: posts big blind $0.20
*** HOLE CARDS ***
Dealt to warioman [4d Kc]
warioman: folds
Player#6828: raises $0.20 to $0.45
Player#4365: folds
Player#0088: folds
Player#3593: calls $0.35
Player#8080: folds
*** FLOP *** [Js 8s Qh]
Player#3593: bets $0.55
Player#6828: calls $0.55
*** TURN *** [Js 8s Qh] [8d]
Player#3593: bets $1.60
Player#6828: folds
Player#3593: doesn't show hand
Uncalled bet ($1.60) returned to Player#3593
Player#3593 collected $2.09 from pot
*** SUMMARY ***
Total Pot $2.20 | Rake $0.11
Board [Js 8s Qh 8d]
Seat 1: Player#6828 folded on the turn
Seat 2: Player#4365 folded before the flop
Seat 3: Player#0088 (button) folded before the flop
Seat 4: Player#3593 shows [] and won ($2.09) with 
Seat 5: Player#8080 (big blind) folded before the flop
Seat 6: warioman folded before the flop

PokerStars Hand #20a0942b-b459-4fab-bdbd-02bbeccafddd:  Hold'em No Limit ($0.1/$0.20 USD) - 2021/11/20 12:01:00 ET
Table 'Leominster' 6-max Seat #2 is the button
Seat 1: Player#9118 ($19.90 in chips)
Seat 2: Player#1039 ($26.69 in chips)
Seat 3: Player#3298 ($18.67 in chips)
Seat 4: Player#1368 ($20.36 in chips)
Seat 5: Player#5989 ($16.20 in chips)
Seat 6: warioman ($21.70 in chips)
Player#3298: posts small blind $0.10
Player#1368: posts big blind $0.20
*** HOLE CARDS ***
Dealt to warioman [Qs 7s]
Player#5989: folds
warioman: raises $0.20 to $0.5
Player#9118: folds
Player#1039: raises $0.50 to $1.8
Player#3298: folds
Player#1368: folds
warioman: folds
Player#1039: doesn't show hand
Uncalled bet ($1.80) returned to Player#1039
Player#1039 collected $0.80 from pot
*** SUMMARY ***
Total Pot $0.80 | Rake $0.00
Seat 1: Player#9118 folded before the flop
Seat 2: Player#1039 shows [] and won ($0.80) with 
Seat 3: Player#3298 (small blind) folded before the flop
Seat 4: Player#1368 (big blind) folded before the flop
Seat 5: Player#5989 folded before the flop
Seat 6: warioman folded before the flop

PokerStars Hand #77ea2bbf-83e8-43ed-8ba6-47b30b271ec5:  Hold'em No Limit ($0.1/$0.20 USD) - 2021/11/20 12:00:00 ET
Table 'Minneapolis' 6-max Seat #5 is the button
Seat 1: warioman ($19.70 in chips)
Seat 2: Player#4336 ($23.67 in chips)
Seat 3: Player#4089 ($20.00 in chips)
Seat 4: Player#5348 ($7.65 in chips)
Seat 5: Player#6160 ($38.04 in chips)
Seat 6: Player#3125 ($20.10 in chips)
Player#3125: posts small blind $0.10
warioman: posts big blind $0.20
*** HOLE CARDS ***
Dealt to warioman [Qc Th]
Player#4336: folds
Player#4089: folds
Player#5348: calls $0.20
Player#6160: folds
Player#3125: folds
warioman: checks
*** FLOP *** [2h Ah 9h]
warioman: checks
Player#5348: bets $0.20
warioman: calls $0.20
*** TURN *** [2h Ah 9h] [2s]
warioman: checks
Player#5348: bets $0.20
warioman: folds
Player#5348: doesn't show hand
Uncalled bet ($0.20) returned to Player#5348
Player#5348 collected $0.85 from pot
*** SUMMARY ***
Total Pot $0.90 | Rake $0.04
Board [2h Ah 9h 2s]
Seat 1: warioman (big blind) folded on the turn
Seat 2: Player#4336 folded before the flop
Seat 3: Player#4089 folded before the flop
Seat 4: Player#5348 shows [] and won ($0.85) with 
Seat 5: Player#6160 (button) folded before the flop
Seat 6: Player#3125 (small blind) folded before the flop

PokerStars Hand #7b0f083a-30fe-4b9b-93ce-962b38167a94:  Hold'em No Limit ($0.1/$0.20 USD) - 2021/11/20 12:00:00 ET
Table 'Minneapolis' 6-max Seat #4 is the button
Seat 1: warioman ($19.70 in chips)
Seat 2: Player#5370 ($23.67 in chips)
Seat 3: Player#1255 ($20.00 in chips)
Seat 4: Player#4500 ($7.65 in chips)
Seat 5: Player#5681 ($38.14 in chips)
Seat 6: Player#9807 ($20.00 in chips)
Player#5681: posts small blind $0.10
Player#9807: posts big blind $0.20
*** HOLE CARDS ***
Dealt to warioman [7h 8h]
warioman: folds
Player#5370: folds
Player#1255: folds
Player#4500: folds
Player#5681: folds
Player#9807 collected $0.20 from pot
*** SUMMARY ***
Total Pot $0.20 | Rake $0.00
Seat 1: warioman folded before the flop
Seat 2: Player#5370 folded before the flop
Seat 3: Player#1255 folded before the flop
Seat 4: Player#4500 (button) folded before the flop
Seat 5: Player#5681 (small blind) folded before the flop
Seat 6: Player#9807 shows [] and won ($0.20) with 

PokerStars Hand #207fe9a4-a0ee-432d-bf40-3533364401e3:  Hold'em No Limit ($0.1/$0.20 USD) - 2021/11/20 12:00:00 ET
Table 'Odessa' 6-max Seat #4 is the button
Seat 1: warioman ($20.42 in chips)
Seat 2: Player#5156 ($49.53 in chips)
Seat 3: Player#3067 ($21.20 in chips)
Seat 4: Player#7665 ($10.92 in chips)
Seat 5: Player#3539 ($22.25 in chips)
Seat 6: Player#8516 ($9.30 in chips)
Player#3539: posts small blind $0.10
Player#8516: posts big blind $0.20
*** HOLE CARDS ***
Dealt to warioman [Jh Jd]
warioman: raises $0.20 to $0.5
Player#5156: raises $0.50 to $1.8
Player#3067: folds
Player#7665: folds
Player#3539: folds
Player#8516: folds
warioman: calls $1.30
*** FLOP *** [6d 7h 6c]
warioman: checks
Player#5156: bets $1.95
warioman: raises $1.95 to $4.5
Player#5156: calls $2.55
*** TURN *** [6d 7h 6c] [9c]
warioman: checks
Player#5156: checks
*** RIVER *** [6d 7h 6c] [9c] [5c]
warioman: checks
Player#5156: bets $14.30
warioman: folds
Player#5156: doesn't show hand
Uncalled bet ($14.30) returned to Player#5156
Player#5156 collected $12.26 from pot
*** SUMMARY ***
Total Pot $12.90 | Rake $0.65
Board [6d 7h 6c 9c 5c]
Seat 1: warioman folded on the river
Seat 2: Player#5156 shows [] and won ($12.26) with 
Seat 3: Player#3067 folded before the flop
Seat 4: Player#7665 (button) folded before the flop
Seat 5: Player#3539 (small blind) folded before the flop
Seat 6: Player#8516 (big blind) folded before the flop

PokerStars Hand #90f39de6-ffd0-45c6-92bb-06a93a556e20:  Hold'em No Limit ($0.1/$0.20 USD) - 2021/11/20 12:00:00 ET
Table 'Leominster' 6-max Seat #1 is the button
Seat 1: Player#1809 ($19.90 in chips)
Seat 2: Player#9543 ($24.52 in chips)
Seat 3: Player#0016 ($18.87 in chips)
Seat 4: Player#5993 ($20.36 in chips)
Seat 5: Player#8349 ($18.40 in chips)
Seat 6: warioman ($21.70 in chips)
Player#9543: posts small blind $0.10
Player#0016: posts big blind $0.20
*** HOLE CARDS ***
Dealt to warioman [2s Js]
Player#5993: folds
Player#8349: raises $0.20 to $0.6
warioman: folds
Player#1809: folds
Player#9543: raises $0.60 to $2.2
Player#0016: folds
Player#8349: calls $1.60
*** FLOP *** [4s Qc Ks]
Player#9543: bets $2.30
Player#8349: folds
Player#9543: doesn't show hand
Uncalled bet ($2.30) returned to Player#9543
Player#9543 collected $4.37 from pot
*** SUMMARY ***
Total Pot $4.60 | Rake $0.23
Board [4s Qc Ks]
Seat 1: Player#1809 (button) folded before the flop
Seat 2: Player#9543 shows [] and won ($4.37) with 
Seat 3: Player#0016 (big blind) folded before the flop
Seat 4: Player#5993 folded before the flop
Seat 5: Player#8349 folded on the flop
Seat 6: warioman folded before the flop

PokerStars Hand #8e704a25-853e-4308-aa52-e74a7afa97da:  Hold'em No Limit ($0.1/$0.20 USD) - 2021/11/20 12:00:00 ET
Table 'Minneapolis' 6-max Seat #3 is the button
Seat 1: warioman ($19.70 in chips)
Seat 2: Player#8730 ($23.37 in chips)
Seat 3: Player#8110 ($20.00 in chips)
Seat 4: Player#8968 ($7.75 in chips)
Seat 5: Player#2159 ($38.34 in chips)
Player#8968: posts small blind $0.10
Player#2159: posts big blind $0.20
*** HOLE CARDS ***
Dealt to warioman [Qh 7h]
warioman: folds
Player#8730: raises $0.20 to $0.6
Player#8110: folds
Player#8968: folds
Player#2159: folds
Player#8730: doesn't show hand
Uncalled bet ($0.60) returned to Player#8730
Player#8730 collected $0.30 from pot
*** SUMMARY ***
Total Pot $0.30 | Rake $0.00
Seat 1: warioman folded before the flop
Seat 2: Player#8730 shows [] and won ($0.30) with 
Seat 3: Player#8110 (button) folded before the flop
Seat 4: Player#8968 (small blind) folded before the flop
Seat 5: Player#2159 (big blind) folded before the flop

PokerStars Hand #0da0503b-29c7-4e27-8aaf-846cee7678b3:  Hold'em No Limit ($0.1/$0.20 USD) - 2021/11/20 12:00:00 ET
Table 'Leominster' 6-max Seat #6 is the button
Seat 1: Player#9934 ($20.00 in chips)
Seat 2: Player#6066 ($24.72 in chips)
Seat 3: Player#6532 ($18.87 in chips)
Seat 4: Player#2854 ($20.06 in chips)
Seat 5: Player#5835 ($18.40 in chips)
Seat 6: warioman ($21.70 in chips)
Player#9934: posts small blind $0.10
Player#6066: posts big blind $0.20
*** HOLE CARDS ***
Dealt to warioman [2c Kh]
Player#6532: folds
Player#2854: raises $0.20 to $0.4
Player#5835: folds
warioman: folds
Player#9934: folds
Player#6066: folds
Player#2854: doesn't show hand
Uncalled bet ($0.40) returned to Player#2854
Player#2854 collected $0.30 from pot
*** SUMMARY ***
Total Pot $0.30 | Rake $0.00
Seat 1: Player#9934 (small blind) folded before the flop
Seat 2: Player#6066 (big blind) folded before the flop
Seat 3: Player#6532 folded before the flop
Seat 4: Player#2854 shows [] and won ($0.30) with 
Seat 5: Player#5835 folded before the flop
Seat 6: warioman (button) folded before the flop

PokerStars Hand #c4a83104-97ec-4030-8d09-1131fd8b231f:  Hold'em No Limit ($0.1/$0.20 USD) - 2021/11/20 11:59:00 ET
Table 'Odessa' 6-max Seat #3 is the button
Seat 1: warioman ($20.42 in chips)
Seat 2: Player#6744 ($49.53 in chips)
Seat 3: Player#4665 ($21.20 in chips)
Seat 4: Player#3486 ($11.12 in chips)
Seat 5: Player#6957 ($22.07 in chips)
Seat 6: Player#7611 ($9.30 in chips)
Player#3486: posts small blind $0.10
Player#6957: posts big blind $0.20
*** HOLE CARDS ***
Dealt to warioman [8c 7d]
Player#7611: folds
warioman: folds
Player#6744: folds
Player#4665: folds
Player#3486: calls $0.10
Player#6957: checks
*** FLOP *** [8d 3d 5s]
Player#3486: checks
Player#6957: checks
*** TURN *** [8d 3d 5s] [2h]
Player#3486: checks
Player#6957: checks
*** RIVER *** [8d 3d 5s] [2h] [3h]
Player#3486: checks
Player#6957: checks
*** SHOW DOWN *** 
Player#6957 collected $0.38 from pot
*** SUMMARY ***
Total Pot $0.40 | Rake $0.02
Board [8d 3d 5s 2h 3h]
Seat 1: warioman folded before the flop
Seat 2: Player#6744 folded before the flop
Seat 3: Player#4665 (button) folded before the flop
Seat 4: Player#3486 (small blind) mucked
Seat 5: Player#6957 shows [2s Ad] and won ($0.38) with 
Seat 6: Player#7611 folded before the flop

PokerStars Hand #2d6d1210-3db6-4d17-b994-a15e2aa8acc0:  Hold'em No Limit ($0.1/$0.20 USD) - 2021/11/20 11:59:00 ET
Table 'Leominster' 6-max Seat #5 is the button
Seat 1: Player#7329 ($20.00 in chips)
Seat 2: Player#9350 ($25.42 in chips)
Seat 3: Player#3623 ($18.87 in chips)
Seat 4: Player#3457 ($20.06 in chips)
Seat 5: Player#3846 ($19.10 in chips)
Seat 6: warioman ($20.10 in chips)
warioman: posts small blind $0.10
Player#7329: posts big blind $0.20
*** HOLE CARDS ***
Dealt to warioman [Kc Ad]
Player#9350: raises $0.20 to $0.7
Player#3623: folds
Player#3457: folds
Player#3846: calls $0.70
warioman: raises $0.70 to $3.2
Player#7329: folds
Player#9350: folds
Player#3846: folds
warioman: doesn't show hand
Uncalled bet ($3.20) returned to warioman
warioman collected $1.60 from pot
*** SUMMARY ***
Total Pot $1.60 | Rake $0.00
Seat 1: Player#7329 (big blind) folded before the flop
Seat 2: Player#9350 folded before the flop
Seat 3: Player#3623 folded before the flop
Seat 4: Player#3457 folded before the flop
Seat 5: Player#3846 (button) folded before the flop
Seat 6: warioman (small blind)

PokerStars Hand #7b60252d-e884-4728-b571-2d6dec9635c1:  Hold'em No Limit ($0.1/$0.20 USD) - 2021/11/20 11:59:00 ET
Table 'Odessa' 6-max Seat #2 is the button
Seat 1: warioman ($19.57 in chips)
Seat 2: Player#0016 ($49.53 in chips)
Seat 3: Player#9012 ($21.30 in chips)
Seat 4: Player#0564 ($11.95 in chips)
Seat 5: Player#4309 ($22.07 in chips)
Seat 6: Player#2001 ($9.30 in chips)
Player#9012: posts small blind $0.10
Player#0564: posts big blind $0.20
*** HOLE CARDS ***
Dealt to warioman [8s Ts]
Player#4309: folds
Player#2001: folds
warioman: raises $0.20 to $0.5
Player#0016: folds
Player#9012: folds
Player#0564: calls $0.30
*** FLOP *** [Th 4h 6h]
Player#0564: checks
warioman: bets $0.33
Player#0564: calls $0.33
*** TURN *** [Th 4h 6h] [Jd]
Player#0564: checks
warioman: checks
*** RIVER *** [Th 4h 6h] [Jd] [6d]
Player#0564: checks
warioman: checks
*** SHOW DOWN *** 
warioman collected $1.67 from pot
*** SUMMARY ***
Total Pot $1.76 | Rake $0.09
Board [Th 4h 6h Jd 6d]
Seat 1: warioman
Seat 2: Player#0016 (button) folded before the flop
Seat 3: Player#9012 (small blind) folded before the flop
Seat 4: Player#0564 (big blind) mucked
Seat 5: Player#4309 folded before the flop
Seat 6: Player#2001 folded before the flop

PokerStars Hand #f55833b8-0045-492c-ab18-06cf97a37e63:  Hold'em No Limit ($0.1/$0.20 USD) - 2021/11/20 11:59:00 ET
Table 'Leominster' 6-max Seat #6 is the button
Seat 1: Player#1660 ($20.00 in chips)
Seat 2: Player#6699 ($25.42 in chips)
Seat 3: Player#7243 ($18.87 in chips)
Seat 4: Player#5544 ($20.06 in chips)
Seat 5: Player#1519 ($19.20 in chips)
Seat 6: warioman ($20.00 in chips)
Player#1660: posts small blind $0.10
Player#1519: posts big blind $0.20
*** HOLE CARDS ***
Dealt to warioman [9c Td]
Player#1660 Waiting
Player#6699: folds
Player#7243: folds
Player#5544: folds
Player#1519: folds
warioman collected $0.20 from pot
*** SUMMARY ***
Total Pot $0.20 | Rake $0.00
Seat 1: Player#1660 (small blind) mucked
Seat 2: Player#6699 folded before the flop
Seat 3: Player#7243 folded before the flop
Seat 4: Player#5544 folded before the flop
Seat 5: Player#1519 (big blind) folded before the flop
Seat 6: warioman (button)

PokerStars Hand #dd2beeb9-a004-471b-b9c1-4e4b20b212cc:  Hold'em No Limit ($0.1/$0.20 USD) - 2021/11/20 11:59:00 ET
Table 'Minneapolis' 6-max Seat #2 is the button
Seat 1: warioman ($19.70 in chips)
Seat 2: Player#9015 ($23.37 in chips)
Seat 3: Player#4895 ($20.30 in chips)
Seat 4: Player#3932 ($8.35 in chips)
Seat 5: Player#9345 ($34.44 in chips)
Player#4895: posts small blind $0.10
Player#3932: posts big blind $0.20
*** HOLE CARDS ***
Dealt to warioman [2s 6h]
Player#9345: raises $0.20 to $0.6
warioman: folds
Player#9015: folds
Player#4895: calls $0.50
Player#3932: calls $0.40
*** FLOP *** [4d Ts 6c]
Player#4895: checks
Player#3932: checks
Player#9345: bets $1.10
Player#4895: calls $1.10
Player#3932: folds
*** TURN *** [4d Ts 6c] [7s]
Player#4895: checks
Player#9345: bets $2.00
Player#4895: calls $2.00
*** RIVER *** [4d Ts 6c] [7s] [9s]
Player#4895: checks
Player#9345: checks
*** SHOW DOWN *** 
Player#9345 collected $7.60 from pot
*** SUMMARY ***
Total Pot $8.00 | Rake $0.40
Board [4d Ts 6c 7s 9s]
Seat 1: warioman folded before the flop
Seat 2: Player#9015 (button) folded before the flop
Seat 3: Player#4895 (small blind) mucked
Seat 4: Player#3932 (big blind) folded on the flop
Seat 5: Player#9345 shows [Jd Jc] and won ($7.60) with 

PokerStars Hand #4b5974df-88bf-4cd1-9324-efd242ff2f28:  Hold'em No Limit ($0.1/$0.20 USD) - 2021/11/20 11:59:00 ET
Table 'Leominster' 6-max Seat #5 is the button
Seat 1: Player#1769 ($20.00 in chips)
Seat 2: Player#0075 ($25.42 in chips)
Seat 3: Player#5101 ($18.87 in chips)
Seat 4: Player#4706 ($20.16 in chips)
Seat 5: Player#2849 ($19.10 in chips)
Seat 6: warioman ($20.00 in chips)
warioman: posts small blind $0.10
Player#1769: posts big blind $0.20
*** HOLE CARDS ***
Dealt to warioman []
warioman Waiting
Player#1769 Waiting
Player#0075: folds
Player#5101: folds
Player#4706: folds
Player#2849 collected $0.20 from pot
*** SUMMARY ***
Total Pot $0.20 | Rake $0.00
Seat 1: Player#1769 (big blind) mucked
Seat 2: Player#0075 folded before the flop
Seat 3: Player#5101 folded before the flop
Seat 4: Player#4706 folded before the flop
Seat 5: Player#2849 shows [] and won ($0.20) with 
Seat 6: warioman (small blind)

PokerStars Hand #40023444-2aeb-4f39-81fa-7e96b0d1ff54:  Hold'em No Limit ($0.1/$0.20 USD) - 2021/11/20 11:59:00 ET
Table 'Odessa' 6-max Seat #1 is the button
Seat 1: warioman ($19.27 in chips)
Seat 2: Player#3896 ($49.63 in chips)
Seat 3: Player#5373 ($21.50 in chips)
Seat 4: Player#1688 ($11.95 in chips)
Seat 5: Player#2593 ($22.07 in chips)
Seat 6: Player#6726 ($9.30 in chips)
Player#3896: posts small blind $0.10
Player#5373: posts big blind $0.20
*** HOLE CARDS ***
Dealt to warioman [Kc Td]
Player#1688: folds
Player#2593: folds
Player#6726: folds
warioman: raises $0.20 to $0.5
Player#3896: folds
Player#5373: folds
warioman: doesn't show hand
Uncalled bet ($0.50) returned to warioman
warioman collected $0.30 from pot
*** SUMMARY ***
Total Pot $0.30 | Rake $0.00
Seat 1: warioman (button)
Seat 2: Player#3896 (small blind) folded before the flop
Seat 3: Player#5373 (big blind) folded before the flop
Seat 4: Player#1688 folded before the flop
Seat 5: Player#2593 folded before the flop
Seat 6: Player#6726 folded before the flop

PokerStars Hand #a7e6a295-fee8-4912-8c12-ec920bf99ea4:  Hold'em No Limit ($0.1/$0.20 USD) - 2021/11/20 11:58:00 ET
Table 'Minneapolis' 6-max Seat #1 is the button
Seat 1: warioman ($19.70 in chips)
Seat 2: Player#9416 ($23.17 in chips)
Seat 3: Player#2908 ($20.50 in chips)
Seat 4: Player#6336 ($8.35 in chips)
Seat 5: Player#4069 ($34.44 in chips)
Player#9416: posts small blind $0.10
Player#2908: posts big blind $0.20
*** HOLE CARDS ***
Dealt to warioman [5c 4d]
Player#6336: folds
Player#4069: folds
warioman: folds
Player#9416: raises $0.20 to $0.6
Player#2908: folds
Player#9416: doesn't show hand
Uncalled bet ($0.60) returned to Player#9416
Player#9416 collected $0.20 from pot
*** SUMMARY ***
Total Pot $0.20 | Rake $0.00
Seat 1: warioman (button) folded before the flop
Seat 2: Player#9416 shows [] and won ($0.20) with 
Seat 3: Player#2908 (big blind) folded before the flop
Seat 4: Player#6336 folded before the flop
Seat 5: Player#4069 folded before the flop

PokerStars Hand #92635406-5c9c-4635-bede-77fa9f21863e:  Hold'em No Limit ($0.1/$0.20 USD) - 2021/11/20 11:58:00 ET
Table 'Leominster' 6-max Seat #5 is the button
Seat 1: Player#1070 ($20.00 in chips)
Seat 2: Player#2382 ($25.42 in chips)
Seat 3: Player#1626 ($19.47 in chips)
Seat 4: Player#4579 ($19.56 in chips)
Seat 5: Player#9889 ($19.10 in chips)
Seat 6: warioman ($20.00 in chips)
warioman: posts small blind $0.10
Player#1070: posts big blind $0.20
*** HOLE CARDS ***
Dealt to warioman []
warioman Waiting
Player#1070 Waiting
Player#9889: folds
Player#2382: folds
Player#1626: raises $0.20 to $0.6
Player#4579: raises0.60 to $1
Player#1626: folds
Player#4579: doesn't show hand
Uncalled bet ($1.00) returned to Player#4579
Player#4579 collected $0.60 from pot
*** SUMMARY ***
Total Pot $0.60 | Rake $0.00
Seat 1: Player#1070 (big blind) mucked
Seat 2: Player#2382 folded before the flop
Seat 3: Player#1626 folded before the flop
Seat 4: Player#4579 shows [] and won ($0.60) with 
Seat 5: Player#9889 (button) folded before the flop
Seat 6: warioman (small blind)

PokerStars Hand #cfa95bf5-76e0-437d-95b1-d59834e4e2b4:  Hold'em No Limit ($0.1/$0.20 USD) - 2021/11/20 11:58:00 ET
Table 'Minneapolis' 6-max Seat #6 is the button
Seat 1: warioman ($19.80 in chips)
Seat 2: Player#4598 ($23.07 in chips)
Seat 3: Player#6628 ($20.50 in chips)
Seat 4: Player#3442 ($8.35 in chips)
Seat 5: Player#6041 ($34.44 in chips)
warioman: posts small blind $0.10
Player#4598: posts big blind $0.20
*** HOLE CARDS ***
Dealt to warioman [2h 6s]
Player#6628: folds
Player#3442: folds
Player#6041: folds
warioman: folds
Player#4598 collected $0.20 from pot
*** SUMMARY ***
Total Pot $0.20 | Rake $0.00
Seat 1: warioman (small blind) folded before the flop
Seat 2: Player#4598 shows [] and won ($0.20) with 
Seat 3: Player#6628 folded before the flop
Seat 4: Player#3442 folded before the flop
Seat 5: Player#6041 folded before the flop

PokerStars Hand #990049b7-8528-49c8-b4aa-4057325c27a0:  Hold'em No Limit ($0.1/$0.20 USD) - 2021/11/20 11:58:00 ET
Table 'Odessa' 6-max Seat #6 is the button
Seat 1: warioman ($19.80 in chips)
Seat 2: Player#1160 ($49.83 in chips)
Seat 3: Player#0990 ($21.50 in chips)
Seat 4: Player#3012 ($12.47 in chips)
Seat 5: Player#5141 ($22.07 in chips)
Seat 6: Player#5555 ($9.30 in chips)
warioman: posts small blind $0.10
Player#1160: posts big blind $0.20
*** HOLE CARDS ***
Dealt to warioman [As Qd]
Player#0990: folds
Player#3012: raises $0.20 to $0.6
Player#5141: folds
Player#5555: folds
warioman: calls $0.50
Player#1160: folds
*** FLOP *** [Ah 9d Td]
warioman: checks
Player#3012: bets $0.70
warioman: calls $0.70
*** TURN *** [Ah 9d Td] [2s]
warioman: checks
Player#3012: bets $1.90
warioman: calls $1.90
*** RIVER *** [Ah 9d Td] [2s] [Qs]
warioman: checks
Player#3012: bets $3.30
warioman: raises $3.30 to $16.6
Player#3012: calls $5.97
*** SHOW DOWN *** 
warioman: doesn't show hand
Player#1160: doesn't show hand
Player#0990: doesn't show hand
Player#3012: doesn't show hand
Player#5141: doesn't show hand
Player#5555: doesn't show hand
 *** SUMMARY ***
Total Pot $32.47 | Rake $1.50
Board [Ah 9d Td 2s Qs]
Seat 1: warioman (small blind)
Seat 2: Player#1160 (big blind) folded before the flop
Seat 3: Player#0990 folded before the flop
Seat 4: Player#3012 mucked
Seat 5: Player#5141 folded before the flop
Seat 6: Player#5555 (button) folded before the flop

PokerStars Hand #adc00291-7d96-4d7c-8137-0d5ac8ba1d68:  Hold'em No Limit ($0.1/$0.20 USD) - 2021/11/20 11:58:00 ET
Table 'Minneapolis' 6-max Seat #5 is the button
Seat 1: warioman ($20.00 in chips)
Seat 2: Player#3250 ($22.77 in chips)
Seat 3: Player#2150 ($20.50 in chips)
Seat 4: Player#7309 ($8.35 in chips)
Seat 5: Player#9558 ($34.44 in chips)
Seat 6: Player#5448 ($31.31 in chips)
Player#5448: posts small blind $0.10
warioman: posts big blind $0.20
*** HOLE CARDS ***
Dealt to warioman [8c Kh]
Player#3250: raises $0.20 to $0.6
Player#2150: folds
Player#7309: folds
Player#9558: folds
Player#5448: folds
warioman: folds
Player#3250: doesn't show hand
Uncalled bet ($0.60) returned to Player#3250
Player#3250 collected $0.30 from pot
*** SUMMARY ***
Total Pot $0.30 | Rake $0.00
Seat 1: warioman (big blind) folded before the flop
Seat 2: Player#3250 shows [] and won ($0.30) with 
Seat 3: Player#2150 folded before the flop
Seat 4: Player#7309 folded before the flop
Seat 5: Player#9558 (button) folded before the flop
Seat 6: Player#5448 (small blind) folded before the flop

PokerStars Hand #5dfd1a59-41f8-48d7-a9e4-6fbfa7722c5c:  Hold'em No Limit ($0.1/$0.20 USD) - 2021/11/20 11:57:00 ET
Table 'Minneapolis' 6-max Seat #6 is the button
Seat 1: warioman ($20.00 in chips)
Seat 2: Player#6406 ($22.77 in chips)
Seat 3: Player#0003 ($20.50 in chips)
Seat 4: Player#4015 ($8.35 in chips)
Seat 5: Player#7708 ($34.54 in chips)
Seat 6: Player#3939 ($31.21 in chips)
warioman: posts small blind $0.10
Player#7708: posts big blind $0.20
*** HOLE CARDS ***
Dealt to warioman []
warioman Waiting
Player#6406: folds
Player#0003: folds
Player#4015: folds
Player#7708: folds
Player#3939 collected $0.20 from pot
*** SUMMARY ***
Total Pot $0.20 | Rake $0.00
Seat 1: warioman (small blind)
Seat 2: Player#6406 folded before the flop
Seat 3: Player#0003 folded before the flop
Seat 4: Player#4015 folded before the flop
Seat 5: Player#7708 (big blind) folded before the flop
Seat 6: Player#3939 shows [] and won ($0.20) with 

PokerStars Hand #16b50da2-cf26-4525-9ab3-cae5c438321f:  Hold'em No Limit ($0.1/$0.20 USD) - 2021/11/20 11:57:00 ET
Table 'Odessa' 6-max Seat #5 is the button
Seat 1: warioman ($20.00 in chips)
Seat 2: Player#1111 ($49.83 in chips)
Seat 3: Player#0594 ($23.10 in chips)
Seat 4: Player#1031 ($12.47 in chips)
Seat 5: Player#0048 ($20.34 in chips)
Seat 6: Player#6201 ($9.40 in chips)
Player#6201: posts small blind $0.10
warioman: posts big blind $0.20
*** HOLE CARDS ***
Dealt to warioman [7h 9d]
Player#1111: folds
Player#0594: raises $0.20 to $0.6
Player#1031: folds
Player#0048: calls $0.60
Player#6201: folds
warioman: folds
*** FLOP *** [2s 6h Jh]
Player#0594: bets $1.00
Player#0048: calls $1.00
*** TURN *** [2s 6h Jh] [Js]
Player#0594: checks
Player#0048: checks
*** RIVER *** [2s 6h Jh] [Js] [8s]
Player#0594: checks
Player#0048: bets $2.15
Player#0594: folds
Player#0048: doesn't show hand
Uncalled bet ($2.15) returned to Player#0048
Player#0048 collected $3.33 from pot
*** SUMMARY ***
Total Pot $3.50 | Rake $0.18
Board [2s 6h Jh Js 8s]
Seat 1: warioman (big blind) folded before the flop
Seat 2: Player#1111 folded before the flop
Seat 3: Player#0594 folded on the river
Seat 4: Player#1031 folded before the flop
Seat 5: Player#0048 shows [] and won ($3.33) with 
Seat 6: Player#6201 (small blind) folded before the flop

PokerStars Hand #f5d89f3e-9d94-4ba3-857c-3b805b0c5724:  Hold'em No Limit ($0.1/$0.20 USD) - 2021/11/20 11:56:00 ET
Table 'Odessa' 6-max Seat #6 is the button
Seat 1: warioman ($20.00 in chips)
Seat 2: Player#4370 ($49.83 in chips)
Seat 3: Player#5465 ($23.10 in chips)
Seat 4: Player#2196 ($12.47 in chips)
Seat 5: Player#7481 ($19.80 in chips)
Seat 6: Player#1567 ($10.00 in chips)
warioman: posts small blind $0.10
Player#7481: posts big blind $0.20
*** HOLE CARDS ***
Dealt to warioman []
warioman Waiting
Player#4370: folds
Player#5465: folds
Player#2196: folds
Player#7481: raises $0.20 to $0.6
Player#1567: calls $0.40
*** FLOP *** [Ac 8d 8c]
Player#7481: bets $0.60
Player#1567: folds
Player#7481: doesn't show hand
Uncalled bet ($0.60) returned to Player#7481
Player#7481 collected $1.14 from pot
*** SUMMARY ***
Total Pot $1.20 | Rake $0.06
Board [Ac 8d 8c]
Seat 1: warioman (small blind)
Seat 2: Player#4370 folded before the flop
Seat 3: Player#5465 folded before the flop
Seat 4: Player#2196 folded before the flop
Seat 5: Player#7481 shows [] and won ($1.14) with 
Seat 6: Player#1567 (button) folded on the flop

PokerStars Hand #8cdf1393-19e4-4d68-8527-b3662fc52779:  Hold'em No Limit ($0.1/$0.20 USD) - 2021/11/20 11:56:00 ET
Table 'Odessa' 6-max Seat #4 is the button
Seat 1: warioman ($20.00 in chips)
Seat 2: Player#8537 ($22.80 in chips)
Seat 3: Player#1777 ($12.57 in chips)
Seat 4: Player#8283 ($20.00 in chips)
Seat 5: Player#5276 ($10.00 in chips)
Player#5276: posts small blind $0.10
warioman: posts big blind $0.20
*** HOLE CARDS ***
Dealt to warioman []
Player#5276 Waiting
warioman Waiting
Player#8537: raises $0.20 to $0.6
Player#1777: folds
Player#8283: folds
Player#8537: doesn't show hand
Uncalled bet ($0.60) returned to Player#8537
Player#8537 collected $0.30 from pot
*** SUMMARY ***
Total Pot $0.30 | Rake $0.00
Seat 1: warioman (big blind)
Seat 2: Player#8537 shows [] and won ($0.30) with 
Seat 3: Player#1777 folded before the flop
Seat 4: Player#8283 (button) folded before the flop
Seat 5: Player#5276 (small blind) mucked

PokerStars Hand #8ca34269-868d-46d4-a5d8-9c482b4468fb:  Hold'em No Limit ($0.05/$0.10 USD) - 2021/11/20 11:41:00 ET
Table 'Aberdeen' 6-max Seat #6 is the button
Seat 1: Player#5875 ($9.13 in chips)
Seat 2: warioman ($30.88 in chips)
Seat 3: Player#5902 ($16.78 in chips)
Seat 4: Player#7591 ($10.38 in chips)
Player#5875: posts small blind $0.05
Player#5902: posts big blind $0.10
*** HOLE CARDS ***
Dealt to warioman []
warioman Decline Entry Bet
Player#7591: raises $0.10 to $0.2
Player#5875: folds
Player#5902: calls $0.10
*** FLOP *** [4d Ad 6d]
Player#5902: checks
Player#7591: checks
*** TURN *** [4d Ad 6d] [2h]
Player#5902: checks
Player#7591: checks
*** RIVER *** [4d Ad 6d] [2h] [8h]
Player#5902: checks
Player#7591: checks
*** SHOW DOWN *** 
Player#7591 collected $0.43 from pot
*** SUMMARY ***
Total Pot $0.45 | Rake $0.02
Board [4d Ad 6d 2h 8h]
Seat 1: Player#5875 (small blind) folded before the flop
Seat 2: warioman
Seat 3: Player#5902 (big blind) mucked
Seat 4: Player#7591 shows [Qs Ks] and won ($0.43) with 

PokerStars Hand #c1fba367-4d5b-4f41-95f4-973b336eb77b:  Hold'em No Limit ($0.1/$0.20 USD) - 2021/11/20 11:40:00 ET
Table 'Bel Air' 6-max Seat #1 is the button
Seat 1: Player#0923 ($30.69 in chips)
Seat 2: Player#0560 ($50.52 in chips)
Seat 3: warioman ($21.91 in chips)
Seat 4: Player#7363 ($21.06 in chips)
Seat 5: Player#3884 ($25.32 in chips)
Seat 6: Player#0440 ($22.29 in chips)
Player#0560: posts small blind $0.10
Player#7363: posts big blind $0.20
*** HOLE CARDS ***
Dealt to warioman []
warioman Decline Entry Bet
Player#3884: folds
Player#0440: folds
Player#0923: folds
Player#0560: raises $0.20 to $0.4
Player#7363: calls $0.20
*** FLOP *** [9h 4s Tc]
Player#0560: bets $0.40
Player#7363: calls $0.40
*** TURN *** [9h 4s Tc] [7s]
Player#0560: checks
Player#7363: bets $1.20
Player#0560: folds
Player#7363: doesn't show hand
Uncalled bet ($1.20) returned to Player#7363
Player#7363 collected $1.52 from pot
*** SUMMARY ***
Total Pot $1.60 | Rake $0.08
Board [9h 4s Tc 7s]
Seat 1: Player#0923 (button) folded before the flop
Seat 2: Player#0560 (small blind) folded on the turn
Seat 3: warioman
Seat 4: Player#7363 shows [] and won ($1.52) with 
Seat 5: Player#3884 folded before the flop
Seat 6: Player#0440 folded before the flop

PokerStars Hand #b7ce327b-2458-4544-bbe0-11b8fc783cb3:  Hold'em No Limit ($0.05/$0.10 USD) - 2021/11/20 11:40:00 ET
Table 'Aberdeen' 6-max Seat #6 is the button
Seat 1: Player#2676 ($7.41 in chips)
Seat 2: Player#1521 ($9.23 in chips)
Seat 3: warioman ($23.83 in chips)
Seat 4: Player#2053 ($17.08 in chips)
Seat 5: Player#5727 ($10.38 in chips)
Player#2676: posts small blind $0.05
Player#1521: posts big blind $0.10
*** HOLE CARDS ***
Dealt to warioman [Qs As]
warioman: raises $0.10 to $0.3
Player#2053: calls $0.30
Player#5727: folds
Player#2676: raises $0.30 to $7.41
Player#1521: folds
warioman: calls $7.11
Player#2053: folds
Player#2676 Showing Pocket Cards A2
warioman Showing Pocket Cards QA
*** FLOP *** [9h Jd Js]
*** TURN *** [9h Jd Js] [7s]
*** RIVER *** [9h Jd Js] [7s] [6s]
warioman collected $14.46 from pot
*** SUMMARY ***
Total Pot $15.22 | Rake $0.76
Board [9h Jd Js 7s 6s]
Seat 1: Player#2676 (small blind) mucked
Seat 2: Player#1521 (big blind) folded before the flop
Seat 3: warioman
Seat 4: Player#2053 folded before the flop
Seat 5: Player#5727 folded before the flop

PokerStars Hand #dc4d962c-4f94-4964-a5ec-3666af839d50:  Hold'em No Limit ($0.1/$0.20 USD) - 2021/11/20 11:39:00 ET
Table 'Bethlehem' 6-max Seat #3 is the button
Seat 1: Player#9936 ($27.94 in chips)
Seat 2: Player#5868 ($39.68 in chips)
Seat 3: Player#7859 ($19.70 in chips)
Seat 4: Player#4571 ($19.50 in chips)
Seat 5: warioman ($25.61 in chips)
Player#4571: posts small blind $0.10
Player#9936: posts big blind $0.20
*** HOLE CARDS ***
Dealt to warioman []
warioman Decline Entry Bet
Player#5868: folds
Player#7859: folds
Player#4571: folds
Player#9936 collected $0.20 from pot
*** SUMMARY ***
Total Pot $0.20 | Rake $0.00
Seat 1: Player#9936 shows [] and won ($0.20) with 
Seat 2: Player#5868 folded before the flop
Seat 3: Player#7859 (button) folded before the flop
Seat 4: Player#4571 (small blind) folded before the flop
Seat 5: warioman

PokerStars Hand #bf8ad349-fae3-4459-93b3-0de7d7d6d803:  Hold'em No Limit ($0.1/$0.20 USD) - 2021/11/20 11:39:00 ET
Table 'Bel Air' 6-max Seat #6 is the button
Seat 1: Player#2471 ($30.79 in chips)
Seat 2: Player#4791 ($51.50 in chips)
Seat 3: warioman ($20.00 in chips)
Seat 4: Player#8441 ($21.06 in chips)
Seat 5: Player#7851 ($26.30 in chips)
Seat 6: Player#8926 ($22.29 in chips)
Player#2471: posts small blind $0.10
Player#4791: posts big blind $0.20
*** HOLE CARDS ***
Dealt to warioman [Kc Jc]
warioman: raises $0.20 to $0.5
Player#8441: folds
Player#7851: calls $0.50
Player#8926: folds
Player#2471: folds
Player#4791: calls $0.30
*** FLOP *** [Qc 6c Kd]
Player#4791: checks
warioman: bets $0.48
Player#7851: calls $0.48
Player#4791: calls $0.48
*** TURN *** [Qc 6c Kd] [5c]
Player#4791: checks
warioman: bets $0.91
Player#7851: folds
Player#4791: folds
warioman: doesn't show hand
Uncalled bet ($0.91) returned to warioman
warioman collected $2.89 from pot
*** SUMMARY ***
Total Pot $3.04 | Rake $0.15
Board [Qc 6c Kd 5c]
Seat 1: Player#2471 (small blind) folded before the flop
Seat 2: Player#4791 (big blind) folded on the turn
Seat 3: warioman
Seat 4: Player#8441 folded before the flop
Seat 5: Player#7851 folded on the turn
Seat 6: Player#8926 (button) folded before the flop

PokerStars Hand #8db7085a-f821-4af3-8661-fa36f2258dcb:  Hold'em No Limit ($0.05/$0.10 USD) - 2021/11/20 11:39:00 ET
Table 'Aberdeen' 6-max Seat #4 is the button
Seat 1: Player#9226 ($7.71 in chips)
Seat 2: Player#4279 ($9.23 in chips)
Seat 3: warioman ($23.83 in chips)
Seat 4: Player#5507 ($17.08 in chips)
Seat 5: Player#5277 ($10.11 in chips)
Player#5277: posts small blind $0.05
Player#9226: posts big blind $0.10
*** HOLE CARDS ***
Dealt to warioman [9c 2c]
Player#4279: folds
warioman: folds
Player#5507: folds
Player#5277: calls $0.05
Player#9226: raises $0.10 to $0.3
Player#5277: calls $0.20
*** FLOP *** [Qs 9d 5c]
Player#5277: bets $0.60
Player#9226: folds
Player#5277: doesn't show hand
Uncalled bet ($0.60) returned to Player#5277
Player#5277 collected $0.57 from pot
*** SUMMARY ***
Total Pot $0.60 | Rake $0.03
Board [Qs 9d 5c]
Seat 1: Player#9226 (big blind) folded on the flop
Seat 2: Player#4279 folded before the flop
Seat 3: warioman folded before the flop
Seat 4: Player#5507 (button) folded before the flop
Seat 5: Player#5277 shows [] and won ($0.57) with 

PokerStars Hand #3adfc6cc-4cc9-4ede-8c99-31254d7830f0:  Hold'em No Limit ($0.1/$0.20 USD) - 2021/11/20 11:39:00 ET
Table 'Bethlehem' 6-max Seat #2 is the button
Seat 1: Player#6209 ($28.64 in chips)
Seat 2: Player#2590 ($38.76 in chips)
Seat 3: Player#9677 ($19.80 in chips)
Seat 4: Player#0658 ($19.70 in chips)
Seat 5: warioman ($25.61 in chips)
Player#9677: posts small blind $0.10
Player#0658: posts big blind $0.20
*** HOLE CARDS ***
Dealt to warioman [Jh 4s]
warioman: folds
Player#6209: raises $0.20 to $0.7
Player#2590: calls $0.70
Player#9677: folds
Player#0658: folds
*** FLOP *** [Qs 2h 5c]
Player#6209: checks
Player#2590: bets $1.27
Player#6209: folds
Player#2590: doesn't show hand
Uncalled bet ($1.27) returned to Player#2590
Player#2590 collected $1.61 from pot
*** SUMMARY ***
Total Pot $1.70 | Rake $0.08
Board [Qs 2h 5c]
Seat 1: Player#6209 folded on the flop
Seat 2: Player#2590 shows [] and won ($1.61) with 
Seat 3: Player#9677 (small blind) folded before the flop
Seat 4: Player#0658 (big blind) folded before the flop
Seat 5: warioman folded before the flop

PokerStars Hand #99be3095-011a-4344-b709-ffccc497a41f:  Hold'em No Limit ($0.1/$0.20 USD) - 2021/11/20 11:39:00 ET
Table 'Bel Air' 6-max Seat #5 is the button
Seat 1: Player#0980 ($30.99 in chips)
Seat 2: Player#4275 ($50.40 in chips)
Seat 3: warioman ($19.21 in chips)
Seat 4: Player#5402 ($21.06 in chips)
Seat 5: Player#3316 ($26.30 in chips)
Seat 6: Player#5582 ($22.39 in chips)
Player#5582: posts small blind $0.10
Player#0980: posts big blind $0.20
*** HOLE CARDS ***
Dealt to warioman [Qh Ac]
Player#4275: calls $0.20
warioman: raises $0.20 to $0.9
Player#5402: folds
Player#3316: folds
Player#5582: folds
Player#0980: folds
Player#4275: calls $0.70
*** FLOP *** [5h 2d 9d]
Player#4275: checks
warioman: checks
*** TURN *** [5h 2d 9d] [3s]
Player#4275: bets $1.05
warioman: folds
Player#4275: doesn't show hand
Uncalled bet ($1.05) returned to Player#4275
Player#4275 collected $2.00 from pot
*** SUMMARY ***
Total Pot $2.10 | Rake $0.11
Board [5h 2d 9d 3s]
Seat 1: Player#0980 (big blind) folded before the flop
Seat 2: Player#4275 shows [] and won ($2.00) with 
Seat 3: warioman folded on the turn
Seat 4: Player#5402 folded before the flop
Seat 5: Player#3316 (button) folded before the flop
Seat 6: Player#5582 (small blind) folded before the flop

PokerStars Hand #ff1eeceb-f8fa-4654-acf3-6d86928a7122:  Hold'em No Limit ($0.05/$0.10 USD) - 2021/11/20 11:38:00 ET
Table 'Aberdeen' 6-max Seat #4 is the button
Seat 1: Player#9535 ($7.71 in chips)
Seat 2: Player#2233 ($9.23 in chips)
Seat 3: warioman ($24.88 in chips)
Seat 4: Player#7573 ($3.09 in chips)
Seat 5: Player#2205 ($13.20 in chips)
Seat 6: Player#8546 ($10.21 in chips)
Player#2205: posts small blind $0.05
Player#8546: posts big blind $0.10
*** HOLE CARDS ***
Dealt to warioman [Ad 2d]
Player#9535: folds
Player#2233: folds
warioman: raises $0.10 to $0.3
Player#7573: calls $0.30
Player#2205: calls $0.25
Player#8546: folds
*** FLOP *** [Qd Ts 6d]
Player#2205: checks
warioman: bets $0.75
Player#7573: calls $0.75
Player#2205: calls $0.75
*** TURN *** [Qd Ts 6d] [3c]
Player#2205: checks
warioman: checks
Player#7573: bets $1.63
Player#2205: raises $1.63 to $3.26
warioman: folds
Player#7573: calls $0.41
Player#2205 Showing Pocket Cards KQ
Player#7573 Showing Pocket Cards 9Q
*** RIVER *** [Qd Ts 6d] [3c] [3c]
Player#2205 collected $8.12 from pot
*** SUMMARY ***
Total Pot $8.55 | Rake $0.43
Board [Qd Ts 6d 3c 3c]
Seat 1: Player#9535 folded before the flop
Seat 2: Player#2233 folded before the flop
Seat 3: warioman folded on the turn
Seat 4: Player#7573 (button) mucked
Seat 5: Player#2205 shows [Kh Qh] and won ($8.12) with 
Seat 6: Player#8546 (big blind) folded before the flop

PokerStars Hand #6fc5335c-4f8d-4443-a598-ef834bb914c4:  Hold'em No Limit ($0.1/$0.20 USD) - 2021/11/20 11:38:00 ET
Table 'Bel Air' 6-max Seat #4 is the button
Seat 1: Player#0113 ($30.99 in chips)
Seat 2: Player#5713 ($50.40 in chips)
Seat 3: warioman ($19.21 in chips)
Seat 4: Player#8246 ($19.70 in chips)
Seat 5: Player#3879 ($26.40 in chips)
Seat 6: Player#9855 ($23.79 in chips)
Player#3879: posts small blind $0.10
Player#9855: posts big blind $0.20
*** HOLE CARDS ***
Dealt to warioman [3c Qs]
Player#0113: folds
Player#5713: folds
warioman: folds
Player#8246: raises $0.20 to $0.6
Player#3879: folds
Player#9855: calls $0.40
*** FLOP *** [5c Qc 8s]
Player#9855: checks
Player#8246: bets $0.80
Player#9855: calls $0.80
*** TURN *** [5c Qc 8s] [Ad]
Player#9855: checks
Player#8246: bets $2.20
Player#9855: folds
Player#8246: doesn't show hand
Uncalled bet ($2.20) returned to Player#8246
Player#8246 collected $2.76 from pot
*** SUMMARY ***
Total Pot $2.90 | Rake $0.15
Board [5c Qc 8s Ad]
Seat 1: Player#0113 folded before the flop
Seat 2: Player#5713 folded before the flop
Seat 3: warioman folded before the flop
Seat 4: Player#8246 shows [] and won ($2.76) with 
Seat 5: Player#3879 (small blind) folded before the flop
Seat 6: Player#9855 (big blind) folded on the turn

PokerStars Hand #f82bfda3-3910-486b-b68e-086956a3407c:  Hold'em No Limit ($0.1/$0.20 USD) - 2021/11/20 11:38:00 ET
Table 'Bethlehem' 6-max Seat #1 is the button
Seat 1: Player#3139 ($27.91 in chips)
Seat 2: Player#7250 ($39.36 in chips)
Seat 3: Player#1155 ($20.00 in chips)
Seat 4: Player#2631 ($19.70 in chips)
Seat 5: warioman ($25.61 in chips)
Player#7250: posts small blind $0.10
Player#1155: posts big blind $0.20
*** HOLE CARDS ***
Dealt to warioman [6c Qs]
Player#3139 BB + Dead Small 0.3
Player#2631: folds
warioman: folds
Player#3139: checks
Player#7250: calls $0.10
Player#1155: checks
*** FLOP *** [4h Ts 4d]
Player#7250: checks
Player#1155: checks
Player#3139: checks
*** TURN *** [4h Ts 4d] [Kh]
Player#7250: checks
Player#1155: checks
Player#3139: checks
*** RIVER *** [4h Ts 4d] [Kh] [8h]
Player#7250: bets $0.40
Player#1155: folds
Player#3139: calls $0.40
*** SHOW DOWN *** 
Player#3139 collected $1.14 from pot
*** SUMMARY ***
Total Pot $1.20 | Rake $0.06
Board [4h Ts 4d Kh 8h]
Seat 1: Player#3139 shows [Kc 2s] and won ($1.14) with 
Seat 2: Player#7250 (small blind) mucked
Seat 3: Player#1155 (big blind) folded on the river
Seat 4: Player#2631 folded before the flop
Seat 5: warioman folded before the flop

PokerStars Hand #5e072355-f499-408a-9da4-58fb91467f05:  Hold'em No Limit ($0.1/$0.20 USD) - 2021/11/20 11:38:00 ET
Table 'Bel Air' 6-max Seat #3 is the button
Seat 1: Player#5831 ($30.99 in chips)
Seat 2: Player#8504 ($50.90 in chips)
Seat 3: warioman ($19.21 in chips)
Seat 4: Player#8663 ($19.80 in chips)
Seat 5: Player#2633 ($25.85 in chips)
Seat 6: Player#5738 ($23.79 in chips)
Player#8663: posts small blind $0.10
Player#2633: posts big blind $0.20
*** HOLE CARDS ***
Dealt to warioman [3c 9s]
Player#8504 BB + Dead Small 0.3
Player#5738: folds
Player#5831: folds
Player#8504: checks
warioman: folds
Player#8663: folds
Player#2633: checks
*** FLOP *** [9h 6h Jc]
Player#2633: checks
Player#8504: checks
*** TURN *** [9h 6h Jc] [Kc]
Player#2633: bets $0.20
Player#8504: calls $0.20
*** RIVER *** [9h 6h Jc] [Kc] [9c]
Player#2633: bets $0.20
Player#8504: folds
Player#2633: doesn't show hand
Uncalled bet ($0.20) returned to Player#2633
Player#2633 collected $0.66 from pot
*** SUMMARY ***
Total Pot $0.70 | Rake $0.03
Board [9h 6h Jc Kc 9c]
Seat 1: Player#5831 folded before the flop
Seat 2: Player#8504 folded on the river
Seat 3: warioman (button) folded before the flop
Seat 4: Player#8663 (small blind) folded before the flop
Seat 5: Player#2633 shows [] and won ($0.66) with 
Seat 6: Player#5738 folded before the flop

PokerStars Hand #2939135d-9de8-4ba0-b637-cfe2f9b3e222:  Hold'em No Limit ($0.1/$0.20 USD) - 2021/11/20 11:38:00 ET
Table 'Bethlehem' 6-max Seat #1 is the button
Seat 1: Player#7336 ($27.91 in chips)
Seat 2: Player#2757 ($39.36 in chips)
Seat 3: Player#8882 ($20.00 in chips)
Seat 4: Player#8605 ($19.70 in chips)
Seat 5: warioman ($25.61 in chips)
Player#2757: posts small blind $0.10
Player#8882: posts big blind $0.20
*** HOLE CARDS ***
Dealt to warioman [6h Js]
Player#8882: folds
Player#8605: folds
warioman: folds
 *** SUMMARY ***
Total Pot $0.10 | Rake $0.00
Seat 1: Player#7336 (button) mucked
Seat 2: Player#2757 (small blind) mucked
Seat 3: Player#8882 (big blind) folded before the flop
Seat 4: Player#8605 folded before the flop
Seat 5: warioman folded before the flop

PokerStars Hand #0d1b7e53-13c2-4f38-a006-9eb0cc6b8513:  Hold'em No Limit ($0.05/$0.10 USD) - 2021/11/20 11:37:00 ET
Table 'Aberdeen' 6-max Seat #3 is the button
Seat 1: Player#4690 ($10.96 in chips)
Seat 2: Player#2224 ($9.23 in chips)
Seat 3: warioman ($24.88 in chips)
Seat 4: Player#7628 ($3.19 in chips)
Seat 5: Player#8601 ($10.18 in chips)
Seat 6: Player#1537 ($10.21 in chips)
Player#7628: posts small blind $0.05
Player#8601: posts big blind $0.10
*** HOLE CARDS ***
Dealt to warioman [7h Th]
Player#1537: folds
Player#4690: calls $0.10
Player#2224: folds
warioman: folds
Player#7628: calls $0.05
Player#8601: checks
*** FLOP *** [4c 3d 8d]
Player#7628: checks
Player#8601: checks
Player#4690: bets $0.20
Player#7628: folds
Player#8601: raises $0.20 to $0.8
Player#4690: calls $0.60
*** TURN *** [4c 3d 8d] [Ad]
Player#8601: bets $0.75
Player#4690: calls $0.75
*** RIVER *** [4c 3d 8d] [Ad] [Jd]
Player#8601: bets $1.60
Player#4690: calls $1.60
*** SHOW DOWN *** 
Player#4690: doesn't show hand
Player#8601 collected $6.27 from pot
*** SUMMARY ***
Total Pot $6.60 | Rake $0.33
Board [4c 3d 8d Ad Jd]
Seat 1: Player#4690 mucked
Seat 2: Player#2224 folded before the flop
Seat 3: warioman (button) folded before the flop
Seat 4: Player#7628 (small blind) folded on the flop
Seat 5: Player#8601 shows [8s 4s] and won ($6.27) with 
Seat 6: Player#1537 folded before the flop

PokerStars Hand #3b020fef-debe-4b18-80d3-f4b425152a66:  Hold'em No Limit ($0.05/$0.10 USD) - 2021/11/20 11:36:00 ET
Table 'Aberdeen' 6-max Seat #2 is the button
Seat 1: Player#8444 ($10.81 in chips)
Seat 2: Player#0339 ($9.23 in chips)
Seat 3: warioman ($24.93 in chips)
Seat 4: Player#3740 ($3.29 in chips)
Seat 5: Player#8007 ($10.18 in chips)
Seat 6: Player#9844 ($10.21 in chips)
warioman: posts small blind $0.05
Player#3740: posts big blind $0.10
*** HOLE CARDS ***
Dealt to warioman [5c 7c]
Player#8007: folds
Player#9844: folds
Player#8444: raises $ 10.10 to $10.81
Player#0339: folds
warioman: folds
Player#3740: folds
Player#8444: doesn't show hand
Uncalled bet ($10.81) returned to Player#8444
Player#8444 collected $0.15 from pot
*** SUMMARY ***
Total Pot $0.15 | Rake $0.00
Seat 1: Player#8444 shows [] and won ($0.15) with 
Seat 2: Player#0339 (button) folded before the flop
Seat 3: warioman (small blind) folded before the flop
Seat 4: Player#3740 (big blind) folded before the flop
Seat 5: Player#8007 folded before the flop
Seat 6: Player#9844 folded before the flop

PokerStars Hand #43b2e441-9a16-4d9b-b4a3-67d7c904c763:  Hold'em No Limit ($0.1/$0.20 USD) - 2021/11/20 11:36:00 ET
Table 'Bel Air' 6-max Seat #1 is the button
Seat 1: Player#2228 ($30.99 in chips)
Seat 2: warioman ($19.41 in chips)
Seat 3: Player#0801 ($20.00 in chips)
Seat 4: Player#5973 ($25.85 in chips)
Seat 5: Player#0298 ($23.42 in chips)
warioman: posts small blind $0.10
Player#0801: posts big blind $0.20
*** HOLE CARDS ***
Dealt to warioman [As 6s]
Player#0298 BB + Dead Small 0.3
Player#5973: folds
Player#0298: checks
Player#2228: folds
warioman: calls $0.10
Player#0801: checks
*** FLOP *** [9h 4h 7s]
warioman: checks
Player#0801: checks
Player#0298: checks
*** TURN *** [9h 4h 7s] [6h]
warioman: checks
Player#0801: checks
Player#0298: checks
*** RIVER *** [9h 4h 7s] [6h] [Th]
warioman: checks
Player#0801: checks
Player#0298: bets $0.70
warioman: folds
Player#0801: folds
Player#0298: doesn't show hand
Uncalled bet ($0.70) returned to Player#0298
Player#0298 collected $0.38 from pot
*** SUMMARY ***
Total Pot $0.40 | Rake $0.02
Board [9h 4h 7s 6h Th]
Seat 1: Player#2228 (button) folded before the flop
Seat 2: warioman (small blind) folded on the river
Seat 3: Player#0801 (big blind) folded on the river
Seat 4: Player#5973 folded before the flop
Seat 5: Player#0298 shows [] and won ($0.38) with 

PokerStars Hand #99b02518-30dc-469c-b01d-8588315f0f43:  Hold'em No Limit ($0.1/$0.20 USD) - 2021/11/20 11:36:00 ET
Table 'Bethlehem' 6-max Seat #4 is the button
Seat 1: Player#3284 ($22.04 in chips)
Seat 2: Player#8638 ($20.53 in chips)
Seat 3: Player#2839 ($31.85 in chips)
Seat 4: Player#3113 ($19.70 in chips)
Seat 5: warioman ($25.71 in chips)
warioman: posts small blind $0.10
Player#3284: posts big blind $0.20
*** HOLE CARDS ***
Dealt to warioman [Kd 9s]
Player#8638: raises $0.20 to $0.6
Player#2839: raises $0.60 to $2.1
Player#3113: folds
warioman: folds
Player#3284: folds
Player#8638: calls $1.50
*** FLOP *** [Qd Qc 2c]
Player#8638: checks
Player#2839: bets $2.25
Player#8638: raises $2.25 to $6.1
Player#2839: calls $3.85
*** TURN *** [Qd Qc 2c] [4c]
Player#8638: bets $12.33
Player#2839: calls $12.33
Player#8638 Showing Pocket Cards T8
Player#2839 Showing Pocket Cards AQ
*** RIVER *** [Qd Qc 2c] [4c] [Kh]
Player#8638 collected $39.86 from pot
*** SUMMARY ***
Total Pot $41.36 | Rake $1.50
Board [Qd Qc 2c 4c Kh]
Seat 1: Player#3284 (big blind) folded before the flop
Seat 2: Player#8638 shows [Tc 8c] and won ($39.86) with 
Seat 3: Player#2839 mucked
Seat 4: Player#3113 (button) folded before the flop
Seat 5: warioman (small blind) folded before the flop

PokerStars Hand #e285202d-ae31-40ab-a7a3-c486c491ea01:  Hold'em No Limit ($0.1/$0.20 USD) - 2021/11/20 11:36:00 ET
Table 'Bel Air' 6-max Seat #6 is the button
Seat 1: Player#3882 ($31.09 in chips)
Seat 2: warioman ($19.61 in chips)
Seat 3: Player#6935 ($20.00 in chips)
Seat 4: Player#0331 ($25.55 in chips)
Player#3882: posts small blind $0.10
warioman: posts big blind $0.20
*** HOLE CARDS ***
Dealt to warioman [Ad 6s]
Player#6935: folds
Player#0331: raises $0.20 to $0.6
Player#3882: folds
warioman: folds
Player#0331: doesn't show hand
Uncalled bet ($0.60) returned to Player#0331
Player#0331 collected $0.30 from pot
*** SUMMARY ***
Total Pot $0.30 | Rake $0.00
Seat 1: Player#3882 (small blind) folded before the flop
Seat 2: warioman (big blind) folded before the flop
Seat 3: Player#6935 folded before the flop
Seat 4: Player#0331 shows [] and won ($0.30) with 

PokerStars Hand #99a400ca-3cff-4311-be3c-b8fc8dd901c6:  Hold'em No Limit ($0.05/$0.10 USD) - 2021/11/20 11:36:00 ET
Table 'Aberdeen' 6-max Seat #1 is the button
Seat 1: Player#9654 ($5.46 in chips)
Seat 2: Player#3386 ($9.28 in chips)
Seat 3: warioman ($25.03 in chips)
Seat 4: Player#0960 ($8.75 in chips)
Seat 5: Player#3788 ($10.48 in chips)
Seat 6: Player#6005 ($10.21 in chips)
Player#3386: posts small blind $0.05
warioman: posts big blind $0.10
*** HOLE CARDS ***
Dealt to warioman [Ts 4h]
Player#0960: raises $0.10 to $0.3
Player#3788: calls $0.30
Player#6005: folds
Player#9654: raises $0.30 to $5.46
Player#3386: folds
warioman: folds
Player#0960: calls $5.16
Player#3788: folds
Player#0960 Showing Pocket Cards JJ
Player#9654 Showing Pocket Cards AQ
*** FLOP *** [Ah Ad Kh]
*** TURN *** [Ah Ad Kh] [5d]
*** RIVER *** [Ah Ad Kh] [5d] [5h]
Player#9654 collected $10.80 from pot
*** SUMMARY ***
Total Pot $11.37 | Rake $0.57
Board [Ah Ad Kh 5d 5h]
Seat 1: Player#9654 shows [Ah Qh] and won ($10.80) with 
Seat 2: Player#3386 (small blind) folded before the flop
Seat 3: warioman (big blind) folded before the flop
Seat 4: Player#0960 mucked
Seat 5: Player#3788 folded before the flop
Seat 6: Player#6005 folded before the flop

PokerStars Hand #a6c71cf7-297f-4a11-88d0-cd643d1731ad:  Hold'em No Limit ($0.1/$0.20 USD) - 2021/11/20 11:36:00 ET
Table 'Bel Air' 6-max Seat #3 is the button
Seat 1: Player#7999 ($31.29 in chips)
Seat 2: warioman ($19.61 in chips)
Seat 3: Player#8655 ($19.70 in chips)
Seat 4: Player#8031 ($25.65 in chips)
Player#8031: posts small blind $0.10
Player#7999: posts big blind $0.20
*** HOLE CARDS ***
Dealt to warioman [6h 4d]
warioman: folds
Player#8655: raises $0.20 to $0.6
Player#8031: folds
Player#7999: folds
Player#8655: doesn't show hand
Uncalled bet ($0.60) returned to Player#8655
Player#8655 collected $0.30 from pot
*** SUMMARY ***
Total Pot $0.30 | Rake $0.00
Seat 1: Player#7999 (big blind) folded before the flop
Seat 2: warioman folded before the flop
Seat 3: Player#8655 shows [] and won ($0.30) with 
Seat 4: Player#8031 (small blind) folded before the flop

PokerStars Hand #b2d3a6bc-f938-4cc4-83c5-b6527d5d36d3:  Hold'em No Limit ($0.1/$0.20 USD) - 2021/11/20 11:35:00 ET
Table 'Bethlehem' 6-max Seat #4 is the button
Seat 1: Player#0904 ($27.91 in chips)
Seat 2: Player#9892 ($21.76 in chips)
Seat 3: Player#0304 ($20.53 in chips)
Seat 4: Player#4393 ($31.85 in chips)
Seat 5: Player#0434 ($19.80 in chips)
Seat 6: warioman ($25.91 in chips)
Player#0434: posts small blind $0.10
warioman: posts big blind $0.20
*** HOLE CARDS ***
Dealt to warioman [8d 2h]
Player#0904: folds
Player#9892: calls $0.20
Player#0304: folds
Player#4393: folds
Player#0434: folds
warioman: checks
*** FLOP *** [Qs Jc 6s]
warioman: checks
Player#9892: checks
*** TURN *** [Qs Jc 6s] [Ts]
warioman: checks
Player#9892: checks
*** RIVER *** [Qs Jc 6s] [Ts] [8s]
warioman: checks
Player#9892: bets $0.50
warioman: folds
Player#9892: doesn't show hand
Uncalled bet ($0.50) returned to Player#9892
Player#9892 collected $0.47 from pot
*** SUMMARY ***
Total Pot $0.50 | Rake $0.03
Board [Qs Jc 6s Ts 8s]
Seat 1: Player#0904 folded before the flop
Seat 2: Player#9892 shows [] and won ($0.47) with 
Seat 3: Player#0304 folded before the flop
Seat 4: Player#4393 (button) folded before the flop
Seat 5: Player#0434 (small blind) folded before the flop
Seat 6: warioman (big blind) folded on the river

PokerStars Hand #6417f09f-9efc-48a1-87a5-80487ed46049:  Hold'em No Limit ($0.1/$0.20 USD) - 2021/11/20 11:35:00 ET
Table 'Bel Air' 6-max Seat #3 is the button
Seat 1: Player#6896 ($30.99 in chips)
Seat 2: Player#0194 ($50.90 in chips)
Seat 3: warioman ($19.61 in chips)
Seat 4: Player#9531 ($19.80 in chips)
Seat 5: Player#4266 ($25.85 in chips)
Seat 6: Player#7468 ($23.42 in chips)
Player#9531: posts small blind $0.10
Player#4266: posts big blind $0.20
*** HOLE CARDS ***
Dealt to warioman [Qd 8h]
Player#7468: folds
Player#6896: raises $0.20 to $0.6
Player#0194: folds
warioman: folds
Player#9531: folds
Player#4266: folds
Player#6896: doesn't show hand
Uncalled bet ($0.60) returned to Player#6896
Player#6896 collected $0.30 from pot
*** SUMMARY ***
Total Pot $0.30 | Rake $0.00
Seat 1: Player#6896 shows [] and won ($0.30) with 
Seat 2: Player#0194 folded before the flop
Seat 3: warioman (button) folded before the flop
Seat 4: Player#9531 (small blind) folded before the flop
Seat 5: Player#4266 (big blind) folded before the flop
Seat 6: Player#7468 folded before the flop

PokerStars Hand #3d31ee3e-ed54-4b81-aa3d-74009ec0a3cd:  Hold'em No Limit ($0.1/$0.20 USD) - 2021/11/20 11:35:00 ET
Table 'Bel Air' 6-max Seat #2 is the button
Seat 1: Player#7055 ($30.69 in chips)
Seat 2: Player#8219 ($50.90 in chips)
Seat 3: warioman ($19.71 in chips)
Seat 4: Player#5131 ($20.00 in chips)
Seat 5: Player#0001 ($25.85 in chips)
Seat 6: Player#9113 ($23.42 in chips)
warioman: posts small blind $0.10
Player#5131: posts big blind $0.20
*** HOLE CARDS ***
Dealt to warioman [2c 4s]
Player#0001: folds
Player#9113: folds
Player#7055: raises $0.20 to $0.6
Player#8219: folds
warioman: folds
Player#5131: folds
Player#7055: doesn't show hand
Uncalled bet ($0.60) returned to Player#7055
Player#7055 collected $0.30 from pot
*** SUMMARY ***
Total Pot $0.30 | Rake $0.00
Seat 1: Player#7055 shows [] and won ($0.30) with 
Seat 2: Player#8219 (button) folded before the flop
Seat 3: warioman (small blind) folded before the flop
Seat 4: Player#5131 (big blind) folded before the flop
Seat 5: Player#0001 folded before the flop
Seat 6: Player#9113 folded before the flop

PokerStars Hand #d7abbeb0-5e20-4f73-92a8-fa916d40865f:  Hold'em No Limit ($0.05/$0.10 USD) - 2021/11/20 11:35:00 ET
Table 'Aberdeen' 6-max Seat #6 is the button
Seat 1: Player#5424 ($11.26 in chips)
Seat 2: Player#7640 ($9.38 in chips)
Seat 3: warioman ($19.71 in chips)
Seat 4: Player#0899 ($8.75 in chips)
Seat 5: Player#5839 ($10.48 in chips)
Seat 6: Player#9930 ($10.21 in chips)
Player#5424: posts small blind $0.05
Player#7640: posts big blind $0.10
*** HOLE CARDS ***
Dealt to warioman [Ac Qh]
warioman: raises $0.10 to $0.5
Player#0899: folds
Player#5839: folds
Player#9930: folds
Player#5424: calls $0.45
Player#7640: folds
*** FLOP *** [Qc 2s 4d]
Player#5424: bets $0.55
warioman: raises $0.55 to $1.4
Player#5424: calls $0.85
*** TURN *** [Qc 2s 4d] [3s]
Player#5424: checks
warioman: checks
*** RIVER *** [Qc 2s 4d] [3s] [8s]
Player#5424: bets $3.90
warioman: calls $3.90
*** SHOW DOWN *** 
warioman collected $11.11 from pot
*** SUMMARY ***
Total Pot $11.70 | Rake $0.58
Board [Qc 2s 4d 3s 8s]
Seat 1: Player#5424 (small blind) mucked
Seat 2: Player#7640 (big blind) folded before the flop
Seat 3: warioman
Seat 4: Player#0899 folded before the flop
Seat 5: Player#5839 folded before the flop
Seat 6: Player#9930 (button) folded before the flop

PokerStars Hand #73f429b1-afe1-47a2-af55-a9fc751e5f54:  Hold'em No Limit ($0.1/$0.20 USD) - 2021/11/20 11:35:00 ET
Table 'Bel Air' 6-max Seat #1 is the button
Seat 1: Player#5069 ($30.69 in chips)
Seat 2: Player#4372 ($51.00 in chips)
Seat 3: warioman ($19.91 in chips)
Seat 4: Player#4623 ($20.00 in chips)
Seat 5: Player#8091 ($25.55 in chips)
Seat 6: Player#4608 ($23.42 in chips)
Player#4372: posts small blind $0.10
warioman: posts big blind $0.20
*** HOLE CARDS ***
Dealt to warioman [8h 3h]
Player#4623: folds
Player#8091: raises $0.20 to $0.6
Player#4608: folds
Player#5069: folds
Player#4372: folds
warioman: folds
Player#8091: doesn't show hand
Uncalled bet ($0.60) returned to Player#8091
Player#8091 collected $0.30 from pot
*** SUMMARY ***
Total Pot $0.30 | Rake $0.00
Seat 1: Player#5069 (button) folded before the flop
Seat 2: Player#4372 (small blind) folded before the flop
Seat 3: warioman (big blind) folded before the flop
Seat 4: Player#4623 folded before the flop
Seat 5: Player#8091 shows [] and won ($0.30) with 
Seat 6: Player#4608 folded before the flop

PokerStars Hand #fd543163-97bb-41ed-8825-9a4025ded5c3:  Hold'em No Limit ($0.1/$0.20 USD) - 2021/11/20 11:35:00 ET
Table 'Bethlehem' 6-max Seat #3 is the button
Seat 1: Player#0182 ($27.91 in chips)
Seat 2: Player#2277 ($21.46 in chips)
Seat 3: Player#3750 ($20.53 in chips)
Seat 4: Player#9238 ($31.95 in chips)
Seat 5: Player#2113 ($20.00 in chips)
Seat 6: warioman ($25.91 in chips)
Player#9238: posts small blind $0.10
Player#2113: posts big blind $0.20
*** HOLE CARDS ***
Dealt to warioman [6c Td]
Player#2277 BB + Dead Small 0.3
warioman: folds
Player#0182: folds
Player#2277: raises0.20 to $1
Player#3750: folds
Player#9238: folds
Player#2113: folds
Player#2277: doesn't show hand
Uncalled bet ($1.00) returned to Player#2277
Player#2277 collected $0.30 from pot
*** SUMMARY ***
Total Pot $0.30 | Rake $0.00
Seat 1: Player#0182 folded before the flop
Seat 2: Player#2277 shows [] and won ($0.30) with 
Seat 3: Player#3750 (button) folded before the flop
Seat 4: Player#9238 (small blind) folded before the flop
Seat 5: Player#2113 (big blind) folded before the flop
Seat 6: warioman folded before the flop

PokerStars Hand #cf85f1e4-71f9-44eb-ba67-2224dc007198:  Hold'em No Limit ($0.05/$0.10 USD) - 2021/11/20 11:35:00 ET
Table 'Aberdeen' 6-max Seat #5 is the button
Seat 1: Player#8130 ($11.36 in chips)
Seat 2: Player#3234 ($9.38 in chips)
Seat 3: warioman ($19.71 in chips)
Seat 4: Player#9731 ($8.75 in chips)
Seat 5: Player#5629 ($10.33 in chips)
Seat 6: Player#9160 ($10.26 in chips)
Player#9160: posts small blind $0.05
Player#8130: posts big blind $0.10
*** HOLE CARDS ***
Dealt to warioman [Jh 3s]
Player#3234: folds
warioman: folds
Player#9731: folds
Player#5629: raises $0.10 to $0.3
Player#9160: folds
Player#8130: folds
Player#8130: doesn't show hand
Player#3234: doesn't show hand
warioman: doesn't show hand
Player#9731: doesn't show hand
Player#5629: doesn't show hand
Player#9160: doesn't show hand
Uncalled bet ($0.30) returned to Player#5629
Player#5629 collected $0.15 from pot
*** SUMMARY ***
Total Pot $0.15 | Rake $0.00
Seat 1: Player#8130 (big blind) folded before the flop
Seat 2: Player#3234 folded before the flop
Seat 3: warioman folded before the flop
Seat 4: Player#9731 folded before the flop
Seat 5: Player#5629 shows [] and won ($0.15) with 
Seat 6: Player#9160 (small blind) folded before the flop

PokerStars Hand #3007e56d-9194-4a60-a13d-39e47e1e4f5a:  Hold'em No Limit ($0.1/$0.20 USD) - 2021/11/20 11:35:00 ET
Table 'Bethlehem' 6-max Seat #1 is the button
Seat 1: Player#2987 ($27.91 in chips)
Seat 2: Player#7561 ($20.63 in chips)
Seat 3: Player#2493 ($31.85 in chips)
Seat 4: Player#8465 ($20.00 in chips)
Seat 5: warioman ($25.91 in chips)
Player#7561: posts small blind $0.10
Player#2493: posts big blind $0.20
*** HOLE CARDS ***
Dealt to warioman [8h 6h]
Player#8465: folds
warioman: folds
Player#2987: folds
Player#7561: folds
Player#2493 collected $0.20 from pot
*** SUMMARY ***
Total Pot $0.20 | Rake $0.00
Seat 1: Player#2987 (button) folded before the flop
Seat 2: Player#7561 (small blind) folded before the flop
Seat 3: Player#2493 shows [] and won ($0.20) with 
Seat 4: Player#8465 folded before the flop
Seat 5: warioman folded before the flop

PokerStars Hand #72d5bcf5-d35b-4ca3-91ca-3de01731c2e2:  Hold'em No Limit ($0.1/$0.20 USD) - 2021/11/20 11:35:00 ET
Table 'Bel Air' 6-max Seat #6 is the button
Seat 1: Player#9942 ($30.89 in chips)
Seat 2: Player#3297 ($50.80 in chips)
Seat 3: warioman ($19.91 in chips)
Seat 4: Player#7272 ($20.00 in chips)
Seat 5: Player#2751 ($25.55 in chips)
Seat 6: Player#2015 ($23.42 in chips)
Player#9942: posts small blind $0.10
Player#3297: posts big blind $0.20
*** HOLE CARDS ***
Dealt to warioman [5h 5d]
warioman: folds
Player#7272: folds
Player#2751: folds
Player#2015: folds
Player#9942: calls $0.10
Player#3297: raises $0.20 to $0.6
Player#9942: folds
Player#3297: doesn't show hand
Uncalled bet ($0.60) returned to Player#3297
Player#3297 collected $0.20 from pot
*** SUMMARY ***
Total Pot $0.20 | Rake $0.00
Seat 1: Player#9942 (small blind) folded before the flop
Seat 2: Player#3297 shows [] and won ($0.20) with 
Seat 3: warioman folded before the flop
Seat 4: Player#7272 folded before the flop
Seat 5: Player#2751 folded before the flop
Seat 6: Player#2015 (button) folded before the flop

PokerStars Hand #dfbab2e7-3acf-4b91-a8c7-ca097aacefea:  Hold'em No Limit ($0.1/$0.20 USD) - 2021/11/20 11:34:00 ET
Table 'Bethlehem' 6-max Seat #6 is the button
Seat 1: Player#6728 ($28.01 in chips)
Seat 2: Player#4805 ($20.83 in chips)
Seat 3: Player#0863 ($31.85 in chips)
Seat 4: Player#6513 ($20.00 in chips)
Seat 5: warioman ($25.61 in chips)
Player#6728: posts small blind $0.10
Player#4805: posts big blind $0.20
*** HOLE CARDS ***
Dealt to warioman [Kc Jh]
Player#0863: folds
Player#6513: folds
warioman: raises $0.20 to $0.5
Player#6728: folds
Player#4805: folds
warioman: doesn't show hand
Uncalled bet ($0.50) returned to warioman
warioman collected $0.30 from pot
*** SUMMARY ***
Total Pot $0.30 | Rake $0.00
Seat 1: Player#6728 (small blind) folded before the flop
Seat 2: Player#4805 (big blind) folded before the flop
Seat 3: Player#0863 folded before the flop
Seat 4: Player#6513 folded before the flop
Seat 5: warioman

PokerStars Hand #92f83fa4-06ea-4a90-bfaf-c329e24d7cd5:  Hold'em No Limit ($0.1/$0.20 USD) - 2021/11/20 11:34:00 ET
Table 'Bel Air' 6-max Seat #5 is the button
Seat 1: Player#7632 ($30.61 in chips)
Seat 2: Player#2738 ($51.00 in chips)
Seat 3: warioman ($19.91 in chips)
Seat 4: Player#5463 ($20.00 in chips)
Seat 5: Player#8657 ($25.55 in chips)
Seat 6: Player#2072 ($23.52 in chips)
Player#2072: posts small blind $0.10
Player#7632: posts big blind $0.20
*** HOLE CARDS ***
Dealt to warioman [2d 4s]
Player#2738: calls $0.20
warioman: folds
Player#5463: folds
Player#8657: folds
Player#2072: folds
Player#7632: checks
*** FLOP *** [2s Th Kh]
Player#7632: bets $0.20
Player#2738: folds
Player#7632: doesn't show hand
Uncalled bet ($0.20) returned to Player#7632
Player#7632 collected $0.47 from pot
*** SUMMARY ***
Total Pot $0.50 | Rake $0.02
Board [2s Th Kh]
Seat 1: Player#7632 shows [] and won ($0.47) with 
Seat 2: Player#2738 folded on the flop
Seat 3: warioman folded before the flop
Seat 4: Player#5463 folded before the flop
Seat 5: Player#8657 (button) folded before the flop
Seat 6: Player#2072 (small blind) folded before the flop

PokerStars Hand #5ee580f8-9dea-4d7c-ba2b-4c76f74a3ece:  Hold'em No Limit ($0.05/$0.10 USD) - 2021/11/20 11:34:00 ET
Table 'Aberdeen' 6-max Seat #4 is the button
Seat 1: Player#6593 ($10.44 in chips)
Seat 2: Player#8670 ($9.38 in chips)
Seat 3: warioman ($19.71 in chips)
Seat 4: Player#1511 ($8.75 in chips)
Seat 5: Player#9558 ($10.63 in chips)
Seat 6: Player#1792 ($10.96 in chips)
Player#9558: posts small blind $0.05
Player#1792: posts big blind $0.10
*** HOLE CARDS ***
Dealt to warioman [9c Qc]
Player#6593: raises $0.10 to $0.3
Player#8670: folds
warioman: folds
Player#1511: folds
Player#9558: calls $0.25
Player#1792: calls $0.20
*** FLOP *** [Ts 5s 9h]
Player#9558: checks
Player#1792: checks
Player#6593: bets $0.40
Player#9558: folds
Player#1792: calls $0.40
*** TURN *** [Ts 5s 9h] [6c]
Player#1792: checks
Player#6593: checks
*** RIVER *** [Ts 5s 9h] [6c] [Qc]
Player#1792: checks
Player#6593: bets $1.70
Player#1792: folds
Player#6593: doesn't show hand
Uncalled bet ($1.70) returned to Player#6593
Player#6593 collected $1.62 from pot
*** SUMMARY ***
Total Pot $1.70 | Rake $0.09
Board [Ts 5s 9h 6c Qc]
Seat 1: Player#6593 shows [] and won ($1.62) with 
Seat 2: Player#8670 folded before the flop
Seat 3: warioman folded before the flop
Seat 4: Player#1511 (button) folded before the flop
Seat 5: Player#9558 (small blind) folded on the flop
Seat 6: Player#1792 (big blind) folded on the river

PokerStars Hand #3d4885df-4bfd-4b8f-8651-1db1ee8a7b8e:  Hold'em No Limit ($0.1/$0.20 USD) - 2021/11/20 11:34:00 ET
Table 'Bel Air' 6-max Seat #4 is the button
Seat 1: Player#7531 ($30.61 in chips)
Seat 2: Player#3305 ($51.00 in chips)
Seat 3: warioman ($19.91 in chips)
Seat 4: Player#1200 ($19.70 in chips)
Seat 5: Player#2483 ($25.65 in chips)
Seat 6: Player#6581 ($23.72 in chips)
Player#2483: posts small blind $0.10
Player#6581: posts big blind $0.20
*** HOLE CARDS ***
Dealt to warioman [6s Ks]
Player#7531: folds
Player#3305: folds
warioman: folds
Player#1200: raises $0.20 to $0.6
Player#2483: folds
Player#6581: folds
Player#1200: doesn't show hand
Uncalled bet ($0.60) returned to Player#1200
Player#1200 collected $0.30 from pot
*** SUMMARY ***
Total Pot $0.30 | Rake $0.00
Seat 1: Player#7531 folded before the flop
Seat 2: Player#3305 folded before the flop
Seat 3: warioman folded before the flop
Seat 4: Player#1200 shows [] and won ($0.30) with 
Seat 5: Player#2483 (small blind) folded before the flop
Seat 6: Player#6581 (big blind) folded before the flop

PokerStars Hand #594c3d18-51a1-4916-9539-ebffe0f039eb:  Hold'em No Limit ($0.1/$0.20 USD) - 2021/11/20 11:33:00 ET
Table 'Bel Air' 6-max Seat #3 is the button
Seat 1: Player#0966 ($30.61 in chips)
Seat 2: Player#5754 ($51.70 in chips)
Seat 3: warioman ($19.91 in chips)
Seat 4: Player#1760 ($19.80 in chips)
Seat 5: Player#3673 ($25.85 in chips)
Seat 6: Player#4268 ($22.80 in chips)
Player#1760: posts small blind $0.10
Player#3673: posts big blind $0.20
*** HOLE CARDS ***
Dealt to warioman [Td 2c]
Player#4268: raises $0.20 to $0.7
Player#0966: folds
Player#5754: calls $0.70
warioman: folds
Player#1760: folds
Player#3673: folds
*** FLOP *** [6s 8s 9c]
Player#4268: checks
Player#5754: checks
*** TURN *** [6s 8s 9c] [5s]
Player#4268: bets $1.70
Player#5754: folds
Player#4268: doesn't show hand
Uncalled bet ($1.70) returned to Player#4268
Player#4268 collected $1.61 from pot
*** SUMMARY ***
Total Pot $1.70 | Rake $0.09
Board [6s 8s 9c 5s]
Seat 1: Player#0966 folded before the flop
Seat 2: Player#5754 folded on the turn
Seat 3: warioman (button) folded before the flop
Seat 4: Player#1760 (small blind) folded before the flop
Seat 5: Player#3673 (big blind) folded before the flop
Seat 6: Player#4268 shows [] and won ($1.61) with 

PokerStars Hand #bf8292cd-820f-4abc-8fcb-2e62f5856414:  Hold'em No Limit ($0.05/$0.10 USD) - 2021/11/20 11:33:00 ET
Table 'Aberdeen' 6-max Seat #3 is the button
Seat 1: Player#6121 ($9.44 in chips)
Seat 2: Player#8135 ($9.83 in chips)
Seat 3: warioman ($19.71 in chips)
Seat 4: Player#7434 ($9.20 in chips)
Seat 5: Player#3383 ($10.73 in chips)
Seat 6: Player#3398 ($10.96 in chips)
Player#7434: posts small blind $0.05
Player#3383: posts big blind $0.10
*** HOLE CARDS ***
Dealt to warioman [Ks 4s]
Player#3398: folds
Player#6121: calls $0.10
Player#8135: raises $0.10 to $0.45
warioman: folds
Player#7434: calls $0.40
Player#3383: folds
Player#6121: raises $0.45 to $9.44
Player#8135: folds
Player#7434: folds
Player#6121: doesn't show hand
Uncalled bet ($9.44) returned to Player#6121
Player#6121 collected $1.00 from pot
*** SUMMARY ***
Total Pot $1.00 | Rake $0.00
Seat 1: Player#6121 shows [] and won ($1.00) with 
Seat 2: Player#8135 folded before the flop
Seat 3: warioman (button) folded before the flop
Seat 4: Player#7434 (small blind) folded before the flop
Seat 5: Player#3383 (big blind) folded before the flop
Seat 6: Player#3398 folded before the flop

PokerStars Hand #e9eabbc6-1cc5-4788-922d-cdeb938f1403:  Hold'em No Limit ($0.1/$0.20 USD) - 2021/11/20 11:33:00 ET
Table 'Bethlehem' 6-max Seat #4 is the button
Seat 1: Player#8652 ($22.69 in chips)
Seat 2: Player#8835 ($20.83 in chips)
Seat 3: Player#3159 ($31.85 in chips)
Seat 4: Player#4511 ($19.70 in chips)
Seat 5: warioman ($25.71 in chips)
warioman: posts small blind $0.10
Player#8652: posts big blind $0.20
*** HOLE CARDS ***
Dealt to warioman [9d 7h]
Player#8835: folds
Player#3159: folds
Player#4511: raises $0.20 to $0.6
warioman: folds
Player#8652: calls $0.40
*** FLOP *** [8h Tc 4h]
Player#8652: bets $1.30
Player#4511: calls $1.30
*** TURN *** [8h Tc 4h] [Jh]
Player#8652: bets $3.90
Player#4511: calls $3.90
*** RIVER *** [8h Tc 4h] [Jh] [5h]
Player#8652: bets $16.89
Player#4511: folds
Player#8652: doesn't show hand
Uncalled bet ($16.89) returned to Player#8652
Player#8652 collected $11.12 from pot
*** SUMMARY ***
Total Pot $11.70 | Rake $0.59
Board [8h Tc 4h Jh 5h]
Seat 1: Player#8652 shows [] and won ($11.12) with 
Seat 2: Player#8835 folded before the flop
Seat 3: Player#3159 folded before the flop
Seat 4: Player#4511 (button) folded on the river
Seat 5: warioman (small blind) folded before the flop

PokerStars Hand #7f2f64f5-70df-4edb-9cc8-aa627076295a:  Hold'em No Limit ($0.1/$0.20 USD) - 2021/11/20 11:33:00 ET
Table 'Bel Air' 6-max Seat #2 is the button
Seat 1: Player#1843 ($30.61 in chips)
Seat 2: Player#1016 ($51.70 in chips)
Seat 3: warioman ($20.01 in chips)
Seat 4: Player#9020 ($20.00 in chips)
Seat 5: Player#5623 ($25.55 in chips)
Seat 6: Player#5510 ($22.80 in chips)
warioman: posts small blind $0.10
Player#9020: posts big blind $0.20
*** HOLE CARDS ***
Dealt to warioman [Ac Th]
Player#5623: raises $0.20 to $0.6
Player#5510: folds
Player#1843: folds
Player#1016: folds
warioman: folds
Player#9020: folds
Player#5623: doesn't show hand
Uncalled bet ($0.60) returned to Player#5623
Player#5623 collected $0.30 from pot
*** SUMMARY ***
Total Pot $0.30 | Rake $0.00
Seat 1: Player#1843 folded before the flop
Seat 2: Player#1016 (button) folded before the flop
Seat 3: warioman (small blind) folded before the flop
Seat 4: Player#9020 (big blind) folded before the flop
Seat 5: Player#5623 shows [] and won ($0.30) with 
Seat 6: Player#5510 folded before the flop

PokerStars Hand #ff007668-f240-41b9-b56b-57c39577ecc4:  Hold'em No Limit ($0.05/$0.10 USD) - 2021/11/20 11:33:00 ET
Table 'Aberdeen' 6-max Seat #2 is the button
Seat 1: Player#3227 ($9.44 in chips)
Seat 2: Player#5265 ($9.68 in chips)
Seat 3: warioman ($19.76 in chips)
Seat 4: Player#7854 ($9.30 in chips)
Seat 5: Player#9814 ($10.73 in chips)
Seat 6: Player#2586 ($10.96 in chips)
warioman: posts small blind $0.05
Player#7854: posts big blind $0.10
*** HOLE CARDS ***
Dealt to warioman [6c Qh]
Player#9814: folds
Player#2586: folds
Player#3227: folds
Player#5265: raises $0.10 to $0.3
warioman: folds
Player#7854: folds
Player#5265: doesn't show hand
Uncalled bet ($0.30) returned to Player#5265
Player#5265 collected $0.15 from pot
*** SUMMARY ***
Total Pot $0.15 | Rake $0.00
Seat 1: Player#3227 folded before the flop
Seat 2: Player#5265 shows [] and won ($0.15) with 
Seat 3: warioman (small blind) folded before the flop
Seat 4: Player#7854 (big blind) folded before the flop
Seat 5: Player#9814 folded before the flop
Seat 6: Player#2586 folded before the flop

PokerStars Hand #e4add300-24df-495e-a7da-b700ada51c2a:  Hold'em No Limit ($0.1/$0.20 USD) - 2021/11/20 11:33:00 ET
Table 'Bel Air' 6-max Seat #1 is the button
Seat 1: Player#6466 ($30.61 in chips)
Seat 2: Player#4011 ($51.80 in chips)
Seat 3: warioman ($19.91 in chips)
Seat 4: Player#5883 ($20.00 in chips)
Seat 5: Player#3621 ($25.55 in chips)
Seat 6: Player#8891 ($22.80 in chips)
Player#4011: posts small blind $0.10
warioman: posts big blind $0.20
*** HOLE CARDS ***
Dealt to warioman [Js Qh]
Player#5883: folds
Player#3621: folds
Player#8891: folds
Player#6466: folds
Player#4011: folds
warioman collected $0.20 from pot
*** SUMMARY ***
Total Pot $0.20 | Rake $0.00
Seat 1: Player#6466 (button) folded before the flop
Seat 2: Player#4011 (small blind) folded before the flop
Seat 3: warioman (big blind)
Seat 4: Player#5883 folded before the flop
Seat 5: Player#3621 folded before the flop
Seat 6: Player#8891 folded before the flop

PokerStars Hand #ca7efacd-51d6-4654-a1d6-9d129791e90f:  Hold'em No Limit ($0.1/$0.20 USD) - 2021/11/20 11:33:00 ET
Table 'Bethlehem' 6-max Seat #3 is the button
Seat 1: Player#0741 ($22.69 in chips)
Seat 2: Player#4234 ($20.00 in chips)
Seat 3: Player#1149 ($32.45 in chips)
Seat 4: Player#6750 ($19.80 in chips)
Seat 5: warioman ($25.91 in chips)
Player#6750: posts small blind $0.10
warioman: posts big blind $0.20
*** HOLE CARDS ***
Dealt to warioman [2d 5h]
Player#0741: folds
Player#4234: raises $0.20 to $0.6
Player#1149: calls $0.60
Player#6750: folds
warioman: folds
*** FLOP *** [4h Ac Kh]
Player#4234: bets $1.13
Player#1149: folds
Player#4234: doesn't show hand
Uncalled bet ($1.13) returned to Player#4234
Player#4234 collected $1.43 from pot
*** SUMMARY ***
Total Pot $1.50 | Rake $0.08
Board [4h Ac Kh]
Seat 1: Player#0741 folded before the flop
Seat 2: Player#4234 shows [] and won ($1.43) with 
Seat 3: Player#1149 (button) folded on the flop
Seat 4: Player#6750 (small blind) folded before the flop
Seat 5: warioman (big blind) folded before the flop

PokerStars Hand #71f6c3a6-644f-43ff-ab11-bf9bb196842e:  Hold'em No Limit ($0.1/$0.20 USD) - 2021/11/20 11:32:00 ET
Table 'Bethlehem' 6-max Seat #2 is the button
Seat 1: Player#9313 ($22.69 in chips)
Seat 2: Player#2898 ($19.70 in chips)
Seat 3: Player#1240 ($32.55 in chips)
Seat 4: Player#6481 ($20.00 in chips)
Seat 5: warioman ($25.91 in chips)
Player#1240: posts small blind $0.10
Player#6481: posts big blind $0.20
*** HOLE CARDS ***
Dealt to warioman [4c Tc]
warioman: folds
Player#9313: folds
Player#2898: raises $0.20 to $0.6
Player#1240: folds
Player#6481: folds
Player#2898: doesn't show hand
Uncalled bet ($0.60) returned to Player#2898
Player#2898 collected $0.30 from pot
*** SUMMARY ***
Total Pot $0.30 | Rake $0.00
Seat 1: Player#9313 folded before the flop
Seat 2: Player#2898 shows [] and won ($0.30) with 
Seat 3: Player#1240 (small blind) folded before the flop
Seat 4: Player#6481 (big blind) folded before the flop
Seat 5: warioman folded before the flop

PokerStars Hand #3b3db7cc-1b81-43b6-9a09-3855259640a7:  Hold'em No Limit ($0.1/$0.20 USD) - 2021/11/20 11:32:00 ET
Table 'Bel Air' 6-max Seat #6 is the button
Seat 1: Player#6470 ($30.71 in chips)
Seat 2: Player#2595 ($51.07 in chips)
Seat 3: warioman ($19.91 in chips)
Seat 4: Player#1873 ($20.00 in chips)
Seat 5: Player#2066 ($25.55 in chips)
Seat 6: Player#3324 ($23.50 in chips)
Player#6470: posts small blind $0.10
Player#2595: posts big blind $0.20
*** HOLE CARDS ***
Dealt to warioman [2c 6s]
warioman: folds
Player#1873: folds
Player#2066: folds
Player#3324: raises $0.20 to $0.7
Player#6470: folds
Player#2595: calls $0.50
*** FLOP *** [Th Tc Qh]
Player#2595: checks
Player#3324: checks
*** TURN *** [Th Tc Qh] [3h]
Player#2595: bets $0.75
Player#3324: folds
Player#2595: doesn't show hand
Uncalled bet ($0.75) returned to Player#2595
Player#2595 collected $1.43 from pot
*** SUMMARY ***
Total Pot $1.50 | Rake $0.08
Board [Th Tc Qh 3h]
Seat 1: Player#6470 (small blind) folded before the flop
Seat 2: Player#2595 shows [] and won ($1.43) with 
Seat 3: warioman folded before the flop
Seat 4: Player#1873 folded before the flop
Seat 5: Player#2066 folded before the flop
Seat 6: Player#3324 (button) folded on the turn

PokerStars Hand #4386cdec-71ad-4fd6-a5d6-cb21db94ce8f:  Hold'em No Limit ($0.05/$0.10 USD) - 2021/11/20 11:32:00 ET
Table 'Aberdeen' 6-max Seat #1 is the button
Seat 1: Player#6892 ($10.04 in chips)
Seat 2: Player#7981 ($9.73 in chips)
Seat 3: warioman ($18.60 in chips)
Seat 4: Player#8407 ($9.90 in chips)
Seat 5: Player#4323 ($10.73 in chips)
Seat 6: Player#9231 ($10.96 in chips)
Player#7981: posts small blind $0.05
warioman: posts big blind $0.10
*** HOLE CARDS ***
Dealt to warioman [Js Ah]
Player#8407: calls $0.10
Player#4323: folds
Player#9231: folds
Player#6892: calls $0.10
Player#7981: folds
warioman: raises $0.10 to $0.6
Player#8407: calls $0.50
Player#6892: calls $0.50
*** FLOP *** [Ac 2h 3h]
warioman: bets $0.76
Player#8407: folds
Player#6892: folds
warioman: doesn't show hand
Uncalled bet ($0.76) returned to warioman
warioman collected $1.76 from pot
*** SUMMARY ***
Total Pot $1.85 | Rake $0.09
Board [Ac 2h 3h]
Seat 1: Player#6892 (button) folded on the flop
Seat 2: Player#7981 (small blind) folded before the flop
Seat 3: warioman (big blind)
Seat 4: Player#8407 folded on the flop
Seat 5: Player#4323 folded before the flop
Seat 6: Player#9231 folded before the flop

PokerStars Hand #a33c7dd5-6ccc-4b66-8c13-b6b02786e37d:  Hold'em No Limit ($0.1/$0.20 USD) - 2021/11/20 11:32:00 ET
Table 'Bethlehem' 6-max Seat #1 is the button
Seat 1: Player#8632 ($22.69 in chips)
Seat 2: Player#6742 ($19.80 in chips)
Seat 3: Player#2336 ($32.45 in chips)
Seat 4: Player#6419 ($20.00 in chips)
Seat 5: warioman ($25.91 in chips)
Player#6742: posts small blind $0.10
Player#2336: posts big blind $0.20
*** HOLE CARDS ***
Dealt to warioman [Tc 3c]
Player#6419: folds
warioman: folds
Player#8632: folds
Player#6742: folds
Player#2336 collected $0.20 from pot
*** SUMMARY ***
Total Pot $0.20 | Rake $0.00
Seat 1: Player#8632 (button) folded before the flop
Seat 2: Player#6742 (small blind) folded before the flop
Seat 3: Player#2336 shows [] and won ($0.20) with 
Seat 4: Player#6419 folded before the flop
Seat 5: warioman folded before the flop

PokerStars Hand #1d6313f6-ae72-43b9-9a93-e93a9ddf06c0:  Hold'em No Limit ($0.1/$0.20 USD) - 2021/11/20 11:32:00 ET
Table 'Bel Air' 6-max Seat #5 is the button
Seat 1: Player#0798 ($31.11 in chips)
Seat 2: Player#9150 ($50.61 in chips)
Seat 3: warioman ($19.91 in chips)
Seat 4: Player#6290 ($18.40 in chips)
Seat 5: Player#1989 ($25.55 in chips)
Seat 6: Player#6853 ($23.60 in chips)
Player#6853: posts small blind $0.10
Player#0798: posts big blind $0.20
*** HOLE CARDS ***
Dealt to warioman [9h 8c]
Player#9150: calls $0.20
warioman: folds
Player#6290: folds
Player#1989: folds
Player#6853: folds
Player#0798: checks
*** FLOP *** [3c 5h Jh]
Player#0798: bets $0.20
Player#9150: calls $0.20
*** TURN *** [3c 5h Jh] [Ac]
Player#0798: checks
Player#9150: bets $0.60
Player#0798: folds
Player#9150: doesn't show hand
Uncalled bet ($0.60) returned to Player#9150
Player#9150 collected $0.85 from pot
*** SUMMARY ***
Total Pot $0.90 | Rake $0.05
Board [3c 5h Jh Ac]
Seat 1: Player#0798 (big blind) folded on the turn
Seat 2: Player#9150 shows [] and won ($0.85) with 
Seat 3: warioman folded before the flop
Seat 4: Player#6290 folded before the flop
Seat 5: Player#1989 (button) folded before the flop
Seat 6: Player#6853 (small blind) folded before the flop

PokerStars Hand #9e6444e8-798d-4644-8208-34d6bc8d8f8b:  Hold'em No Limit ($0.1/$0.20 USD) - 2021/11/20 11:32:00 ET
Table 'Bethlehem' 6-max Seat #1 is the button
Seat 1: Player#6049 ($22.39 in chips)
Seat 2: Player#9123 ($21.56 in chips)
Seat 3: Player#5117 ($20.00 in chips)
Seat 4: Player#9495 ($32.45 in chips)
Seat 5: Player#8782 ($20.00 in chips)
Seat 6: warioman ($25.91 in chips)
Player#9123: posts small blind $0.10
Player#5117: posts big blind $0.20
*** HOLE CARDS ***
Dealt to warioman [2c 8h]
Player#9495: folds
Player#8782: folds
warioman: folds
Player#6049: raises $0.20 to $0.7
Player#9123: folds
Player#5117: folds
Player#6049: doesn't show hand
Uncalled bet ($0.70) returned to Player#6049
Player#6049 collected $0.30 from pot
*** SUMMARY ***
Total Pot $0.30 | Rake $0.00
Seat 1: Player#6049 shows [] and won ($0.30) with 
Seat 2: Player#9123 (small blind) folded before the flop
Seat 3: Player#5117 (big blind) folded before the flop
Seat 4: Player#9495 folded before the flop
Seat 5: Player#8782 folded before the flop
Seat 6: warioman folded before the flop

PokerStars Hand #9ec527a1-f012-460a-8b8c-4ff8a141f6d1:  Hold'em No Limit ($0.05/$0.10 USD) - 2021/11/20 11:31:00 ET
Table 'Aberdeen' 6-max Seat #6 is the button
Seat 1: Player#9066 ($10.09 in chips)
Seat 2: Player#9512 ($10.22 in chips)
Seat 3: warioman ($18.60 in chips)
Seat 4: Player#6910 ($9.90 in chips)
Seat 5: Player#7983 ($10.73 in chips)
Seat 6: Player#6829 ($11.44 in chips)
Player#9066: posts small blind $0.05
Player#9512: posts big blind $0.10
*** HOLE CARDS ***
Dealt to warioman [Tc 7h]
warioman: folds
Player#6910: folds
Player#7983: folds
Player#6829: raises $0.10 to $0.2
Player#9066: folds
Player#9512: raises $0.20 to $0.65
Player#6829: calls $0.45
*** FLOP *** [2c 2d Qd]
Player#9512: bets $0.68
Player#6829: raises $ 10.68 to $10.79
Player#9512: calls $8.89
Player#9512 Showing Pocket Cards QA
Player#6829 Showing Pocket Cards KQ
*** TURN *** [2c 2d Qd] [2c]
*** RIVER *** [2c 2d Qd] [2c] [4h]
 *** SUMMARY ***
Total Pot $21.71 | Rake $1.09
Board [2c 2d Qd 2c 4h]
Seat 1: Player#9066 (small blind) folded before the flop
Seat 2: Player#9512 (big blind) mucked
Seat 3: warioman folded before the flop
Seat 4: Player#6910 folded before the flop
Seat 5: Player#7983 folded before the flop
Seat 6: Player#6829 (button) mucked

PokerStars Hand #5fddc81a-d8c0-46ca-bb5f-53384075dfd1:  Hold'em No Limit ($0.1/$0.20 USD) - 2021/11/20 11:31:00 ET
Table 'Bethlehem' 6-max Seat #2 is the button
Seat 1: Player#3815 ($22.49 in chips)
Seat 2: Player#0120 ($21.76 in chips)
Seat 3: Player#7708 ($20.00 in chips)
Seat 4: Player#1363 ($32.45 in chips)
Seat 5: Player#0003 ($20.00 in chips)
Seat 6: warioman ($25.61 in chips)
Player#7708: posts small blind $0.10
Player#3815: posts big blind $0.20
*** HOLE CARDS ***
Dealt to warioman [Ad Jc]
Player#7708 Waiting
Player#1363: folds
Player#0003: folds
warioman: raises $0.20 to $0.5
Player#3815: folds
Player#0120: folds
warioman: doesn't show hand
Uncalled bet ($0.50) returned to warioman
warioman collected $0.30 from pot
*** SUMMARY ***
Total Pot $0.30 | Rake $0.00
Seat 1: Player#3815 (big blind) folded before the flop
Seat 2: Player#0120 (button) folded before the flop
Seat 3: Player#7708 (small blind) mucked
Seat 4: Player#1363 folded before the flop
Seat 5: Player#0003 folded before the flop
Seat 6: warioman

PokerStars Hand #e2e548d4-858a-46ab-a2f8-f262545de3c3:  Hold'em No Limit ($0.1/$0.20 USD) - 2021/11/20 11:31:00 ET
Table 'Bel Air' 6-max Seat #4 is the button
Seat 1: Player#6635 ($31.11 in chips)
Seat 2: Player#4937 ($50.61 in chips)
Seat 3: warioman ($20.74 in chips)
Seat 4: Player#6839 ($18.40 in chips)
Seat 5: Player#5163 ($25.65 in chips)
Seat 6: Player#8289 ($22.75 in chips)
Player#5163: posts small blind $0.10
Player#8289: posts big blind $0.20
*** HOLE CARDS ***
Dealt to warioman [9c 9d]
Player#6635: folds
Player#4937: folds
warioman: raises $0.20 to $0.5
Player#6839: folds
Player#5163: folds
Player#8289: calls $0.30
*** FLOP *** [Jc 8d 4h]
Player#8289: checks
warioman: bets $0.33
Player#8289: raises $0.33 to $1.97
warioman: folds
Player#8289: doesn't show hand
Uncalled bet ($1.97) returned to Player#8289
Player#8289 collected $1.36 from pot
*** SUMMARY ***
Total Pot $1.43 | Rake $0.07
Board [Jc 8d 4h]
Seat 1: Player#6635 folded before the flop
Seat 2: Player#4937 folded before the flop
Seat 3: warioman folded on the flop
Seat 4: Player#6839 (button) folded before the flop
Seat 5: Player#5163 (small blind) folded before the flop
Seat 6: Player#8289 shows [] and won ($1.36) with 

PokerStars Hand #e47793ab-dc3b-42d5-a245-659a1eb98ff8:  Hold'em No Limit ($0.1/$0.20 USD) - 2021/11/20 11:31:00 ET
Table 'Bel Air' 6-max Seat #3 is the button
Seat 1: Player#2163 ($31.11 in chips)
Seat 2: Player#5849 ($50.81 in chips)
Seat 3: warioman ($20.74 in chips)
Seat 4: Player#9021 ($18.50 in chips)
Seat 5: Player#2084 ($25.37 in chips)
Seat 6: Player#3187 ($22.75 in chips)
Player#9021: posts small blind $0.10
Player#2084: posts big blind $0.20
*** HOLE CARDS ***
Dealt to warioman [6d As]
Player#3187: folds
Player#2163: folds
Player#5849: calls $0.20
warioman: folds
Player#9021: folds
Player#2084: checks
*** FLOP *** [9c Jd 6s]
Player#2084: checks
Player#5849: checks
*** TURN *** [9c Jd 6s] [2s]
Player#2084: bets $0.40
Player#5849: folds
Player#2084: doesn't show hand
Uncalled bet ($0.40) returned to Player#2084
Player#2084 collected $0.47 from pot
*** SUMMARY ***
Total Pot $0.50 | Rake $0.03
Board [9c Jd 6s 2s]
Seat 1: Player#2163 folded before the flop
Seat 2: Player#5849 folded on the turn
Seat 3: warioman (button) folded before the flop
Seat 4: Player#9021 (small blind) folded before the flop
Seat 5: Player#2084 shows [] and won ($0.47) with 
Seat 6: Player#3187 folded before the flop

PokerStars Hand #9369a527-3dac-4616-96c2-202deb515244:  Hold'em No Limit ($0.1/$0.20 USD) - 2021/11/20 11:30:00 ET
Table 'Bethlehem' 6-max Seat #2 is the button
Seat 1: Player#9455 ($22.69 in chips)
Seat 2: Player#6477 ($21.76 in chips)
Seat 3: Player#3157 ($20.00 in chips)
Seat 4: Player#3804 ($33.05 in chips)
Seat 5: Player#5353 ($16.90 in chips)
Seat 6: warioman ($25.71 in chips)
Player#3157: posts small blind $0.10
warioman: posts big blind $0.20
*** HOLE CARDS ***
Dealt to warioman [7h 9c]
Player#3157 Waiting
Player#6477: folds
Player#3804: raises $0.20 to $0.6
Player#5353: calls $0.60
warioman: folds
Player#9455: folds
*** FLOP *** [Tc 8d Kh]
Player#3804: checks
Player#5353: checks
*** TURN *** [Tc 8d Kh] [4c]
Player#3804: checks
Player#5353: checks
*** RIVER *** [Tc 8d Kh] [4c] [Kc]
Player#3804: checks
Player#5353: checks
*** SHOW DOWN *** 
Player#5353 collected $1.43 from pot
*** SUMMARY ***
Total Pot $1.50 | Rake $0.08
Board [Tc 8d Kh 4c Kc]
Seat 1: Player#9455 folded before the flop
Seat 2: Player#6477 (button) folded before the flop
Seat 3: Player#3157 (small blind) mucked
Seat 4: Player#3804 mucked
Seat 5: Player#5353 shows [9d Ad] and won ($1.43) with 
Seat 6: warioman (big blind) folded before the flop

PokerStars Hand #c44ca580-613f-43d4-9db6-d8bca5d21ff2:  Hold'em No Limit ($0.05/$0.10 USD) - 2021/11/20 11:30:00 ET
Table 'Aberdeen' 6-max Seat #5 is the button
Seat 1: Player#2964 ($10.19 in chips)
Seat 2: Player#2517 ($10.22 in chips)
Seat 3: warioman ($18.60 in chips)
Seat 4: Player#3911 ($10.00 in chips)
Seat 5: Player#3682 ($10.83 in chips)
Seat 6: Player#2151 ($11.16 in chips)
Player#2151: posts small blind $0.05
Player#2964: posts big blind $0.10
*** HOLE CARDS ***
Dealt to warioman [6d 3s]
Player#3911 Entry Bet 0.1
Player#2517: folds
warioman: folds
Player#3911: checks
Player#3682: calls $0.10
Player#2151: calls $0.05
Player#2964: checks
*** FLOP *** [9c 2h 3h]
Player#2151: checks
Player#2964: checks
Player#3911: checks
Player#3682: checks
*** TURN *** [9c 2h 3h] [3d]
Player#2151: checks
Player#2964: checks
Player#3911: checks
Player#3682: checks
*** RIVER *** [9c 2h 3h] [3d] [4d]
Player#2151: checks
Player#2964: checks
Player#3911: checks
Player#3682: checks
*** SHOW DOWN *** 
Player#2151 collected $0.29 from pot
*** SUMMARY ***
Total Pot $0.30 | Rake $0.02
Board [9c 2h 3h 3d 4d]
Seat 1: Player#2964 (big blind) mucked
Seat 2: Player#2517 folded before the flop
Seat 3: warioman folded before the flop
Seat 4: Player#3911 mucked
Seat 5: Player#3682 (button) mucked
Seat 6: Player#2151 shows [Ks Qh] and won ($0.29) with 

PokerStars Hand #5b15f39b-d972-45fe-a819-7e21c0b0e60f:  Hold'em No Limit ($0.1/$0.20 USD) - 2021/11/20 11:30:00 ET
Table 'Bel Air' 6-max Seat #2 is the button
Seat 1: Player#3735 ($31.11 in chips)
Seat 2: Player#6664 ($49.36 in chips)
Seat 3: warioman ($20.84 in chips)
Seat 4: Player#9314 ($20.00 in chips)
Seat 5: Player#1747 ($25.37 in chips)
Seat 6: Player#2253 ($22.75 in chips)
warioman: posts small blind $0.10
Player#9314: posts big blind $0.20
*** HOLE CARDS ***
Dealt to warioman [5d Kh]
Player#1747: folds
Player#2253: folds
Player#3735: folds
Player#6664: raises $0.20 to $0.4
warioman: folds
Player#9314: raises $0.40 to $1.5
Player#6664: calls $1.10
*** FLOP *** [6h 7h 4h]
Player#9314: checks
Player#6664: checks
*** TURN *** [6h 7h 4h] [4d]
Player#9314: checks
Player#6664: bets $1.55
Player#9314: folds
Player#6664: doesn't show hand
Uncalled bet ($1.55) returned to Player#6664
Player#6664 collected $2.95 from pot
*** SUMMARY ***
Total Pot $3.10 | Rake $0.16
Board [6h 7h 4h 4d]
Seat 1: Player#3735 folded before the flop
Seat 2: Player#6664 shows [] and won ($2.95) with 
Seat 3: warioman (small blind) folded before the flop
Seat 4: Player#9314 (big blind) folded on the turn
Seat 5: Player#1747 folded before the flop
Seat 6: Player#2253 folded before the flop

PokerStars Hand #2aabe0d9-155d-4cf4-8c86-e21c98164202:  Hold'em No Limit ($0.1/$0.20 USD) - 2021/11/20 11:29:00 ET
Table 'Bethlehem' 6-max Seat #2 is the button
Seat 1: Player#0124 ($22.69 in chips)
Seat 2: Player#3281 ($21.76 in chips)
Seat 3: Player#6722 ($20.00 in chips)
Seat 4: Player#1422 ($33.05 in chips)
Seat 5: Player#8017 ($18.70 in chips)
Seat 6: warioman ($24.09 in chips)
Player#6722: posts small blind $0.10
Player#8017: posts big blind $0.20
*** HOLE CARDS ***
Dealt to warioman [Qh Ah]
Player#6722 Waiting
Player#0124: folds
Player#3281: folds
Player#1422: folds
Player#8017: raises $0.20 to $0.6
warioman: raises $0.60 to $1.8
Player#8017: calls $1.20
*** FLOP *** [2h Kh 5s]
Player#8017: checks
warioman: bets $1.28
Player#8017: folds
warioman: doesn't show hand
Uncalled bet ($1.28) returned to warioman
warioman collected $3.42 from pot
*** SUMMARY ***
Total Pot $3.60 | Rake $0.18
Board [2h Kh 5s]
Seat 1: Player#0124 folded before the flop
Seat 2: Player#3281 (button) folded before the flop
Seat 3: Player#6722 (small blind) mucked
Seat 4: Player#1422 folded before the flop
Seat 5: Player#8017 (big blind) folded on the flop
Seat 6: warioman

PokerStars Hand #9a2f9030-d6d8-4b5b-b465-0f33f28820a3:  Hold'em No Limit ($0.05/$0.10 USD) - 2021/11/20 11:29:00 ET
Table 'Aberdeen' 6-max Seat #4 is the button
Seat 1: Player#3813 ($9.01 in chips)
Seat 2: Player#3229 ($10.22 in chips)
Seat 3: warioman ($18.60 in chips)
Seat 4: Player#2778 ($10.00 in chips)
Seat 5: Player#6515 ($12.03 in chips)
Seat 6: Player#9548 ($11.26 in chips)
Player#6515: posts small blind $0.05
Player#9548: posts big blind $0.10
*** HOLE CARDS ***
Dealt to warioman [2d 6h]
Player#3813: calls $0.10
Player#3229: folds
warioman: folds
Player#6515: calls $0.05
Player#9548: checks
*** FLOP *** [Jc 9h 7c]
Player#6515: checks
Player#9548: checks
Player#3813: bets $0.30
Player#6515: calls $0.30
Player#9548: folds
*** TURN *** [Jc 9h 7c] [8h]
Player#6515: checks
Player#3813: bets $0.30
Player#6515: raises $0.30 to $0.8
Player#3813: calls $0.50
*** RIVER *** [Jc 9h 7c] [8h] [3h]
Player#6515: checks
Player#3813: bets $1.25
Player#6515: folds
Player#3813: doesn't show hand
Uncalled bet ($1.25) returned to Player#3813
Player#3813 collected $2.38 from pot
*** SUMMARY ***
Total Pot $2.50 | Rake $0.12
Board [Jc 9h 7c 8h 3h]
Seat 1: Player#3813 shows [] and won ($2.38) with 
Seat 2: Player#3229 folded before the flop
Seat 3: warioman folded before the flop
Seat 4: Player#2778 (button) mucked
Seat 5: Player#6515 (small blind) folded on the river
Seat 6: Player#9548 (big blind) folded on the flop

PokerStars Hand #39a6c681-bf9a-44cb-883d-3c15f3ea2ec1:  Hold'em No Limit ($0.1/$0.20 USD) - 2021/11/20 11:29:00 ET
Table 'Bethlehem' 6-max Seat #3 is the button
Seat 1: Player#0319 ($22.69 in chips)
Seat 2: Player#5732 ($21.76 in chips)
Seat 3: Player#4351 ($20.00 in chips)
Seat 4: Player#9493 ($33.15 in chips)
Seat 5: Player#3857 ($18.90 in chips)
Seat 6: warioman ($23.79 in chips)
Player#9493: posts small blind $0.10
Player#3857: posts big blind $0.20
*** HOLE CARDS ***
Dealt to warioman [Js 9s]
warioman: raises $0.20 to $0.5
Player#0319: folds
Player#5732: folds
Player#9493: folds
Player#3857: folds
warioman: doesn't show hand
Uncalled bet ($0.50) returned to warioman
warioman collected $0.30 from pot
*** SUMMARY ***
Total Pot $0.30 | Rake $0.00
Seat 1: Player#0319 folded before the flop
Seat 2: Player#5732 folded before the flop
Seat 3: Player#4351 (button) mucked
Seat 4: Player#9493 (small blind) folded before the flop
Seat 5: Player#3857 (big blind) folded before the flop
Seat 6: warioman

PokerStars Hand #0c760632-d711-45cb-bdcc-be755e17a973:  Hold'em No Limit ($0.1/$0.20 USD) - 2021/11/20 11:29:00 ET
Table 'Bel Air' 6-max Seat #3 is the button
Seat 1: Player#3822 ($31.11 in chips)
Seat 2: Player#0133 ($49.96 in chips)
Seat 3: warioman ($20.30 in chips)
Seat 4: Player#5273 ($20.00 in chips)
Seat 5: Player#6455 ($25.37 in chips)
Seat 6: Player#0531 ($22.75 in chips)
Player#5273: posts small blind $0.10
Player#0133: posts big blind $0.20
*** HOLE CARDS ***
Dealt to warioman [Kc 6d]
Player#5273 Waiting
Player#6455: folds
Player#0531: folds
Player#3822: folds
Player#0133: calls $0.10
warioman: checks
*** FLOP *** [Ks Kd Jd]
Player#0133: checks
warioman: checks
*** TURN *** [Ks Kd Jd] [Td]
Player#0133: bets $0.40
warioman: calls $0.40
*** RIVER *** [Ks Kd Jd] [Td] [2d]
Player#0133: checks
warioman: checks
*** SHOW DOWN *** 
warioman collected $1.14 from pot
*** SUMMARY ***
Total Pot $1.20 | Rake $0.06
Board [Ks Kd Jd Td 2d]
Seat 1: Player#3822 folded before the flop
Seat 2: Player#0133 (big blind) mucked
Seat 3: warioman (button)
Seat 4: Player#5273 (small blind) mucked
Seat 5: Player#6455 folded before the flop
Seat 6: Player#0531 folded before the flop

PokerStars Hand #fe6afc5a-c3d9-41bf-971b-8ec152702cdd:  Hold'em No Limit ($0.1/$0.20 USD) - 2021/11/20 11:29:00 ET
Table 'Bethlehem' 6-max Seat #1 is the button
Seat 1: Player#3919 ($22.69 in chips)
Seat 2: Player#8919 ($21.86 in chips)
Seat 3: Player#7062 ($33.35 in chips)
Seat 4: Player#0717 ($18.60 in chips)
Seat 5: warioman ($23.79 in chips)
Player#8919: posts small blind $0.10
Player#7062: posts big blind $0.20
*** HOLE CARDS ***
Dealt to warioman [Qd 9h]
Player#0717: raises $0.20 to $0.6
warioman: folds
Player#3919: folds
Player#8919: folds
Player#7062: folds
Player#0717: doesn't show hand
Uncalled bet ($0.60) returned to Player#0717
Player#0717 collected $0.30 from pot
*** SUMMARY ***
Total Pot $0.30 | Rake $0.00
Seat 1: Player#3919 (button) folded before the flop
Seat 2: Player#8919 (small blind) folded before the flop
Seat 3: Player#7062 (big blind) folded before the flop
Seat 4: Player#0717 shows [] and won ($0.30) with 
Seat 5: warioman folded before the flop

PokerStars Hand #03b4c04d-20a0-4b71-a067-cd0a33813fbc:  Hold'em No Limit ($0.1/$0.20 USD) - 2021/11/20 11:29:00 ET
Table 'Bel Air' 6-max Seat #3 is the button
Seat 1: Player#6808 ($31.21 in chips)
Seat 2: Player#1965 ($50.16 in chips)
Seat 3: warioman ($20.30 in chips)
Seat 4: Player#9984 ($20.00 in chips)
Seat 5: Player#1094 ($25.07 in chips)
Seat 6: Player#5675 ($22.75 in chips)
Player#9984: posts small blind $0.10
Player#6808: posts big blind $0.20
*** HOLE CARDS ***
Dealt to warioman [5c Ts]
Player#9984 Waiting
warioman: folds
Player#1094: raises $0.20 to $0.6
Player#5675: folds
Player#6808: folds
Player#1965: folds
Player#1094: doesn't show hand
Uncalled bet ($0.60) returned to Player#1094
Player#1094 collected $0.30 from pot
*** SUMMARY ***
Total Pot $0.30 | Rake $0.00
Seat 1: Player#6808 (big blind) folded before the flop
Seat 2: Player#1965 folded before the flop
Seat 3: warioman (button) folded before the flop
Seat 4: Player#9984 (small blind) mucked
Seat 5: Player#1094 shows [] and won ($0.30) with 
Seat 6: Player#5675 folded before the flop

PokerStars Hand #3bdb1ca6-d31c-4e07-bc10-d65014ef6e9b:  Hold'em No Limit ($0.1/$0.20 USD) - 2021/11/20 11:29:00 ET
Table 'Bethlehem' 6-max Seat #6 is the button
Seat 1: Player#8771 ($22.79 in chips)
Seat 2: Player#9406 ($21.76 in chips)
Seat 3: Player#0252 ($20.79 in chips)
Seat 4: Player#9369 ($33.35 in chips)
Seat 5: Player#3905 ($18.60 in chips)
Seat 6: warioman ($23.79 in chips)
Player#8771: posts small blind $0.10
Player#9406: posts big blind $0.20
*** HOLE CARDS ***
Dealt to warioman [6c 8h]
Player#0252: folds
Player#9369: folds
Player#3905: folds
warioman: folds
Player#8771: folds
Player#9406 collected $0.20 from pot
*** SUMMARY ***
Total Pot $0.20 | Rake $0.00
Seat 1: Player#8771 (small blind) folded before the flop
Seat 2: Player#9406 shows [] and won ($0.20) with 
Seat 3: Player#0252 folded before the flop
Seat 4: Player#9369 folded before the flop
Seat 5: Player#3905 folded before the flop
Seat 6: warioman (button) folded before the flop

PokerStars Hand #e22778ad-bdf3-4b2d-b9fa-8e6c72b32570:  Hold'em No Limit ($0.05/$0.10 USD) - 2021/11/20 11:29:00 ET
Table 'Aberdeen' 6-max Seat #2 is the button
Seat 1: Player#8584 ($9.01 in chips)
Seat 2: Player#1854 ($10.22 in chips)
Seat 3: warioman ($18.65 in chips)
Seat 4: Player#1382 ($13.43 in chips)
Seat 5: Player#2896 ($9.95 in chips)
warioman: posts small blind $0.05
Player#1382: posts big blind $0.10
*** HOLE CARDS ***
Dealt to warioman [9c 5s]
Player#2896: raises $0.10 to $0.35
Player#8584: folds
Player#1854: folds
warioman: folds
Player#1382: calls $0.25
*** FLOP *** [Jc 3h Ts]
Player#1382: checks
Player#2896: checks
*** TURN *** [Jc 3h Ts] [Ad]
Player#1382: checks
Player#2896: bets $0.10
Player#1382: calls $0.10
*** RIVER *** [Jc 3h Ts] [Ad] [3d]
Player#1382: bets $0.95
Player#2896: raises $0.95 to $3.8
Player#1382: folds
Player#2896: doesn't show hand
Uncalled bet ($3.80) returned to Player#2896
Player#2896 collected $1.80 from pot
*** SUMMARY ***
Total Pot $1.90 | Rake $0.09
Board [Jc 3h Ts Ad 3d]
Seat 1: Player#8584 folded before the flop
Seat 2: Player#1854 (button) folded before the flop
Seat 3: warioman (small blind) folded before the flop
Seat 4: Player#1382 (big blind) folded on the river
Seat 5: Player#2896 shows [] and won ($1.80) with 

PokerStars Hand #f048fc34-1497-4bc1-93d7-7d3058cf279e:  Hold'em No Limit ($0.1/$0.20 USD) - 2021/11/20 11:28:00 ET
Table 'Bel Air' 6-max Seat #3 is the button
Seat 1: Player#5668 ($31.11 in chips)
Seat 2: Player#4083 ($50.16 in chips)
Seat 3: warioman ($20.30 in chips)
Seat 4: Player#4881 ($20.00 in chips)
Seat 5: Player#2414 ($25.07 in chips)
Seat 6: Player#0457 ($22.85 in chips)
Player#4881: posts small blind $0.10
Player#0457: posts big blind $0.20
*** HOLE CARDS ***
Dealt to warioman [Ad 7h]
Player#4881 Waiting
Player#4083: folds
warioman: folds
Player#2414: folds
Player#0457: folds
Player#5668 collected $0.20 from pot
*** SUMMARY ***
Total Pot $0.20 | Rake $0.00
Seat 1: Player#5668 shows [] and won ($0.20) with 
Seat 2: Player#4083 folded before the flop
Seat 3: warioman (button) folded before the flop
Seat 4: Player#4881 (small blind) mucked
Seat 5: Player#2414 folded before the flop
Seat 6: Player#0457 (big blind) folded before the flop

PokerStars Hand #fc278764-5bf1-4dfe-8faf-ed342e80d715:  Hold'em No Limit ($0.1/$0.20 USD) - 2021/11/20 11:28:00 ET
Table 'Bel Air' 6-max Seat #3 is the button
Seat 1: Player#2138 ($31.11 in chips)
Seat 2: Player#0750 ($50.16 in chips)
Seat 3: warioman ($20.00 in chips)
Seat 4: Player#9243 ($25.17 in chips)
Seat 5: Player#1343 ($23.05 in chips)
Player#9243: posts small blind $0.10
Player#1343: posts big blind $0.20
*** HOLE CARDS ***
Dealt to warioman [Ac Ah]
Player#2138: folds
Player#0750: folds
warioman: raises $0.20 to $0.5
Player#9243: folds
Player#1343: folds
warioman: doesn't show hand
Uncalled bet ($0.50) returned to warioman
warioman collected $0.30 from pot
*** SUMMARY ***
Total Pot $0.30 | Rake $0.00
Seat 1: Player#2138 folded before the flop
Seat 2: Player#0750 folded before the flop
Seat 3: warioman (button)
Seat 4: Player#9243 (small blind) folded before the flop
Seat 5: Player#1343 (big blind) folded before the flop

PokerStars Hand #d91d8e2e-9c39-407e-92d3-326cd6761cb9:  Hold'em No Limit ($0.05/$0.10 USD) - 2021/11/20 11:28:00 ET
Table 'Aberdeen' 6-max Seat #1 is the button
Seat 1: Player#3691 ($8.64 in chips)
Seat 2: Player#9810 ($10.27 in chips)
Seat 3: warioman ($19.00 in chips)
Seat 4: Player#2481 ($13.43 in chips)
Seat 5: Player#5414 ($9.95 in chips)
Player#9810: posts small blind $0.05
warioman: posts big blind $0.10
*** HOLE CARDS ***
Dealt to warioman [8h Qc]
Player#2481: folds
Player#5414: folds
Player#3691: calls $0.10
Player#9810: folds
warioman: checks
*** FLOP *** [6d Ts 8c]
warioman: checks
Player#3691: bets $0.25
warioman: calls $0.25
*** TURN *** [6d Ts 8c] [Jd]
warioman: checks
Player#3691: bets $0.75
warioman: folds
Player#3691: doesn't show hand
Uncalled bet ($0.75) returned to Player#3691
Player#3691 collected $0.71 from pot
*** SUMMARY ***
Total Pot $0.75 | Rake $0.04
Board [6d Ts 8c Jd]
Seat 1: Player#3691 shows [] and won ($0.71) with 
Seat 2: Player#9810 (small blind) folded before the flop
Seat 3: warioman (big blind) folded on the turn
Seat 4: Player#2481 folded before the flop
Seat 5: Player#5414 folded before the flop

PokerStars Hand #131ab88a-4d0f-4ed0-9ce8-8cf8be02bae0:  Hold'em No Limit ($0.1/$0.20 USD) - 2021/11/20 11:27:00 ET
Table 'Bethlehem' 6-max Seat #5 is the button
Seat 1: Player#1197 ($22.99 in chips)
Seat 2: Player#9275 ($21.76 in chips)
Seat 3: Player#5680 ($19.78 in chips)
Seat 4: Player#1487 ($33.35 in chips)
Seat 5: Player#7169 ($19.40 in chips)
Seat 6: warioman ($23.89 in chips)
warioman: posts small blind $0.10
Player#1197: posts big blind $0.20
*** HOLE CARDS ***
Dealt to warioman [Ks 3c]
Player#9275: folds
Player#5680: calls $0.20
Player#1487: folds
Player#7169: raises $0.20 to $0.8
warioman: folds
Player#1197: folds
Player#5680: calls $0.60
*** FLOP *** [8h Qc 6d]
Player#5680: checks
Player#7169: checks
*** TURN *** [8h Qc 6d] [Ac]
Player#5680: checks
Player#7169: checks
*** RIVER *** [8h Qc 6d] [Ac] [6c]
Player#5680: bets $0.60
Player#7169: folds
Player#5680: doesn't show hand
Uncalled bet ($0.60) returned to Player#5680
Player#5680 collected $1.80 from pot
*** SUMMARY ***
Total Pot $1.90 | Rake $0.10
Board [8h Qc 6d Ac 6c]
Seat 1: Player#1197 (big blind) folded before the flop
Seat 2: Player#9275 folded before the flop
Seat 3: Player#5680 shows [] and won ($1.80) with 
Seat 4: Player#1487 folded before the flop
Seat 5: Player#7169 (button) folded on the river
Seat 6: warioman (small blind) folded before the flop

PokerStars Hand #3ac92f34-ae40-441d-b996-f677b301f48f:  Hold'em No Limit ($0.05/$0.10 USD) - 2021/11/20 11:27:00 ET
Table 'Aberdeen' 6-max Seat #6 is the button
Seat 1: Player#8985 ($8.94 in chips)
Seat 2: Player#2839 ($10.00 in chips)
Seat 3: warioman ($19.00 in chips)
Seat 4: Player#9434 ($13.43 in chips)
Seat 5: Player#9963 ($9.95 in chips)
Player#8985: posts small blind $0.05
Player#2839: posts big blind $0.10
*** HOLE CARDS ***
Dealt to warioman [Ts 5h]
warioman: folds
Player#9434: folds
Player#9963: folds
Player#8985: calls $0.05
Player#2839: raises $0.10 to $0.3
Player#8985: calls $0.20
*** FLOP *** [3h Th 3c]
Player#8985: checks
Player#2839: bets $0.30
Player#8985: folds
Player#2839: doesn't show hand
Uncalled bet ($0.30) returned to Player#2839
Player#2839 collected $0.57 from pot
*** SUMMARY ***
Total Pot $0.60 | Rake $0.03
Board [3h Th 3c]
Seat 1: Player#8985 (small blind) folded on the flop
Seat 2: Player#2839 shows [] and won ($0.57) with 
Seat 3: warioman folded before the flop
Seat 4: Player#9434 folded before the flop
Seat 5: Player#9963 folded before the flop

PokerStars Hand #c726cad4-5d04-49e1-946b-f18ef0e61eaf:  Hold'em No Limit ($0.1/$0.20 USD) - 2021/11/20 11:27:00 ET
Table 'Bel Air' 6-max Seat #2 is the button
Seat 1: Player#9484 ($31.71 in chips)
Seat 2: Player#7967 ($25.68 in chips)
Seat 3: warioman ($44.53 in chips)
Seat 4: Player#5421 ($25.37 in chips)
Seat 5: Player#1264 ($23.05 in chips)
warioman: posts small blind $0.10
Player#5421: posts big blind $0.20
*** HOLE CARDS ***
Dealt to warioman [Ad Kd]
Player#1264: folds
Player#9484: raises $0.20 to $0.6
Player#7967: raises0.60 to $1
warioman: raises1.00 to $4
Player#5421: folds
Player#9484: folds
Player#7967: raises $ 24.00 to $25.68
warioman: calls $21.68
warioman Showing Pocket Cards AK
Player#7967 Showing Pocket Cards JJ
*** FLOP *** [Qd 3d 6s]
*** TURN *** [Qd 3d 6s] [5d]
*** RIVER *** [Qd 3d 6s] [5d] [8h]
Player#7967 collected $50.66 from pot
*** SUMMARY ***
Total Pot $52.16 | Rake $1.50
Board [Qd 3d 6s 5d 8h]
Seat 1: Player#9484 folded before the flop
Seat 2: Player#7967 shows [Js Jc] and won ($50.66) with 
Seat 3: warioman (small blind)
Seat 4: Player#5421 (big blind) folded before the flop
Seat 5: Player#1264 folded before the flop

PokerStars Hand #fdc1504d-9c0b-4fd0-b756-44033786c448:  Hold'em No Limit ($0.1/$0.20 USD) - 2021/11/20 11:27:00 ET
Table 'Bel Air' 6-max Seat #1 is the button
Seat 1: Player#4443 ($31.71 in chips)
Seat 2: Player#6113 ($25.78 in chips)
Seat 3: warioman ($44.43 in chips)
Seat 4: Player#1789 ($25.37 in chips)
Seat 5: Player#8379 ($23.05 in chips)
Player#6113: posts small blind $0.10
warioman: posts big blind $0.20
*** HOLE CARDS ***
Dealt to warioman [8d 3c]
Player#1789: folds
Player#8379: folds
Player#4443: folds
Player#6113: folds
warioman collected $0.20 from pot
*** SUMMARY ***
Total Pot $0.20 | Rake $0.00
Seat 1: Player#4443 (button) folded before the flop
Seat 2: Player#6113 (small blind) folded before the flop
Seat 3: warioman (big blind)
Seat 4: Player#1789 folded before the flop
Seat 5: Player#8379 folded before the flop

PokerStars Hand #c8eac1de-ab63-4e81-8df0-4799f39c1a5e:  Hold'em No Limit ($0.1/$0.20 USD) - 2021/11/20 11:27:00 ET
Table 'Bethlehem' 6-max Seat #4 is the button
Seat 1: Player#0702 ($22.99 in chips)
Seat 2: Player#9336 ($21.76 in chips)
Seat 3: Player#7996 ($20.18 in chips)
Seat 4: Player#6714 ($32.65 in chips)
Seat 5: Player#2569 ($19.50 in chips)
Seat 6: warioman ($24.09 in chips)
Player#2569: posts small blind $0.10
warioman: posts big blind $0.20
*** HOLE CARDS ***
Dealt to warioman [Js 2s]
Player#0702: folds
Player#9336: folds
Player#7996: raises $0.20 to $0.4
Player#6714: raises $0.40 to $1.9
Player#2569: folds
warioman: folds
Player#7996: folds
Player#6714: doesn't show hand
Uncalled bet ($1.90) returned to Player#6714
Player#6714 collected $0.70 from pot
*** SUMMARY ***
Total Pot $0.70 | Rake $0.00
Seat 1: Player#0702 folded before the flop
Seat 2: Player#9336 folded before the flop
Seat 3: Player#7996 folded before the flop
Seat 4: Player#6714 shows [] and won ($0.70) with 
Seat 5: Player#2569 (small blind) folded before the flop
Seat 6: warioman (big blind) folded before the flop

PokerStars Hand #c0dd5535-c36a-4d1a-8b44-9ade991e4f12:  Hold'em No Limit ($0.1/$0.20 USD) - 2021/11/20 11:27:00 ET
Table 'Bel Air' 6-max Seat #6 is the button
Seat 1: Player#9073 ($31.81 in chips)
Seat 2: Player#5968 ($25.98 in chips)
Seat 3: warioman ($44.43 in chips)
Seat 4: Player#0278 ($25.07 in chips)
Seat 5: Player#1958 ($23.05 in chips)
Player#9073: posts small blind $0.10
Player#5968: posts big blind $0.20
*** HOLE CARDS ***
Dealt to warioman [Kd 2h]
warioman: folds
Player#0278: raises $0.20 to $0.6
Player#1958: folds
Player#9073: folds
Player#5968: folds
Player#0278: doesn't show hand
Uncalled bet ($0.60) returned to Player#0278
Player#0278 collected $0.30 from pot
*** SUMMARY ***
Total Pot $0.30 | Rake $0.00
Seat 1: Player#9073 (small blind) folded before the flop
Seat 2: Player#5968 (big blind) folded before the flop
Seat 3: warioman folded before the flop
Seat 4: Player#0278 shows [] and won ($0.30) with 
Seat 5: Player#1958 folded before the flop

PokerStars Hand #3bb52645-4565-484f-9b32-940e768ee1eb:  Hold'em No Limit ($0.1/$0.20 USD) - 2021/11/20 11:27:00 ET
Table 'Bel Air' 6-max Seat #4 is the button
Seat 1: Player#1711 ($32.01 in chips)
Seat 2: Player#4988 ($25.98 in chips)
Seat 3: warioman ($44.43 in chips)
Seat 4: Player#2736 ($24.77 in chips)
Seat 5: Player#0062 ($23.15 in chips)
Player#0062: posts small blind $0.10
Player#1711: posts big blind $0.20
*** HOLE CARDS ***
Dealt to warioman [Ts 5s]
Player#4988: folds
warioman: folds
Player#2736: raises $0.20 to $0.6
Player#0062: folds
Player#1711: folds
Player#2736: doesn't show hand
Uncalled bet ($0.60) returned to Player#2736
Player#2736 collected $0.30 from pot
*** SUMMARY ***
Total Pot $0.30 | Rake $0.00
Seat 1: Player#1711 (big blind) folded before the flop
Seat 2: Player#4988 folded before the flop
Seat 3: warioman folded before the flop
Seat 4: Player#2736 shows [] and won ($0.30) with 
Seat 5: Player#0062 (small blind) folded before the flop

PokerStars Hand #69476490-4464-43ad-9a9e-23e93fcb5fdf:  Hold'em No Limit ($0.05/$0.10 USD) - 2021/11/20 11:26:00 ET
Table 'Aberdeen' 6-max Seat #1 is the button
Seat 1: Player#1563 ($9.04 in chips)
Seat 2: Player#9037 ($10.00 in chips)
Seat 3: warioman ($19.00 in chips)
Seat 4: Player#4262 ($6.52 in chips)
Seat 5: Player#4659 ($13.83 in chips)
Seat 6: Player#2264 ($9.40 in chips)
Player#9037: posts small blind $0.05
Player#2264: posts big blind $0.10
*** HOLE CARDS ***
Dealt to warioman [3h Qh]
Player#9037 Waiting
warioman: folds
Player#4262: calls $0.10
Player#4659: calls $0.10
Player#2264: calls $0.05
Player#1563: checks
*** FLOP *** [Qs Qd Ks]
Player#2264: checks
Player#1563: checks
Player#4262: checks
Player#4659: bets $0.30
Player#2264: raises $0.30 to $9.3
Player#1563: folds
Player#4262: folds
Player#4659: folds
Player#2264: doesn't show hand
Uncalled bet ($9.30) returned to Player#2264
Player#2264 collected $0.66 from pot
*** SUMMARY ***
Total Pot $0.70 | Rake $0.03
Board [Qs Qd Ks]
Seat 1: Player#1563 (button) folded on the flop
Seat 2: Player#9037 (small blind) mucked
Seat 3: warioman folded before the flop
Seat 4: Player#4262 folded on the flop
Seat 5: Player#4659 folded on the flop
Seat 6: Player#2264 shows [] and won ($0.66) with 

PokerStars Hand #d773e90c-9f64-4056-bcb3-85dc3096ae52:  Hold'em No Limit ($0.1/$0.20 USD) - 2021/11/20 11:26:00 ET
Table 'Bethlehem' 6-max Seat #3 is the button
Seat 1: Player#7635 ($23.69 in chips)
Seat 2: Player#6116 ($20.84 in chips)
Seat 3: Player#1293 ($20.18 in chips)
Seat 4: Player#4388 ($32.75 in chips)
Seat 5: Player#2778 ($19.70 in chips)
Seat 6: warioman ($24.09 in chips)
Player#4388: posts small blind $0.10
Player#2778: posts big blind $0.20
*** HOLE CARDS ***
Dealt to warioman [6c 2h]
warioman: folds
Player#7635: raises $0.20 to $0.7
Player#6116: calls $0.70
Player#1293: folds
Player#4388: folds
Player#2778: folds
*** FLOP *** [Ts 5d 6d]
Player#7635: checks
Player#6116: checks
*** TURN *** [Ts 5d 6d] [2s]
Player#7635: checks
Player#6116: checks
*** RIVER *** [Ts 5d 6d] [2s] [Ts]
Player#7635: checks
Player#6116: bets $0.85
Player#7635: folds
Player#6116: doesn't show hand
Uncalled bet ($0.85) returned to Player#6116
Player#6116 collected $1.61 from pot
*** SUMMARY ***
Total Pot $1.70 | Rake $0.08
Board [Ts 5d 6d 2s Ts]
Seat 1: Player#7635 folded on the river
Seat 2: Player#6116 shows [] and won ($1.61) with 
Seat 3: Player#1293 (button) folded before the flop
Seat 4: Player#4388 (small blind) folded before the flop
Seat 5: Player#2778 (big blind) folded before the flop
Seat 6: warioman folded before the flop

PokerStars Hand #b15c7e02-59aa-4c7e-87f3-faf6e144d271:  Hold'em No Limit ($0.1/$0.20 USD) - 2021/11/20 11:26:00 ET
Table 'Bel Air' 6-max Seat #3 is the button
Seat 1: Player#7960 ($32.01 in chips)
Seat 2: Player#4655 ($25.98 in chips)
Seat 3: warioman ($44.43 in chips)
Seat 4: Player#5931 ($24.87 in chips)
Seat 5: Player#1524 ($23.05 in chips)
Player#5931: posts small blind $0.10
Player#1524: posts big blind $0.20
*** HOLE CARDS ***
Dealt to warioman [9s 4h]
Player#7960: folds
Player#4655: folds
warioman: folds
Player#5931: folds
Player#1524 collected $0.20 from pot
*** SUMMARY ***
Total Pot $0.20 | Rake $0.00
Seat 1: Player#7960 folded before the flop
Seat 2: Player#4655 folded before the flop
Seat 3: warioman (button) folded before the flop
Seat 4: Player#5931 (small blind) folded before the flop
Seat 5: Player#1524 shows [] and won ($0.20) with 

PokerStars Hand #bf8bef75-de03-4709-bd1c-9352ce9f4eeb:  Hold'em No Limit ($0.1/$0.20 USD) - 2021/11/20 11:26:00 ET
Table 'Bel Air' 6-max Seat #2 is the button
Seat 1: Player#4222 ($32.01 in chips)
Seat 2: Player#0405 ($26.18 in chips)
Seat 3: warioman ($44.03 in chips)
Seat 4: Player#3462 ($20.51 in chips)
Seat 5: Player#2020 ($25.07 in chips)
Seat 6: Player#7290 ($23.05 in chips)
warioman: posts small blind $0.10
Player#2020: posts big blind $0.20
*** HOLE CARDS ***
Dealt to warioman [Ah Qs]
Player#3462 Decline Entry Bet
Player#7290: folds
Player#4222: folds
Player#0405: calls $0.20
warioman: raises $0.20 to $1.2
Player#2020: folds
Player#0405: folds
warioman: doesn't show hand
Uncalled bet ($1.20) returned to warioman
warioman collected $0.40 from pot
*** SUMMARY ***
Total Pot $0.40 | Rake $0.00
Seat 1: Player#4222 folded before the flop
Seat 2: Player#0405 (button) folded before the flop
Seat 3: warioman (small blind)
Seat 4: Player#3462 mucked
Seat 5: Player#2020 (big blind) folded before the flop
Seat 6: Player#7290 folded before the flop

PokerStars Hand #9797060d-0b8b-4cb5-bd23-a81bab489020:  Hold'em No Limit ($0.05/$0.10 USD) - 2021/11/20 11:26:00 ET
Table 'Aberdeen' 6-max Seat #1 is the button
Seat 1: Player#3549 ($9.04 in chips)
Seat 2: Player#4449 ($10.00 in chips)
Seat 3: warioman ($19.00 in chips)
Seat 4: Player#3338 ($7.37 in chips)
Seat 5: Player#5748 ($12.97 in chips)
Seat 6: Player#1071 ($9.50 in chips)
Player#4449: posts small blind $0.05
Player#5748: posts big blind $0.10
*** HOLE CARDS ***
Dealt to warioman [Qd 3s]
Player#4449 Waiting
Player#3549: folds
warioman: folds
Player#3338: calls $0.10
Player#5748: raises $0.10 to $0.4
Player#1071: folds
Player#3338: calls $0.30
*** FLOP *** [3c Qc Qh]
Player#5748: bets $0.45
Player#3338: calls $0.45
*** TURN *** [3c Qc Qh] [Kd]
Player#5748: checks
Player#3338: checks
*** RIVER *** [3c Qc Qh] [Kd] [2d]
Player#5748: checks
Player#3338: checks
*** SHOW DOWN *** 
Player#5748 collected $1.71 from pot
*** SUMMARY ***
Total Pot $1.80 | Rake $0.09
Board [3c Qc Qh Kd 2d]
Seat 1: Player#3549 (button) folded before the flop
Seat 2: Player#4449 (small blind) mucked
Seat 3: warioman folded before the flop
Seat 4: Player#3338 mucked
Seat 5: Player#5748 shows [Tc Ts] and won ($1.71) with 
Seat 6: Player#1071 folded before the flop

PokerStars Hand #9c00e7b7-2bea-4ec8-a4db-463422a39419:  Hold'em No Limit ($0.1/$0.20 USD) - 2021/11/20 11:26:00 ET
Table 'Bel Air' 6-max Seat #1 is the button
Seat 1: Player#4298 ($32.01 in chips)
Seat 2: Player#5862 ($26.28 in chips)
Seat 3: warioman ($44.23 in chips)
Seat 4: Player#1788 ($20.51 in chips)
Seat 5: Player#6569 ($25.67 in chips)
Seat 6: Player#3988 ($22.15 in chips)
Player#5862: posts small blind $0.10
warioman: posts big blind $0.20
*** HOLE CARDS ***
Dealt to warioman [Kd Qd]
Player#1788: folds
Player#6569: raises $0.20 to $0.6
Player#3988: raises $0.60 to $2.1
Player#4298: folds
Player#5862: folds
warioman: folds
Player#6569: folds
Player#3988: doesn't show hand
Uncalled bet ($2.10) returned to Player#3988
Player#3988 collected $0.90 from pot
*** SUMMARY ***
Total Pot $0.90 | Rake $0.00
Seat 1: Player#4298 (button) folded before the flop
Seat 2: Player#5862 (small blind) folded before the flop
Seat 3: warioman (big blind) folded before the flop
Seat 4: Player#1788 folded before the flop
Seat 5: Player#6569 folded before the flop
Seat 6: Player#3988 shows [] and won ($0.90) with 

PokerStars Hand #6ce74f93-f2df-48a1-893e-cd5a6495ca62:  Hold'em No Limit ($0.1/$0.20 USD) - 2021/11/20 11:26:00 ET
Table 'Bel Air' 6-max Seat #6 is the button
Seat 1: Player#3675 ($32.11 in chips)
Seat 2: Player#4607 ($26.18 in chips)
Seat 3: warioman ($44.23 in chips)
Seat 4: Player#3004 ($20.51 in chips)
Seat 5: Player#7963 ($25.67 in chips)
Seat 6: Player#7969 ($22.15 in chips)
Player#3675: posts small blind $0.10
Player#4607: posts big blind $0.20
*** HOLE CARDS ***
Dealt to warioman [7h Ad]
warioman: folds
Player#3004: folds
Player#7963: folds
Player#7969: folds
Player#3675: folds
Player#4607 collected $0.20 from pot
*** SUMMARY ***
Total Pot $0.20 | Rake $0.00
Seat 1: Player#3675 (small blind) folded before the flop
Seat 2: Player#4607 shows [] and won ($0.20) with 
Seat 3: warioman folded before the flop
Seat 4: Player#3004 folded before the flop
Seat 5: Player#7963 folded before the flop
Seat 6: Player#7969 (button) folded before the flop

PokerStars Hand #ee47ef7a-ede6-4b10-bdc5-bd295dc427f7:  Hold'em No Limit ($0.1/$0.20 USD) - 2021/11/20 11:25:00 ET
Table 'Bethlehem' 6-max Seat #2 is the button
Seat 1: Player#3715 ($22.60 in chips)
Seat 2: Player#3857 ($20.84 in chips)
Seat 3: Player#0984 ($20.28 in chips)
Seat 4: Player#9755 ($32.95 in chips)
Seat 5: Player#1079 ($19.70 in chips)
Seat 6: warioman ($24.98 in chips)
Player#0984: posts small blind $0.10
Player#9755: posts big blind $0.20
*** HOLE CARDS ***
Dealt to warioman [5s As]
Player#1079: folds
warioman: raises $0.20 to $0.5
Player#3715: calls $0.50
Player#3857: folds
Player#0984: folds
Player#9755: folds
*** FLOP *** [Qd 3h Kh]
warioman: bets $0.39
Player#3715: raises $0.39 to $1.85
warioman: folds
Player#3715: doesn't show hand
Uncalled bet ($1.85) returned to Player#3715
Player#3715 collected $1.61 from pot
*** SUMMARY ***
Total Pot $1.69 | Rake $0.08
Board [Qd 3h Kh]
Seat 1: Player#3715 shows [] and won ($1.61) with 
Seat 2: Player#3857 (button) folded before the flop
Seat 3: Player#0984 (small blind) folded before the flop
Seat 4: Player#9755 (big blind) folded before the flop
Seat 5: Player#1079 folded before the flop
Seat 6: warioman folded on the flop

PokerStars Hand #ccee02a6-8b2a-441c-a5ef-993a807f57c2:  Hold'em No Limit ($0.1/$0.20 USD) - 2021/11/20 11:25:00 ET
Table 'Bethlehem' 6-max Seat #1 is the button
Seat 1: Player#7384 ($22.60 in chips)
Seat 2: Player#2396 ($20.94 in chips)
Seat 3: Player#5251 ($20.18 in chips)
Seat 4: Player#3266 ($32.95 in chips)
Seat 5: Player#1534 ($19.70 in chips)
Seat 6: warioman ($24.98 in chips)
Player#2396: posts small blind $0.10
Player#5251: posts big blind $0.20
*** HOLE CARDS ***
Dealt to warioman [4c 3h]
Player#3266: folds
Player#1534: folds
warioman: folds
Player#7384: folds
Player#2396: folds
Player#5251 collected $0.20 from pot
*** SUMMARY ***
Total Pot $0.20 | Rake $0.00
Seat 1: Player#7384 (button) folded before the flop
Seat 2: Player#2396 (small blind) folded before the flop
Seat 3: Player#5251 shows [] and won ($0.20) with 
Seat 4: Player#3266 folded before the flop
Seat 5: Player#1534 folded before the flop
Seat 6: warioman folded before the flop

PokerStars Hand #ecea5756-d04b-46a5-ba0b-d814be90af9e:  Hold'em No Limit ($0.05/$0.10 USD) - 2021/11/20 11:25:00 ET
Table 'Aberdeen' 6-max Seat #2 is the button
Seat 1: Player#7366 ($9.34 in chips)
Seat 2: warioman ($19.00 in chips)
Seat 3: Player#0622 ($10.82 in chips)
Seat 4: Player#9152 ($9.58 in chips)
Seat 5: Player#2019 ($9.50 in chips)
Player#0622: posts small blind $0.05
Player#9152: posts big blind $0.10
*** HOLE CARDS ***
Dealt to warioman [3s 7d]
Player#2019: folds
Player#7366: raises $0.10 to $0.3
warioman: folds
Player#0622: calls $0.25
Player#9152: calls $0.20
*** FLOP *** [8d 6d 5c]
Player#0622: bets $0.45
Player#9152: calls $0.45
Player#7366: folds
*** TURN *** [8d 6d 5c] [6h]
Player#0622: bets $0.90
Player#9152: calls $0.90
*** RIVER *** [8d 6d 5c] [6h] [5h]
Player#0622: bets $1.80
Player#9152: calls $1.80
*** SHOW DOWN *** 
Player#9152 collected $6.84 from pot
*** SUMMARY ***
Total Pot $7.20 | Rake $0.36
Board [8d 6d 5c 6h 5h]
Seat 1: Player#7366 folded on the flop
Seat 2: warioman (button) folded before the flop
Seat 3: Player#0622 (small blind) mucked
Seat 4: Player#9152 shows [Jh 8s] and won ($6.84) with 
Seat 5: Player#2019 folded before the flop

PokerStars Hand #bd4a17b7-275e-4b6e-908a-a0e3e29204f0:  Hold'em No Limit ($0.1/$0.20 USD) - 2021/11/20 11:25:00 ET
Table 'Bel Air' 6-max Seat #5 is the button
Seat 1: Player#8229 ($32.31 in chips)
Seat 2: Player#0715 ($29.43 in chips)
Seat 3: warioman ($44.23 in chips)
Seat 4: Player#8528 ($17.30 in chips)
Seat 5: Player#6786 ($25.67 in chips)
Seat 6: Player#9469 ($22.25 in chips)
Player#9469: posts small blind $0.10
Player#8229: posts big blind $0.20
*** HOLE CARDS ***
Dealt to warioman [8s Kh]
Player#0715: raises $0.20 to $0.7
warioman: folds
Player#8528: calls $0.70
Player#6786: folds
Player#9469: folds
Player#8229: folds
*** FLOP *** [Jh 6s 3c]
Player#0715: checks
Player#8528: checks
*** TURN *** [Jh 6s 3c] [6h]
Player#0715: bets $0.85
Player#8528: calls $0.85
*** RIVER *** [Jh 6s 3c] [6h] [Jh]
Player#0715: bets $1.70
Player#8528: calls $1.70
*** SHOW DOWN *** 
Player#8528 collected $6.46 from pot
*** SUMMARY ***
Total Pot $6.80 | Rake $0.34
Board [Jh 6s 3c 6h Jh]
Seat 1: Player#8229 (big blind) folded before the flop
Seat 2: Player#0715 mucked
Seat 3: warioman folded before the flop
Seat 4: Player#8528 shows [Ah Th] and won ($6.46) with 
Seat 5: Player#6786 (button) folded before the flop
Seat 6: Player#9469 (small blind) folded before the flop

PokerStars Hand #08c48455-8258-4826-aeb9-cdd18f9ac0d5:  Hold'em No Limit ($0.1/$0.20 USD) - 2021/11/20 11:25:00 ET
Table 'Bethlehem' 6-max Seat #6 is the button
Seat 1: Player#8495 ($22.70 in chips)
Seat 2: Player#8783 ($20.84 in chips)
Seat 3: Player#8414 ($20.18 in chips)
Seat 4: Player#4912 ($32.95 in chips)
Seat 5: Player#9574 ($19.70 in chips)
Seat 6: warioman ($24.98 in chips)
Player#8495: posts small blind $0.10
Player#8783: posts big blind $0.20
*** HOLE CARDS ***
Dealt to warioman [9d Jc]
Player#8414: folds
Player#4912: folds
Player#9574: folds
warioman: folds
Player#8495: folds
Player#8783 collected $0.20 from pot
*** SUMMARY ***
Total Pot $0.20 | Rake $0.00
Seat 1: Player#8495 (small blind) folded before the flop
Seat 2: Player#8783 shows [] and won ($0.20) with 
Seat 3: Player#8414 folded before the flop
Seat 4: Player#4912 folded before the flop
Seat 5: Player#9574 folded before the flop
Seat 6: warioman (button) folded before the flop

PokerStars Hand #93c4a34f-8075-4a41-8b03-0315b58a04cf:  Hold'em No Limit ($0.05/$0.10 USD) - 2021/11/20 11:25:00 ET
Table 'Aberdeen' 6-max Seat #1 is the button
Seat 1: Player#4886 ($9.34 in chips)
Seat 2: warioman ($18.91 in chips)
Seat 3: Player#3575 ($10.92 in chips)
Seat 4: Player#3339 ($9.58 in chips)
Seat 5: Player#1236 ($9.50 in chips)
warioman: posts small blind $0.05
Player#3575: posts big blind $0.10
*** HOLE CARDS ***
Dealt to warioman [Ts Qc]
Player#3339: folds
Player#1236: folds
Player#4886: folds
warioman: calls $0.05
Player#3575: checks
*** FLOP *** [Qs Tc 6c]
warioman: checks
Player#3575: checks
*** TURN *** [Qs Tc 6c] [4h]
warioman: bets $0.20
Player#3575: folds
warioman: doesn't show hand
Uncalled bet ($0.20) returned to warioman
warioman collected $0.19 from pot
*** SUMMARY ***
Total Pot $0.20 | Rake $0.01
Board [Qs Tc 6c 4h]
Seat 1: Player#4886 (button) folded before the flop
Seat 2: warioman (small blind)
Seat 3: Player#3575 (big blind) folded on the turn
Seat 4: Player#3339 folded before the flop
Seat 5: Player#1236 folded before the flop

PokerStars Hand #8eb5cf18-9d21-42d0-aea4-a3728a124cfa:  Hold'em No Limit ($0.1/$0.20 USD) - 2021/11/20 11:25:00 ET
Table 'Bel Air' 6-max Seat #4 is the button
Seat 1: Player#5469 ($32.31 in chips)
Seat 2: Player#0828 ($30.33 in chips)
Seat 3: warioman ($43.13 in chips)
Seat 4: Player#1104 ($17.30 in chips)
Seat 5: Player#4089 ($25.77 in chips)
Seat 6: Player#9834 ($22.45 in chips)
Player#4089: posts small blind $0.10
Player#9834: posts big blind $0.20
*** HOLE CARDS ***
Dealt to warioman [Kh Th]
Player#5469: folds
Player#0828: calls $0.20
warioman: raises $0.20 to $0.9
Player#1104: folds
Player#4089: folds
Player#9834: folds
Player#0828: calls $0.70
*** FLOP *** [Kd 8c 8h]
Player#0828: checks
warioman: bets $0.63
Player#0828: folds
warioman: doesn't show hand
Uncalled bet ($0.63) returned to warioman
warioman collected $2.00 from pot
*** SUMMARY ***
Total Pot $2.10 | Rake $0.11
Board [Kd 8c 8h]
Seat 1: Player#5469 folded before the flop
Seat 2: Player#0828 folded on the flop
Seat 3: warioman
Seat 4: Player#1104 (button) folded before the flop
Seat 5: Player#4089 (small blind) folded before the flop
Seat 6: Player#9834 (big blind) folded before the flop

PokerStars Hand #dd6fc9ec-7873-453e-a996-2816976d28f3:  Hold'em No Limit ($0.1/$0.20 USD) - 2021/11/20 11:25:00 ET
Table 'Bel Air' 6-max Seat #3 is the button
Seat 1: Player#6827 ($32.31 in chips)
Seat 2: Player#0427 ($30.33 in chips)
Seat 3: warioman ($43.13 in chips)
Seat 4: Player#8418 ($17.40 in chips)
Seat 5: Player#0346 ($25.67 in chips)
Seat 6: Player#8612 ($22.45 in chips)
Player#8418: posts small blind $0.10
Player#0346: posts big blind $0.20
*** HOLE CARDS ***
Dealt to warioman [9d Jh]
Player#8612: folds
Player#6827: folds
Player#0427: folds
warioman: folds
Player#8418: folds
Player#0346 collected $0.20 from pot
*** SUMMARY ***
Total Pot $0.20 | Rake $0.00
Seat 1: Player#6827 folded before the flop
Seat 2: Player#0427 folded before the flop
Seat 3: warioman (button) folded before the flop
Seat 4: Player#8418 (small blind) folded before the flop
Seat 5: Player#0346 shows [] and won ($0.20) with 
Seat 6: Player#8612 folded before the flop

PokerStars Hand #1852845f-0562-4e32-8f27-d1b914b01366:  Hold'em No Limit ($0.1/$0.20 USD) - 2021/11/20 11:24:00 ET
Table 'Bethlehem' 6-max Seat #5 is the button
Seat 1: Player#2339 ($22.90 in chips)
Seat 2: Player#9932 ($20.84 in chips)
Seat 3: Player#9899 ($19.90 in chips)
Seat 4: Player#5163 ($32.95 in chips)
Seat 5: Player#1743 ($19.70 in chips)
Seat 6: warioman ($25.08 in chips)
warioman: posts small blind $0.10
Player#2339: posts big blind $0.20
*** HOLE CARDS ***
Dealt to warioman [8c 4s]
Player#9932: folds
Player#9899: calls $0.20
Player#5163: folds
Player#1743: folds
warioman: folds
Player#2339: checks
*** FLOP *** [Kc Qc Ah]
Player#2339: checks
Player#9899: bets $0.20
Player#2339: folds
Player#9899: doesn't show hand
Uncalled bet ($0.20) returned to Player#9899
Player#9899 collected $0.47 from pot
*** SUMMARY ***
Total Pot $0.50 | Rake $0.02
Board [Kc Qc Ah]
Seat 1: Player#2339 (big blind) folded on the flop
Seat 2: Player#9932 folded before the flop
Seat 3: Player#9899 shows [] and won ($0.47) with 
Seat 4: Player#5163 folded before the flop
Seat 5: Player#1743 (button) folded before the flop
Seat 6: warioman (small blind) folded before the flop

PokerStars Hand #e76fe08f-cfa2-4391-b274-906333ae9f96:  Hold'em No Limit ($0.1/$0.20 USD) - 2021/11/20 11:24:00 ET
Table 'Bel Air' 6-max Seat #2 is the button
Seat 1: Player#9748 ($32.31 in chips)
Seat 2: Player#2132 ($30.33 in chips)
Seat 3: warioman ($43.23 in chips)
Seat 4: Player#3132 ($17.60 in chips)
Seat 5: Player#7506 ($26.37 in chips)
Seat 6: Player#6810 ($21.45 in chips)
warioman: posts small blind $0.10
Player#3132: posts big blind $0.20
*** HOLE CARDS ***
Dealt to warioman [Th Qd]
Player#7506: raises $0.20 to $0.7
Player#6810: raises $0.70 to $2.4
Player#9748: folds
Player#2132: folds
warioman: folds
Player#3132: folds
Player#7506: folds
Player#6810: doesn't show hand
Uncalled bet ($2.40) returned to Player#6810
Player#6810 collected $1.00 from pot
*** SUMMARY ***
Total Pot $1.00 | Rake $0.00
Seat 1: Player#9748 folded before the flop
Seat 2: Player#2132 (button) folded before the flop
Seat 3: warioman (small blind) folded before the flop
Seat 4: Player#3132 (big blind) folded before the flop
Seat 5: Player#7506 folded before the flop
Seat 6: Player#6810 shows [] and won ($1.00) with 

PokerStars Hand #c982578e-dfac-4ad8-8f63-b13bd1111d20:  Hold'em No Limit ($0.1/$0.20 USD) - 2021/11/20 11:24:00 ET
Table 'Bethlehem' 6-max Seat #4 is the button
Seat 1: Player#6833 ($22.90 in chips)
Seat 2: Player#8073 ($20.84 in chips)
Seat 3: Player#3268 ($19.90 in chips)
Seat 4: Player#9476 ($32.95 in chips)
Seat 5: Player#6062 ($19.80 in chips)
Seat 6: warioman ($24.98 in chips)
Player#6062: posts small blind $0.10
warioman: posts big blind $0.20
*** HOLE CARDS ***
Dealt to warioman [7h 8c]
Player#6833: folds
Player#8073: folds
Player#3268: folds
Player#9476: folds
Player#6062: folds
warioman collected $0.20 from pot
*** SUMMARY ***
Total Pot $0.20 | Rake $0.00
Seat 1: Player#6833 folded before the flop
Seat 2: Player#8073 folded before the flop
Seat 3: Player#3268 folded before the flop
Seat 4: Player#9476 (button) folded before the flop
Seat 5: Player#6062 (small blind) folded before the flop
Seat 6: warioman (big blind)

PokerStars Hand #ff6b8244-38a1-4da1-95c6-7bb8779a6190:  Hold'em No Limit ($0.1/$0.20 USD) - 2021/11/20 11:24:00 ET
Table 'Bel Air' 6-max Seat #1 is the button
Seat 1: Player#7407 ($32.31 in chips)
Seat 2: Player#6895 ($30.15 in chips)
Seat 3: warioman ($43.43 in chips)
Seat 4: Player#7999 ($17.60 in chips)
Seat 5: Player#7103 ($26.37 in chips)
Seat 6: Player#0295 ($21.45 in chips)
Player#6895: posts small blind $0.10
warioman: posts big blind $0.20
*** HOLE CARDS ***
Dealt to warioman [Td 2d]
Player#7999: folds
Player#7103: folds
Player#0295: folds
Player#7407: folds
Player#6895: calls $0.10
warioman: checks
*** FLOP *** [5c Tc Qd]
Player#6895: bets $0.40
warioman: folds
Player#6895: doesn't show hand
Uncalled bet ($0.40) returned to Player#6895
Player#6895 collected $0.38 from pot
*** SUMMARY ***
Total Pot $0.40 | Rake $0.02
Board [5c Tc Qd]
Seat 1: Player#7407 (button) folded before the flop
Seat 2: Player#6895 shows [] and won ($0.38) with 
Seat 3: warioman (big blind) folded on the flop
Seat 4: Player#7999 folded before the flop
Seat 5: Player#7103 folded before the flop
Seat 6: Player#0295 folded before the flop

PokerStars Hand #baf7112e-6283-47ce-8223-d305f5e597c4:  Hold'em No Limit ($0.05/$0.10 USD) - 2021/11/20 11:24:00 ET
Table 'Aberdeen' 6-max Seat #1 is the button
Seat 1: Player#2835 ($9.34 in chips)
Seat 2: Player#1568 ($13.05 in chips)
Seat 3: warioman ($19.01 in chips)
Seat 4: Player#3723 ($10.00 in chips)
Seat 5: Player#1512 ($10.18 in chips)
Seat 6: Player#1318 ($9.50 in chips)
Player#1568: posts small blind $0.05
warioman: posts big blind $0.10
*** HOLE CARDS ***
Dealt to warioman [5d Th]
Player#3723: calls $0.10
Player#1512: calls $0.10
Player#1318: folds
Player#2835: folds
Player#1568: calls $0.05
warioman: checks
*** FLOP *** [Jd Tc Ad]
Player#1568: checks
warioman: checks
Player#3723: checks
Player#1512: bets $0.20
Player#1568: calls $0.20
warioman: folds
Player#3723: calls $0.20
*** TURN *** [Jd Tc Ad] [9c]
Player#1568: checks
Player#3723: checks
Player#1512: bets $0.30
Player#1568: folds
Player#3723: calls $0.30
*** RIVER *** [Jd Tc Ad] [9c] [3c]
Player#3723: bets $9.40
Player#1512: folds
Player#3723: doesn't show hand
Uncalled bet ($9.40) returned to Player#3723
Player#3723 collected $1.52 from pot
*** SUMMARY ***
Total Pot $1.60 | Rake $0.08
Board [Jd Tc Ad 9c 3c]
Seat 1: Player#2835 (button) folded before the flop
Seat 2: Player#1568 (small blind) folded on the turn
Seat 3: warioman (big blind) folded on the flop
Seat 4: Player#3723 shows [] and won ($1.52) with 
Seat 5: Player#1512 folded on the river
Seat 6: Player#1318 folded before the flop

PokerStars Hand #e12573f6-d1e0-4f35-8214-68e1752d431d:  Hold'em No Limit ($0.1/$0.20 USD) - 2021/11/20 11:24:00 ET
Table 'Bethlehem' 6-max Seat #3 is the button
Seat 1: Player#5128 ($22.90 in chips)
Seat 2: Player#5875 ($20.84 in chips)
Seat 3: Player#9177 ($19.90 in chips)
Seat 4: Player#5756 ($33.45 in chips)
Seat 5: Player#4582 ($20.00 in chips)
Seat 6: warioman ($24.34 in chips)
Player#5756: posts small blind $0.10
Player#4582: posts big blind $0.20
*** HOLE CARDS ***
Dealt to warioman [Jh Ad]
warioman: raises $0.20 to $0.5
Player#5128: folds
Player#5875: folds
Player#9177: folds
Player#5756: calls $0.40
Player#4582: folds
*** FLOP *** [9h Ts Ah]
Player#5756: checks
warioman: bets $0.90
Player#5756: folds
warioman: doesn't show hand
Uncalled bet ($0.90) returned to warioman
warioman collected $1.14 from pot
*** SUMMARY ***
Total Pot $1.20 | Rake $0.06
Board [9h Ts Ah]
Seat 1: Player#5128 folded before the flop
Seat 2: Player#5875 folded before the flop
Seat 3: Player#9177 (button) folded before the flop
Seat 4: Player#5756 (small blind) folded on the flop
Seat 5: Player#4582 (big blind) folded before the flop
Seat 6: warioman

PokerStars Hand #db3326e8-8d94-45c3-8c8d-32f3145fa72e:  Hold'em No Limit ($0.1/$0.20 USD) - 2021/11/20 11:23:00 ET
Table 'Bel Air' 6-max Seat #6 is the button
Seat 1: Player#7426 ($32.41 in chips)
Seat 2: Player#5220 ($29.51 in chips)
Seat 3: warioman ($43.43 in chips)
Seat 4: Player#6526 ($18.20 in chips)
Seat 5: Player#2390 ($26.37 in chips)
Seat 6: Player#7778 ($21.45 in chips)
Player#7426: posts small blind $0.10
Player#5220: posts big blind $0.20
*** HOLE CARDS ***
Dealt to warioman [5h Td]
warioman: folds
Player#6526: raises $0.20 to $0.6
Player#2390: folds
Player#7778: folds
Player#7426: folds
Player#5220: calls $0.40
*** FLOP *** [8h 6c Qc]
Player#5220: checks
Player#6526: checks
*** TURN *** [8h 6c Qc] [9d]
Player#5220: checks
Player#6526: checks
*** RIVER *** [8h 6c Qc] [9d] [Kd]
Player#5220: bets $0.65
Player#6526: folds
Player#5220: doesn't show hand
Uncalled bet ($0.65) returned to Player#5220
Player#5220 collected $1.24 from pot
*** SUMMARY ***
Total Pot $1.30 | Rake $0.07
Board [8h 6c Qc 9d Kd]
Seat 1: Player#7426 (small blind) folded before the flop
Seat 2: Player#5220 shows [] and won ($1.24) with 
Seat 3: warioman folded before the flop
Seat 4: Player#6526 folded on the river
Seat 5: Player#2390 folded before the flop
Seat 6: Player#7778 (button) folded before the flop

PokerStars Hand #f41b6eaa-7283-4cf1-b321-ccc30d11bc10:  Hold'em No Limit ($0.1/$0.20 USD) - 2021/11/20 11:23:00 ET
Table 'Bethlehem' 6-max Seat #4 is the button
Seat 1: Player#7927 ($22.90 in chips)
Seat 2: Player#6490 ($20.84 in chips)
Seat 3: Player#1431 ($19.72 in chips)
Seat 4: Player#9816 ($33.65 in chips)
Seat 5: Player#2084 ($20.00 in chips)
Seat 6: warioman ($24.34 in chips)
Player#2084: posts small blind $0.10
Player#1431: posts big blind $0.20
*** HOLE CARDS ***
Dealt to warioman [6c 3h]
Player#2084 Waiting
warioman: folds
Player#7927: folds
Player#6490: folds
Player#1431: calls $0.10
Player#9816: checks
*** FLOP *** [8s 5d 5h]
Player#1431: checks
Player#9816: checks
*** TURN *** [8s 5d 5h] [Qc]
Player#1431: checks
Player#9816: checks
*** RIVER *** [8s 5d 5h] [Qc] [Jc]
Player#1431: checks
Player#9816: checks
*** SHOW DOWN *** 
Player#1431 collected $0.38 from pot
*** SUMMARY ***
Total Pot $0.40 | Rake $0.02
Board [8s 5d 5h Qc Jc]
Seat 1: Player#7927 folded before the flop
Seat 2: Player#6490 folded before the flop
Seat 3: Player#1431 shows [Th Kd] and won ($0.38) with 
Seat 4: Player#9816 (button) mucked
Seat 5: Player#2084 (small blind) mucked
Seat 6: warioman folded before the flop

PokerStars Hand #d9feb0f1-0a27-421a-b0de-3f81c3f42014:  Hold'em No Limit ($0.05/$0.10 USD) - 2021/11/20 11:23:00 ET
Table 'Aberdeen' 6-max Seat #6 is the button
Seat 1: Player#1879 ($10.24 in chips)
Seat 2: Player#3179 ($13.15 in chips)
Seat 3: warioman ($9.80 in chips)
Seat 4: Player#4126 ($9.17 in chips)
Seat 5: Player#4343 ($10.18 in chips)
Seat 6: Player#9571 ($9.50 in chips)
Player#1879: posts small blind $0.05
Player#3179: posts big blind $0.10
*** HOLE CARDS ***
Dealt to warioman [Js Ks]
warioman: raises $0.10 to $0.5
Player#4126: raises $0.50 to $0.9
Player#4343: folds
Player#9571: folds
Player#1879: calls $0.85
Player#3179: folds
warioman: calls $0.40
*** FLOP *** [3c 6h Kh]
Player#1879: checks
warioman: checks
Player#4126: bets $1.40
Player#1879: folds
warioman: calls $1.40
*** TURN *** [3c 6h Kh] [9d]
warioman: checks
Player#4126: checks
*** RIVER *** [3c 6h Kh] [9d] [4d]
warioman: bets $1.68
Player#4126: raises $1.68 to $6.87
warioman: calls $5.19
*** SHOW DOWN *** 
warioman collected $18.37 from pot
*** SUMMARY ***
Total Pot $19.34 | Rake $0.97
Board [3c 6h Kh 9d 4d]
Seat 1: Player#1879 (small blind) folded on the flop
Seat 2: Player#3179 (big blind) folded before the flop
Seat 3: warioman
Seat 4: Player#4126 mucked
Seat 5: Player#4343 folded before the flop
Seat 6: Player#9571 (button) folded before the flop

PokerStars Hand #9578e3de-1f86-4dea-92b9-8f50946a9c79:  Hold'em No Limit ($0.1/$0.20 USD) - 2021/11/20 11:22:00 ET
Table 'Bel Air' 6-max Seat #5 is the button
Seat 1: Player#2711 ($32.61 in chips)
Seat 2: Player#7852 ($31.61 in chips)
Seat 3: warioman ($41.25 in chips)
Seat 4: Player#1688 ($18.20 in chips)
Seat 5: Player#4908 ($26.37 in chips)
Seat 6: Player#8122 ($21.55 in chips)
Player#8122: posts small blind $0.10
Player#2711: posts big blind $0.20
*** HOLE CARDS ***
Dealt to warioman [9c 9s]
Player#7852: raises $0.20 to $0.6
warioman: raises $0.60 to $2.1
Player#1688: folds
Player#4908: folds
Player#8122: folds
Player#2711: folds
Player#7852: calls $1.50
*** FLOP *** [4h 8c 7h]
Player#7852: checks
warioman: bets $2.15
Player#7852: folds
warioman: doesn't show hand
Uncalled bet ($2.15) returned to warioman
warioman collected $4.28 from pot
*** SUMMARY ***
Total Pot $4.50 | Rake $0.23
Board [4h 8c 7h]
Seat 1: Player#2711 (big blind) folded before the flop
Seat 2: Player#7852 folded on the flop
Seat 3: warioman
Seat 4: Player#1688 folded before the flop
Seat 5: Player#4908 (button) folded before the flop
Seat 6: Player#8122 (small blind) folded before the flop

PokerStars Hand #92b8591e-9d8c-49ed-b953-eaf407490b1c:  Hold'em No Limit ($0.05/$0.10 USD) - 2021/11/20 11:22:00 ET
Table 'Aberdeen' 6-max Seat #4 is the button
Seat 1: Player#1570 ($9.62 in chips)
Seat 2: warioman ($9.80 in chips)
Seat 3: Player#2982 ($9.17 in chips)
Seat 4: Player#2103 ($10.81 in chips)
Seat 5: Player#2187 ($9.55 in chips)
Player#2187: posts small blind $0.05
Player#1570: posts big blind $0.10
*** HOLE CARDS ***
Dealt to warioman [3s Qs]
warioman: folds
Player#2982: folds
Player#2103: raises $0.10 to $0.3
Player#2187: folds
Player#1570: calls $0.20
*** FLOP *** [Jh 6h Ah]
Player#1570: checks
Player#2103: bets $0.33
Player#1570: calls $0.33
*** TURN *** [Jh 6h Ah] [Ks]
Player#1570: checks
Player#2103: checks
*** RIVER *** [Jh 6h Ah] [Ks] [5s]
Player#1570: checks
Player#2103: checks
*** SHOW DOWN *** 
Player#1570 collected $1.24 from pot
*** SUMMARY ***
Total Pot $1.31 | Rake $0.07
Board [Jh 6h Ah Ks 5s]
Seat 1: Player#1570 shows [Jc 5c] and won ($1.24) with 
Seat 2: warioman folded before the flop
Seat 3: Player#2982 folded before the flop
Seat 4: Player#2103 (button) mucked
Seat 5: Player#2187 (small blind) folded before the flop

PokerStars Hand #57fa2dd8-d2b8-4b28-b2a0-2bed8c2e3c3a:  Hold'em No Limit ($0.1/$0.20 USD) - 2021/11/20 11:22:00 ET
Table 'Bethlehem' 6-max Seat #4 is the button
Seat 1: Player#2755 ($22.90 in chips)
Seat 2: Player#1828 ($20.94 in chips)
Seat 3: Player#5824 ($19.08 in chips)
Seat 4: Player#0714 ($34.25 in chips)
Seat 5: Player#5025 ($20.00 in chips)
Seat 6: warioman ($24.34 in chips)
Player#5025: posts small blind $0.10
Player#1828: posts big blind $0.20
*** HOLE CARDS ***
Dealt to warioman [4c 6h]
Player#5025 Waiting
Player#0714: raises $0.20 to $0.4
warioman: folds
Player#2755: folds
Player#1828: folds
Player#5824: calls $0.20
*** FLOP *** [4d 5d 9d]
Player#5824: bets $0.20
Player#0714: calls $0.20
*** TURN *** [4d 5d 9d] [8c]
Player#5824: bets $0.40
Player#0714: folds
Player#5824: doesn't show hand
Uncalled bet ($0.40) returned to Player#5824
Player#5824 collected $1.24 from pot
*** SUMMARY ***
Total Pot $1.30 | Rake $0.07
Board [4d 5d 9d 8c]
Seat 1: Player#2755 folded before the flop
Seat 2: Player#1828 (big blind) folded before the flop
Seat 3: Player#5824 shows [] and won ($1.24) with 
Seat 4: Player#0714 (button) folded on the turn
Seat 5: Player#5025 (small blind) mucked
Seat 6: warioman folded before the flop

PokerStars Hand #28072f6e-8140-4817-8c11-ce02de04a5e3:  Hold'em No Limit ($0.1/$0.20 USD) - 2021/11/20 11:22:00 ET
Table 'Bel Air' 6-max Seat #3 is the button
Seat 1: Player#9963 ($32.61 in chips)
Seat 2: warioman ($41.25 in chips)
Seat 3: Player#6978 ($18.60 in chips)
Seat 4: Player#9101 ($26.47 in chips)
Seat 5: Player#3274 ($21.09 in chips)
Player#9101: posts small blind $0.10
Player#3274: posts big blind $0.20
*** HOLE CARDS ***
Dealt to warioman [6d 2d]
Player#9963: folds
warioman: folds
Player#6978: calls $0.20
Player#9101: folds
Player#3274: checks
*** FLOP *** [3c 4d 5d]
Player#3274: checks
Player#6978: checks
*** TURN *** [3c 4d 5d] [9s]
Player#3274: checks
Player#6978: bets $0.20
Player#3274: calls $0.20
*** RIVER *** [3c 4d 5d] [9s] [2s]
Player#3274: checks
Player#6978: checks
*** SHOW DOWN *** 
Player#3274 collected $0.85 from pot
*** SUMMARY ***
Total Pot $0.90 | Rake $0.04
Board [3c 4d 5d 9s 2s]
Seat 1: Player#9963 folded before the flop
Seat 2: warioman folded before the flop
Seat 3: Player#6978 (button) mucked
Seat 4: Player#9101 (small blind) folded before the flop
Seat 5: Player#3274 shows [6h Qd] and won ($0.85) with 

PokerStars Hand #0556a4eb-f897-4690-9a0e-32a78df9a897:  Hold'em No Limit ($0.05/$0.10 USD) - 2021/11/20 11:22:00 ET
Table 'Aberdeen' 6-max Seat #3 is the button
Seat 1: Player#3584 ($9.62 in chips)
Seat 2: warioman ($9.80 in chips)
Seat 3: Player#1755 ($9.17 in chips)
Seat 4: Player#7968 ($10.72 in chips)
Seat 5: Player#5150 ($9.65 in chips)
Player#7968: posts small blind $0.05
Player#5150: posts big blind $0.10
*** HOLE CARDS ***
Dealt to warioman [7s Kh]
Player#3584: folds
warioman: folds
Player#1755: folds
Player#7968: calls $0.05
Player#5150: checks
*** FLOP *** [9h Qd Ts]
Player#7968: bets $0.10
Player#5150: folds
Player#3584: doesn't show hand
warioman: doesn't show hand
Player#1755: doesn't show hand
Player#7968: doesn't show hand
Player#5150: doesn't show hand
Uncalled bet ($0.10) returned to Player#7968
Player#7968 collected $0.19 from pot
*** SUMMARY ***
Total Pot $0.20 | Rake $0.01
Board [9h Qd Ts]
Seat 1: Player#3584 folded before the flop
Seat 2: warioman folded before the flop
Seat 3: Player#1755 (button) folded before the flop
Seat 4: Player#7968 shows [] and won ($0.19) with 
Seat 5: Player#5150 (big blind) folded on the flop

PokerStars Hand #49a51a51-4821-4813-aa30-dd22961ea965:  Hold'em No Limit ($0.1/$0.20 USD) - 2021/11/20 11:22:00 ET
Table 'Bethlehem' 6-max Seat #4 is the button
Seat 1: Player#7003 ($22.20 in chips)
Seat 2: Player#1131 ($21.14 in chips)
Seat 3: Player#4171 ($19.08 in chips)
Seat 4: Player#4331 ($34.25 in chips)
Seat 5: Player#7116 ($20.00 in chips)
Seat 6: warioman ($24.84 in chips)
Player#7116: posts small blind $0.10
Player#7003: posts big blind $0.20
*** HOLE CARDS ***
Dealt to warioman [6d Qd]
Player#7116 Waiting
Player#4171: folds
Player#4331: folds
warioman: raises $0.20 to $0.5
Player#7003: raises $0.50 to $1.9
Player#1131: folds
warioman: folds
Player#7003: doesn't show hand
Uncalled bet ($1.90) returned to Player#7003
Player#7003 collected $0.70 from pot
*** SUMMARY ***
Total Pot $0.70 | Rake $0.00
Seat 1: Player#7003 shows [] and won ($0.70) with 
Seat 2: Player#1131 folded before the flop
Seat 3: Player#4171 folded before the flop
Seat 4: Player#4331 (button) folded before the flop
Seat 5: Player#7116 (small blind) mucked
Seat 6: warioman folded before the flop

PokerStars Hand #8ab84ebf-9d78-4863-851e-4075c1997500:  Hold'em No Limit ($0.1/$0.20 USD) - 2021/11/20 11:21:00 ET
Table 'Bel Air' 6-max Seat #3 is the button
Seat 1: Player#3504 ($32.61 in chips)
Seat 2: Player#3577 ($31.71 in chips)
Seat 3: warioman ($41.25 in chips)
Seat 4: Player#5276 ($18.70 in chips)
Seat 5: Player#7064 ($26.27 in chips)
Seat 6: Player#7259 ($21.09 in chips)
Player#5276: posts small blind $0.10
Player#7064: posts big blind $0.20
*** HOLE CARDS ***
Dealt to warioman [5c Ad]
Player#7259: folds
Player#3504: folds
Player#3577: folds
warioman: folds
Player#5276: folds
Player#7064 collected $0.30 from pot
*** SUMMARY ***
Total Pot $0.30 | Rake $0.00
Seat 1: Player#3504 folded before the flop
Seat 2: Player#3577 folded before the flop
Seat 3: warioman (button) folded before the flop
Seat 4: Player#5276 (small blind) folded before the flop
Seat 5: Player#7064 shows [] and won ($0.30) with 
Seat 6: Player#7259 folded before the flop

PokerStars Hand #4a620c7f-564a-4593-a0d6-018426573486:  Hold'em No Limit ($0.1/$0.20 USD) - 2021/11/20 11:21:00 ET
Table 'Bel Air' 6-max Seat #2 is the button
Seat 1: Player#3524 ($32.31 in chips)
Seat 2: Player#4449 ($31.71 in chips)
Seat 3: warioman ($41.35 in chips)
Seat 4: Player#5220 ($18.90 in chips)
Seat 5: Player#3721 ($26.27 in chips)
Seat 6: Player#0804 ($21.09 in chips)
warioman: posts small blind $0.10
Player#5220: posts big blind $0.20
*** HOLE CARDS ***
Dealt to warioman [9d Ac]
Player#3721: folds
Player#0804: folds
Player#3524: raises $0.20 to $0.6
warioman: folds
Player#5220: folds
Player#3524: doesn't show hand
Uncalled bet ($0.60) returned to Player#3524
Player#3524 collected $0.30 from pot
*** SUMMARY ***
Total Pot $0.30 | Rake $0.00
Seat 1: Player#3524 shows [] and won ($0.30) with 
Seat 2: Player#4449 (button) mucked
Seat 3: warioman (small blind) folded before the flop
Seat 4: Player#5220 (big blind) folded before the flop
Seat 5: Player#3721 folded before the flop
Seat 6: Player#0804 folded before the flop

PokerStars Hand #9178981b-d475-4829-aa7f-e41d46422a98:  Hold'em No Limit ($0.1/$0.20 USD) - 2021/11/20 11:21:00 ET
Table 'Bethlehem' 6-max Seat #5 is the button
Seat 1: Player#6359 ($23.70 in chips)
Seat 2: Player#7856 ($19.69 in chips)
Seat 3: Player#9374 ($19.08 in chips)
Seat 4: Player#0916 ($34.25 in chips)
Seat 5: Player#5698 ($20.00 in chips)
Seat 6: warioman ($24.94 in chips)
warioman: posts small blind $0.10
Player#6359: posts big blind $0.20
*** HOLE CARDS ***
Dealt to warioman [9c 6c]
Player#7856: raises $0.20 to $0.4
Player#9374: folds
Player#0916: folds
warioman: folds
Player#6359: raises $0.40 to $1.5
Player#7856: calls $1.10
*** FLOP *** [3c Qh 3d]
Player#6359: checks
Player#7856: bets $1.55
Player#6359: folds
Player#7856: doesn't show hand
Uncalled bet ($1.55) returned to Player#7856
Player#7856 collected $2.95 from pot
*** SUMMARY ***
Total Pot $3.10 | Rake $0.16
Board [3c Qh 3d]
Seat 1: Player#6359 (big blind) folded on the flop
Seat 2: Player#7856 shows [] and won ($2.95) with 
Seat 3: Player#9374 folded before the flop
Seat 4: Player#0916 folded before the flop
Seat 5: Player#5698 (button) mucked
Seat 6: warioman (small blind) folded before the flop

PokerStars Hand #b29dd2ab-7cfc-4a5b-888a-c3be2d1ce28c:  Hold'em No Limit ($0.1/$0.20 USD) - 2021/11/20 11:21:00 ET
Table 'Bethlehem' 6-max Seat #3 is the button
Seat 1: Player#0154 ($23.70 in chips)
Seat 2: Player#3405 ($19.69 in chips)
Seat 3: Player#0933 ($19.08 in chips)
Seat 4: Player#7145 ($34.05 in chips)
Seat 5: warioman ($25.14 in chips)
Player#7145: posts small blind $0.10
warioman: posts big blind $0.20
*** HOLE CARDS ***
Dealt to warioman [6h Jc]
Player#0154: folds
Player#3405: folds
Player#0933: folds
Player#7145: raises $0.20 to $0.6
warioman: folds
Player#0154: doesn't show hand
Player#3405: doesn't show hand
Player#0933: doesn't show hand
Player#7145: doesn't show hand
warioman: doesn't show hand
Uncalled bet ($0.60) returned to Player#7145
Player#7145 collected $0.20 from pot
*** SUMMARY ***
Total Pot $0.20 | Rake $0.00
Seat 1: Player#0154 folded before the flop
Seat 2: Player#3405 folded before the flop
Seat 3: Player#0933 (button) folded before the flop
Seat 4: Player#7145 shows [] and won ($0.20) with 
Seat 5: warioman (big blind) folded before the flop

PokerStars Hand #77bb44bc-84a8-4459-a2e1-f3f8a6280102:  Hold'em No Limit ($0.1/$0.20 USD) - 2021/11/20 11:21:00 ET
Table 'Bel Air' 6-max Seat #1 is the button
Seat 1: Player#4723 ($32.31 in chips)
Seat 2: warioman ($41.55 in chips)
Seat 3: Player#5205 ($19.70 in chips)
Seat 4: Player#6637 ($26.27 in chips)
Seat 5: Player#7567 ($20.18 in chips)
warioman: posts small blind $0.10
warioman: posts big blind $0.20
*** HOLE CARDS ***
Dealt to warioman [5d 7d]
Player#5205: calls $0.20
Player#6637: folds
Player#7567: raises $0.20 to $0.8
Player#4723: folds
warioman: folds
Player#5205: calls $0.60
*** FLOP *** [Kh 9c 2h]
Player#5205: checks
Player#7567: bets $0.90
Player#5205: folds
Player#7567: doesn't show hand
Uncalled bet ($0.90) returned to Player#7567
Player#7567 collected $1.71 from pot
*** SUMMARY ***
Total Pot $1.80 | Rake $0.09
Board [Kh 9c 2h]
Seat 1: Player#4723 (button) folded before the flop
Seat 2: warioman (big blind) folded before the flop
Seat 3: Player#5205 folded on the flop
Seat 4: Player#6637 folded before the flop
Seat 5: Player#7567 shows [] and won ($1.71) with 

PokerStars Hand #e20eb3d6-0566-49ff-918c-251294512d11:  Hold'em No Limit ($0.05/$0.10 USD) - 2021/11/20 11:21:00 ET
Table 'Aberdeen' 6-max Seat #2 is the button
Seat 1: Player#3455 ($9.20 in chips)
Seat 2: warioman ($9.80 in chips)
Seat 3: Player#3835 ($9.22 in chips)
Seat 4: Player#7191 ($10.92 in chips)
Seat 5: Player#1465 ($9.85 in chips)
Player#3835: posts small blind $0.05
Player#7191: posts big blind $0.10
*** HOLE CARDS ***
Dealt to warioman [9c 8d]
Player#1465: raises $0.10 to $0.2
Player#3455: calls $0.20
warioman: folds
Player#3835: folds
Player#7191: calls $0.10
*** FLOP *** [Qh As 3s]
Player#7191: checks
Player#1465: checks
Player#3455: checks
*** TURN *** [Qh As 3s] [Qc]
Player#7191: checks
Player#1465: checks
Player#3455: checks
*** RIVER *** [Qh As 3s] [Qc] [9c]
Player#7191: checks
Player#1465: checks
Player#3455: checks
*** SHOW DOWN *** 
Player#3455 collected $0.62 from pot
*** SUMMARY ***
Total Pot $0.65 | Rake $0.03
Board [Qh As 3s Qc 9c]
Seat 1: Player#3455 shows [4h 4c] and won ($0.62) with 
Seat 2: warioman (button) folded before the flop
Seat 3: Player#3835 (small blind) folded before the flop
Seat 4: Player#7191 (big blind) mucked
Seat 5: Player#1465 mucked

PokerStars Hand #8e044a52-a09c-4d25-97b7-c33e48188d37:  Hold'em No Limit ($0.05/$0.10 USD) - 2021/11/20 11:21:00 ET
Table 'Aberdeen' 6-max Seat #1 is the button
Seat 1: Player#1590 ($9.20 in chips)
Seat 2: warioman ($9.85 in chips)
Seat 3: Player#9440 ($9.17 in chips)
Seat 4: Player#7742 ($10.92 in chips)
Seat 5: Player#7281 ($9.85 in chips)
warioman: posts small blind $0.05
Player#9440: posts big blind $0.10
*** HOLE CARDS ***
Dealt to warioman [3s Td]
Player#7742: folds
Player#7281: folds
Player#1590: folds
warioman: folds
Player#9440 collected $0.10 from pot
*** SUMMARY ***
Total Pot $0.10 | Rake $0.00
Seat 1: Player#1590 (button) folded before the flop
Seat 2: warioman (small blind) folded before the flop
Seat 3: Player#9440 shows [] and won ($0.10) with 
Seat 4: Player#7742 folded before the flop
Seat 5: Player#7281 folded before the flop

PokerStars Hand #ed0366d0-d4c9-4870-972e-6661b13d70a4:  Hold'em No Limit ($0.1/$0.20 USD) - 2021/11/20 11:20:00 ET
Table 'Bethlehem' 6-max Seat #2 is the button
Seat 1: Player#7159 ($23.70 in chips)
Seat 2: Player#4848 ($19.69 in chips)
Seat 3: Player#5428 ($18.90 in chips)
Seat 4: Player#1510 ($34.25 in chips)
Seat 5: Player#2652 ($52.25 in chips)
Seat 6: warioman ($25.14 in chips)
Player#5428: posts small blind $0.10
Player#1510: posts big blind $0.20
*** HOLE CARDS ***
Dealt to warioman [8d Qd]
Player#2652: folds
warioman: folds
Player#7159: folds
Player#4848: folds
Player#5428: calls $0.10
Player#1510: checks
*** FLOP *** [Jh 2d 5d]
Player#5428: checks
Player#1510: checks
*** TURN *** [Jh 2d 5d] [5c]
Player#5428: bets $0.40
Player#1510: folds
Player#5428: doesn't show hand
Uncalled bet ($0.40) returned to Player#5428
Player#5428 collected $0.38 from pot
*** SUMMARY ***
Total Pot $0.40 | Rake $0.02
Board [Jh 2d 5d 5c]
Seat 1: Player#7159 folded before the flop
Seat 2: Player#4848 (button) folded before the flop
Seat 3: Player#5428 shows [] and won ($0.38) with 
Seat 4: Player#1510 (big blind) folded on the turn
Seat 5: Player#2652 folded before the flop
Seat 6: warioman folded before the flop

PokerStars Hand #0870e2b7-1f78-4e82-9ca2-05223b2f2132:  Hold'em No Limit ($0.1/$0.20 USD) - 2021/11/20 11:20:00 ET
Table 'Bel Air' 6-max Seat #6 is the button
Seat 1: Player#0231 ($32.41 in chips)
Seat 2: Player#0652 ($31.91 in chips)
Seat 3: warioman ($41.55 in chips)
Seat 4: Player#0654 ($19.70 in chips)
Seat 5: Player#4633 ($25.97 in chips)
Seat 6: Player#8127 ($20.18 in chips)
Player#0231: posts small blind $0.10
Player#0652: posts big blind $0.20
*** HOLE CARDS ***
Dealt to warioman [Ks 6s]
warioman: folds
Player#0654: folds
Player#4633: raises $0.20 to $0.6
Player#8127: folds
Player#0231: folds
Player#0652: folds
Player#4633: doesn't show hand
Uncalled bet ($0.60) returned to Player#4633
Player#4633 collected $0.30 from pot
*** SUMMARY ***
Total Pot $0.30 | Rake $0.00
Seat 1: Player#0231 (small blind) folded before the flop
Seat 2: Player#0652 (big blind) folded before the flop
Seat 3: warioman folded before the flop
Seat 4: Player#0654 folded before the flop
Seat 5: Player#4633 shows [] and won ($0.30) with 
Seat 6: Player#8127 (button) folded before the flop

PokerStars Hand #40b5b2cd-5950-4171-86da-88211e9b6cfc:  Hold'em No Limit ($0.1/$0.20 USD) - 2021/11/20 11:20:00 ET
Table 'Bethlehem' 6-max Seat #1 is the button
Seat 1: Player#8840 ($23.70 in chips)
Seat 2: Player#1673 ($19.79 in chips)
Seat 3: Player#1694 ($18.80 in chips)
Seat 4: Player#1274 ($34.25 in chips)
Seat 5: Player#5964 ($52.25 in chips)
Seat 6: warioman ($25.14 in chips)
Player#1673: posts small blind $0.10
Player#1694: posts big blind $0.20
*** HOLE CARDS ***
Dealt to warioman [2c 4d]
Player#1274: folds
Player#5964: folds
warioman: folds
Player#8840: folds
Player#1673: folds
Player#1694 collected $0.20 from pot
*** SUMMARY ***
Total Pot $0.20 | Rake $0.00
Seat 1: Player#8840 (button) folded before the flop
Seat 2: Player#1673 (small blind) folded before the flop
Seat 3: Player#1694 shows [] and won ($0.20) with 
Seat 4: Player#1274 folded before the flop
Seat 5: Player#5964 folded before the flop
Seat 6: warioman folded before the flop

PokerStars Hand #2cbd8f16-045e-4028-91a0-7462a26a05ca:  Hold'em No Limit ($0.1/$0.20 USD) - 2021/11/20 11:20:00 ET
Table 'Bethlehem' 6-max Seat #6 is the button
Seat 1: Player#9619 ($23.50 in chips)
Seat 2: Player#4716 ($19.99 in chips)
Seat 3: Player#2344 ($18.80 in chips)
Seat 4: Player#6081 ($34.25 in chips)
Seat 5: Player#4373 ($52.25 in chips)
Seat 6: warioman ($25.14 in chips)
Player#9619: posts small blind $0.10
Player#4716: posts big blind $0.20
*** HOLE CARDS ***
Dealt to warioman [As 4d]
Player#2344: folds
Player#6081: folds
Player#4373: folds
warioman: folds
Player#9619: raises $0.20 to $0.6
Player#4716: folds
Player#9619: doesn't show hand
Uncalled bet ($0.60) returned to Player#9619
Player#9619 collected $0.20 from pot
*** SUMMARY ***
Total Pot $0.20 | Rake $0.00
Seat 1: Player#9619 shows [] and won ($0.20) with 
Seat 2: Player#4716 (big blind) folded before the flop
Seat 3: Player#2344 folded before the flop
Seat 4: Player#6081 folded before the flop
Seat 5: Player#4373 folded before the flop
Seat 6: warioman (button) folded before the flop

PokerStars Hand #6a32a75d-96f8-48e1-aa05-4e20abe593c7:  Hold'em No Limit ($0.1/$0.20 USD) - 2021/11/20 11:20:00 ET
Table 'Bel Air' 6-max Seat #5 is the button
Seat 1: Player#3940 ($34.61 in chips)
Seat 2: Player#0774 ($29.36 in chips)
Seat 3: warioman ($41.55 in chips)
Seat 4: Player#6502 ($20.00 in chips)
Seat 5: Player#1465 ($26.17 in chips)
Seat 6: Player#8587 ($20.28 in chips)
Player#8587: posts small blind $0.10
Player#3940: posts big blind $0.20
*** HOLE CARDS ***
Dealt to warioman [9s 6c]
Player#0774: calls $0.20
warioman: folds
Player#6502: calls $0.20
Player#1465: calls $0.20
Player#8587: folds
Player#3940: checks
*** FLOP *** [6h Ah 2s]
Player#3940: bets $0.60
Player#0774: calls $0.60
Player#6502: folds
Player#1465: folds
*** TURN *** [6h Ah 2s] [4d]
Player#3940: checks
Player#0774: checks
*** RIVER *** [6h Ah 2s] [4d] [4d]
Player#3940: bets $1.40
Player#0774: calls $1.40
*** SHOW DOWN *** 
Player#0774 collected $4.75 from pot
*** SUMMARY ***
Total Pot $5.00 | Rake $0.25
Board [6h Ah 2s 4d 4d]
Seat 1: Player#3940 (big blind) mucked
Seat 2: Player#0774 shows [7h Jh] and won ($4.75) with 
Seat 3: warioman folded before the flop
Seat 4: Player#6502 folded on the flop
Seat 5: Player#1465 (button) folded on the flop
Seat 6: Player#8587 (small blind) folded before the flop

PokerStars Hand #e87d5156-9a11-48c9-a661-2353d18345b4:  Hold'em No Limit ($0.05/$0.10 USD) - 2021/11/20 11:19:00 ET
Table 'Aberdeen' 6-max Seat #6 is the button
Seat 1: Player#5427 ($9.60 in chips)
Seat 2: warioman ($9.95 in chips)
Seat 3: Player#8449 ($9.00 in chips)
Seat 4: Player#0168 ($10.76 in chips)
Seat 5: Player#6138 ($9.85 in chips)
Player#5427: posts small blind $0.05
warioman: posts big blind $0.10
*** HOLE CARDS ***
Dealt to warioman [5c Qc]
Player#8449: calls $0.10
Player#0168: raises $0.10 to $0.4
Player#6138: folds
Player#5427: calls $0.35
warioman: folds
Player#8449: calls $0.30
*** FLOP *** [4c 2c 2d]
Player#5427: checks
Player#8449: checks
Player#0168: checks
*** TURN *** [4c 2c 2d] [4h]
Player#5427: checks
Player#8449: bets $0.35
Player#0168: calls $0.35
Player#5427: folds
*** RIVER *** [4c 2c 2d] [4h] [Jh]
Player#8449: bets $0.70
Player#0168: calls $0.70
*** SHOW DOWN *** 
Player#0168 collected $3.23 from pot
*** SUMMARY ***
Total Pot $3.40 | Rake $0.17
Board [4c 2c 2d 4h Jh]
Seat 1: Player#5427 (small blind) folded on the turn
Seat 2: warioman (big blind) folded before the flop
Seat 3: Player#8449 mucked
Seat 4: Player#0168 shows [9c Ah] and won ($3.23) with 
Seat 5: Player#6138 folded before the flop

PokerStars Hand #ad729dd2-1378-4200-ba64-4f97c67bf75c:  Hold'em No Limit ($0.1/$0.20 USD) - 2021/11/20 11:19:00 ET
Table 'Bel Air' 6-max Seat #4 is the button
Seat 1: Player#0624 ($34.61 in chips)
Seat 2: Player#6611 ($29.56 in chips)
Seat 3: warioman ($41.55 in chips)
Seat 4: Player#1089 ($20.00 in chips)
Seat 5: Player#2065 ($26.27 in chips)
Seat 6: Player#7044 ($20.00 in chips)
Player#2065: posts small blind $0.10
Player#7044: posts big blind $0.20
*** HOLE CARDS ***
Dealt to warioman [7h Qh]
Player#0624: folds
Player#6611: calls $0.20
warioman: folds
Player#2065: folds
Player#7044: checks
*** FLOP *** [6c 6s 9c]
Player#7044: checks
Player#6611: checks
*** TURN *** [6c 6s 9c] [Ks]
Player#7044: bets $1.00
Player#6611: folds
Player#7044: doesn't show hand
Uncalled bet ($1.00) returned to Player#7044
Player#7044 collected $0.47 from pot
*** SUMMARY ***
Total Pot $0.50 | Rake $0.03
Board [6c 6s 9c Ks]
Seat 1: Player#0624 folded before the flop
Seat 2: Player#6611 folded on the turn
Seat 3: warioman folded before the flop
Seat 4: Player#1089 (button) mucked
Seat 5: Player#2065 (small blind) folded before the flop
Seat 6: Player#7044 shows [] and won ($0.47) with 

PokerStars Hand #cc88a897-e8d8-437e-bb6d-90a16596fd77:  Hold'em No Limit ($0.1/$0.20 USD) - 2021/11/20 11:19:00 ET
Table 'Bethlehem' 6-max Seat #5 is the button
Seat 1: Player#9482 ($21.66 in chips)
Seat 2: Player#0521 ($19.99 in chips)
Seat 3: Player#3804 ($20.00 in chips)
Seat 4: Player#4745 ($34.25 in chips)
Seat 5: Player#8448 ($52.65 in chips)
Seat 6: warioman ($25.54 in chips)
warioman: posts small blind $0.10
Player#9482: posts big blind $0.20
*** HOLE CARDS ***
Dealt to warioman [Ac 4c]
Player#3804 Entry Bet 0.2
Player#0521: folds
Player#3804: raises $0.20 to $0.4
Player#4745: folds
Player#8448: calls $0.40
warioman: calls $0.30
Player#9482: calls $0.20
*** FLOP *** [Qd Qh Qs]
warioman: checks
Player#9482: checks
Player#3804: bets $0.80
Player#8448: folds
warioman: folds
Player#9482: raises0.80 to $3
Player#3804: folds
Player#9482: doesn't show hand
Uncalled bet ($3.00) returned to Player#9482
Player#9482 collected $2.28 from pot
*** SUMMARY ***
Total Pot $2.40 | Rake $0.12
Board [Qd Qh Qs]
Seat 1: Player#9482 shows [] and won ($2.28) with 
Seat 2: Player#0521 folded before the flop
Seat 3: Player#3804 folded on the flop
Seat 4: Player#4745 folded before the flop
Seat 5: Player#8448 (button) folded on the flop
Seat 6: warioman (small blind) folded on the flop

PokerStars Hand #7dd89b62-d183-405f-88a5-592172e3982b:  Hold'em No Limit ($0.1/$0.20 USD) - 2021/11/20 11:19:00 ET
Table 'Bel Air' 6-max Seat #3 is the button
Seat 1: Player#8442 ($34.61 in chips)
Seat 2: Player#8013 ($29.38 in chips)
Seat 3: warioman ($41.55 in chips)
Seat 4: Player#9526 ($26.47 in chips)
Seat 5: Player#8208 ($20.00 in chips)
Player#9526: posts small blind $0.10
Player#8013: posts big blind $0.20
*** HOLE CARDS ***
Dealt to warioman [6c Qs]
Player#8208: folds
Player#8442: folds
Player#8013: calls $0.20
warioman: folds
Player#9526: checks
*** FLOP *** [9c 5h 9s]
Player#9526: checks
Player#8013: bets $0.50
Player#9526: folds
Player#8013: doesn't show hand
Uncalled bet ($0.50) returned to Player#8013
Player#8013 collected $0.47 from pot
*** SUMMARY ***
Total Pot $0.50 | Rake $0.03
Board [9c 5h 9s]
Seat 1: Player#8442 folded before the flop
Seat 2: Player#8013 shows [] and won ($0.47) with 
Seat 3: warioman (button) folded before the flop
Seat 4: Player#9526 (small blind) folded on the flop
Seat 5: Player#8208 folded before the flop

PokerStars Hand #bfbf0d83-6642-4e2e-85e9-2544b1ff6dae:  Hold'em No Limit ($0.05/$0.10 USD) - 2021/11/20 11:19:00 ET
Table 'Aberdeen' 6-max Seat #5 is the button
Seat 1: Player#7594 ($9.07 in chips)
Seat 2: Player#1817 ($13.15 in chips)
Seat 3: warioman ($9.95 in chips)
Seat 4: Player#2282 ($9.00 in chips)
Seat 5: Player#0009 ($11.29 in chips)
Seat 6: Player#5176 ($9.90 in chips)
Player#5176: posts small blind $0.05
Player#7594: posts big blind $0.10
*** HOLE CARDS ***
Dealt to warioman [5h Jh]
Player#1817: folds
warioman: folds
Player#2282: folds
Player#0009: raises $0.10 to $0.3
Player#5176: folds
Player#7594: calls $0.20
*** FLOP *** [6d 9h Kc]
Player#7594: checks
Player#0009: bets $0.23
Player#7594: calls $0.23
*** TURN *** [6d 9h Kc] [Th]
Player#7594: bets $1.11
Player#0009: folds
Player#7594: doesn't show hand
Uncalled bet ($1.11) returned to Player#7594
Player#7594 collected $1.05 from pot
*** SUMMARY ***
Total Pot $1.11 | Rake $0.06
Board [6d 9h Kc Th]
Seat 1: Player#7594 shows [] and won ($1.05) with 
Seat 2: Player#1817 folded before the flop
Seat 3: warioman folded before the flop
Seat 4: Player#2282 folded before the flop
Seat 5: Player#0009 (button) folded on the turn
Seat 6: Player#5176 (small blind) folded before the flop

PokerStars Hand #8e7e1949-1409-473a-9388-b29bc0ec323d:  Hold'em No Limit ($0.05/$0.10 USD) - 2021/11/20 11:18:00 ET
Table 'Aberdeen' 6-max Seat #4 is the button
Seat 1: Player#0623 ($9.07 in chips)
Seat 2: Player#0594 ($13.00 in chips)
Seat 3: warioman ($9.95 in chips)
Seat 4: Player#1659 ($9.00 in chips)
Seat 5: Player#7556 ($11.34 in chips)
Seat 6: Player#9170 ($10.00 in chips)
Player#7556: posts small blind $0.05
Player#9170: posts big blind $0.10
*** HOLE CARDS ***
Dealt to warioman [Ts 4s]
Player#0623: folds
Player#0594: raises $0.10 to $0.3
warioman: folds
Player#1659: folds
Player#7556: folds
Player#9170: folds
Player#0594: doesn't show hand
Uncalled bet ($0.30) returned to Player#0594
Player#0594 collected $0.15 from pot
*** SUMMARY ***
Total Pot $0.15 | Rake $0.00
Seat 1: Player#0623 folded before the flop
Seat 2: Player#0594 shows [] and won ($0.15) with 
Seat 3: warioman folded before the flop
Seat 4: Player#1659 (button) folded before the flop
Seat 5: Player#7556 (small blind) folded before the flop
Seat 6: Player#9170 (big blind) folded before the flop

PokerStars Hand #88649747-1116-4208-a315-173380dc0a3d:  Hold'em No Limit ($0.1/$0.20 USD) - 2021/11/20 11:18:00 ET
Table 'Bethlehem' 6-max Seat #3 is the button
Seat 1: Player#6663 ($21.66 in chips)
Seat 2: Player#1230 ($19.99 in chips)
Seat 3: Player#3084 ($34.25 in chips)
Seat 4: Player#6824 ($52.85 in chips)
Seat 5: warioman ($25.36 in chips)
Player#6824: posts small blind $0.10
warioman: posts big blind $0.20
*** HOLE CARDS ***
Dealt to warioman [3d As]
Player#6663: folds
Player#1230: folds
Player#3084: folds
Player#6824: calls $0.10
warioman: checks
*** FLOP *** [Td 7d 9c]
Player#6824: checks
warioman: checks
*** TURN *** [Td 7d 9c] [9d]
Player#6824: checks
warioman: checks
*** RIVER *** [Td 7d 9c] [9d] [Td]
Player#6824: checks
warioman: checks
*** SHOW DOWN *** 
warioman collected $0.38 from pot
*** SUMMARY ***
Total Pot $0.40 | Rake $0.02
Board [Td 7d 9c 9d Td]
Seat 1: Player#6663 folded before the flop
Seat 2: Player#1230 folded before the flop
Seat 3: Player#3084 (button) folded before the flop
Seat 4: Player#6824 (small blind) mucked
Seat 5: warioman (big blind)

PokerStars Hand #261d7951-11a3-4a2a-a768-1b269d207d32:  Hold'em No Limit ($0.1/$0.20 USD) - 2021/11/20 11:18:00 ET
Table 'Bethlehem' 6-max Seat #2 is the button
Seat 1: Player#0663 ($21.66 in chips)
Seat 2: Player#3089 ($19.99 in chips)
Seat 3: Player#3711 ($34.35 in chips)
Seat 4: Player#6796 ($52.75 in chips)
Seat 5: warioman ($25.36 in chips)
Player#3711: posts small blind $0.10
Player#6796: posts big blind $0.20
*** HOLE CARDS ***
Dealt to warioman [6c Ad]
warioman: folds
Player#0663: folds
Player#3089: folds
Player#3711: folds
Player#6796 collected $0.20 from pot
*** SUMMARY ***
Total Pot $0.20 | Rake $0.00
Seat 1: Player#0663 folded before the flop
Seat 2: Player#3089 (button) folded before the flop
Seat 3: Player#3711 (small blind) folded before the flop
Seat 4: Player#6796 shows [] and won ($0.20) with 
Seat 5: warioman folded before the flop

PokerStars Hand #6ab6a5e3-e800-4607-8e75-bdbefa1f7924:  Hold'em No Limit ($0.1/$0.20 USD) - 2021/11/20 11:18:00 ET
Table 'Bel Air' 6-max Seat #2 is the button
Seat 1: Player#1150 ($34.61 in chips)
Seat 2: Player#8048 ($29.38 in chips)
Seat 3: warioman ($33.54 in chips)
Seat 4: Player#3984 ($8.90 in chips)
Seat 5: Player#4094 ($26.47 in chips)
Seat 6: Player#7408 ($20.00 in chips)
warioman: posts small blind $0.10
Player#3984: posts big blind $0.20
*** HOLE CARDS ***
Dealt to warioman [Ah Qh]
Player#4094: folds
Player#7408: folds
Player#1150: folds
warioman: calls $0.10
Player#3984: raises0.20 to $1
warioman: raises $ 31.00 to $33.54
Player#3984: calls $7.90
warioman Showing Pocket Cards AQ
Player#3984 Showing Pocket Cards 77
*** FLOP *** [Ah 5h 9s]
*** TURN *** [Ah 5h 9s] [9c]
*** RIVER *** [Ah 5h 9s] [9c] [6h]
warioman collected $40.94 from pot
*** SUMMARY ***
Total Pot $42.44 | Rake $1.50
Board [Ah 5h 9s 9c 6h]
Seat 1: Player#1150 folded before the flop
Seat 2: Player#8048 (button) mucked
Seat 3: warioman (small blind)
Seat 4: Player#3984 (big blind) mucked
Seat 5: Player#4094 folded before the flop
Seat 6: Player#7408 folded before the flop

PokerStars Hand #27f80344-1589-4065-9501-89643593fdb0:  Hold'em No Limit ($0.1/$0.20 USD) - 2021/11/20 11:17:00 ET
Table 'Bel Air' 6-max Seat #1 is the button
Seat 1: Player#7759 ($34.81 in chips)
Seat 2: warioman ($23.36 in chips)
Seat 3: Player#4969 ($20.00 in chips)
Seat 4: Player#7546 ($26.47 in chips)
Seat 5: Player#3366 ($20.00 in chips)
warioman: posts small blind $0.10
Player#4969: posts big blind $0.20
*** HOLE CARDS ***
Dealt to warioman [Qs Qd]
Player#4969 Entry Bet 0.2
Player#4969: checks
Player#7546: folds
Player#3366: folds
Player#7759: calls $0.20
warioman: raises $0.20 to $1.2
Player#4969: calls $1.00
Player#7759: folds
*** FLOP *** [4c 5c Qh]
warioman: bets $0.78
Player#4969: calls $0.78
*** TURN *** [4c 5c Qh] [6h]
warioman: bets $3.52
Player#4969: calls $3.52
*** RIVER *** [4c 5c Qh] [6h] [Jh]
warioman: checks
Player#4969: bets $5.60
warioman: calls $5.60
*** SHOW DOWN *** 
warioman collected $21.09 from pot
*** SUMMARY ***
Total Pot $22.20 | Rake $1.11
Board [4c 5c Qh 6h Jh]
Seat 1: Player#7759 (button) folded before the flop
Seat 2: warioman (small blind)
Seat 3: Player#4969 (big blind) mucked
Seat 4: Player#7546 folded before the flop
Seat 5: Player#3366 folded before the flop

PokerStars Hand #70e69e4e-86d8-410a-be3b-88f7fef4199e:  Hold'em No Limit ($0.1/$0.20 USD) - 2021/11/20 11:17:00 ET
Table 'Bethlehem' 6-max Seat #1 is the button
Seat 1: Player#0612 ($22.56 in chips)
Seat 2: Player#8473 ($20.09 in chips)
Seat 3: Player#2021 ($31.33 in chips)
Seat 4: Player#6931 ($55.05 in chips)
Seat 5: warioman ($25.36 in chips)
Player#8473: posts small blind $0.10
Player#2021: posts big blind $0.20
*** HOLE CARDS ***
Dealt to warioman [7h Ad]
Player#6931: calls $0.20
warioman: folds
Player#0612: raises $0.20 to $0.9
Player#8473: folds
Player#2021: calls $0.70
Player#6931: calls $0.70
*** FLOP *** [2c Qh 8d]
Player#2021: checks
Player#6931: checks
Player#0612: checks
*** TURN *** [2c Qh 8d] [8c]
Player#2021: bets $1.40
Player#6931: calls $1.40
Player#0612: folds
*** RIVER *** [2c Qh 8d] [8c] [5c]
Player#2021: bets $5.60
Player#6931: folds
Player#2021: doesn't show hand
Uncalled bet ($5.60) returned to Player#2021
Player#2021 collected $5.32 from pot
*** SUMMARY ***
Total Pot $5.60 | Rake $0.28
Board [2c Qh 8d 8c 5c]
Seat 1: Player#0612 (button) folded on the turn
Seat 2: Player#8473 (small blind) folded before the flop
Seat 3: Player#2021 shows [] and won ($5.32) with 
Seat 4: Player#6931 folded on the river
Seat 5: warioman folded before the flop

PokerStars Hand #8c490bb5-f85f-4953-a5aa-35e24cdac212:  Hold'em No Limit ($0.05/$0.10 USD) - 2021/11/20 11:17:00 ET
Table 'Aberdeen' 6-max Seat #3 is the button
Seat 1: Player#6081 ($9.17 in chips)
Seat 2: Player#8956 ($13.50 in chips)
Seat 3: warioman ($9.95 in chips)
Seat 4: Player#5699 ($9.20 in chips)
Seat 5: Player#1266 ($10.60 in chips)
Seat 6: Player#5838 ($10.00 in chips)
Player#5699: posts small blind $0.05
Player#1266: posts big blind $0.10
*** HOLE CARDS ***
Dealt to warioman [Td 7c]
Player#5838: folds
Player#6081: calls $0.10
Player#8956: calls $0.10
warioman: folds
Player#5699: calls $0.05
Player#1266: checks
*** FLOP *** [4d 5s 6d]
Player#5699: checks
Player#1266: bets $0.10
Player#6081: folds
Player#8956: calls $0.10
Player#5699: calls $0.10
*** TURN *** [4d 5s 6d] [4s]
Player#5699: checks
Player#1266: checks
Player#8956: bets $0.30
Player#5699: folds
Player#1266: raises0.30 to $1
Player#8956: folds
Player#6081: doesn't show hand
Player#8956: doesn't show hand
warioman: doesn't show hand
Player#5699: doesn't show hand
Player#1266: doesn't show hand
Player#5838: doesn't show hand
Uncalled bet ($1.00) returned to Player#1266
Player#1266 collected $0.95 from pot
*** SUMMARY ***
Total Pot $1.00 | Rake $0.05
Board [4d 5s 6d 4s]
Seat 1: Player#6081 folded on the flop
Seat 2: Player#8956 folded on the turn
Seat 3: warioman (button) folded before the flop
Seat 4: Player#5699 (small blind) folded on the turn
Seat 5: Player#1266 shows [] and won ($0.95) with 
Seat 6: Player#5838 folded before the flop

PokerStars Hand #b5973e10-623b-429d-ac36-955a814d7e8e:  Hold'em No Limit ($0.05/$0.10 USD) - 2021/11/20 11:17:00 ET
Table 'Aberdeen' 6-max Seat #2 is the button
Seat 1: Player#0741 ($9.17 in chips)
Seat 2: Player#0934 ($13.50 in chips)
Seat 3: warioman ($10.00 in chips)
Seat 4: Player#4174 ($9.15 in chips)
Seat 5: Player#9173 ($10.60 in chips)
Seat 6: Player#0426 ($5.94 in chips)
warioman: posts small blind $0.05
Player#4174: posts big blind $0.10
*** HOLE CARDS ***
Dealt to warioman [8d 3c]
Player#9173: folds
Player#0426: folds
Player#0741: folds
Player#0934: folds
warioman: folds
Player#4174 collected $0.10 from pot
*** SUMMARY ***
Total Pot $0.10 | Rake $0.00
Seat 1: Player#0741 folded before the flop
Seat 2: Player#0934 (button) folded before the flop
Seat 3: warioman (small blind) folded before the flop
Seat 4: Player#4174 shows [] and won ($0.10) with 
Seat 5: Player#9173 folded before the flop
Seat 6: Player#0426 folded before the flop

PokerStars Hand #33be2fee-a0dd-421b-ba3a-6691b80d63b0:  Hold'em No Limit ($0.1/$0.20 USD) - 2021/11/20 11:16:00 ET
Table 'Bethlehem' 6-max Seat #6 is the button
Seat 1: Player#9361 ($22.66 in chips)
Seat 2: Player#8397 ($20.29 in chips)
Seat 3: Player#3927 ($36.43 in chips)
Seat 4: Player#7228 ($31.33 in chips)
Seat 5: Player#0763 ($55.95 in chips)
Seat 6: warioman ($25.36 in chips)
Player#9361: posts small blind $0.10
Player#8397: posts big blind $0.20
*** HOLE CARDS ***
Dealt to warioman [Kc 7h]
Player#3927: calls $0.20
Player#7228: folds
Player#0763: raises $0.20 to $0.9
warioman: folds
Player#9361: folds
Player#8397: folds
Player#3927: calls $0.70
*** FLOP *** [6d 2s 6s]
Player#3927: checks
Player#0763: checks
*** TURN *** [6d 2s 6s] [8c]
Player#3927: bets $0.20
Player#0763: folds
Player#3927: doesn't show hand
Uncalled bet ($0.20) returned to Player#3927
Player#3927 collected $2.00 from pot
*** SUMMARY ***
Total Pot $2.10 | Rake $0.11
Board [6d 2s 6s 8c]
Seat 1: Player#9361 (small blind) folded before the flop
Seat 2: Player#8397 (big blind) folded before the flop
Seat 3: Player#3927 shows [] and won ($2.00) with 
Seat 4: Player#7228 folded before the flop
Seat 5: Player#0763 folded on the turn
Seat 6: warioman (button) folded before the flop

PokerStars Hand #be5328dc-d1df-4940-a11b-a3091e39ebb2:  Hold'em No Limit ($0.05/$0.10 USD) - 2021/11/20 11:16:00 ET
Table 'Aberdeen' 6-max Seat #1 is the button
Seat 1: Player#4282 ($4.75 in chips)
Seat 2: Player#4092 ($13.55 in chips)
Seat 3: warioman ($13.35 in chips)
Seat 4: Player#7346 ($9.15 in chips)
Seat 5: Player#8351 ($10.60 in chips)
Seat 6: Player#0030 ($6.04 in chips)
Player#4092: posts small blind $0.05
warioman: posts big blind $0.10
*** HOLE CARDS ***
Dealt to warioman [Ks As]
Player#7346: folds
Player#8351: folds
Player#0030: calls $0.10
Player#4282: raises $0.10 to $4.75
Player#4092: folds
warioman: raises $ 14.75 to $13.35
Player#0030: folds
warioman Showing Pocket Cards KA
Player#4282 Showing Pocket Cards 2A
*** FLOP *** [9s 2s 2c]
*** TURN *** [9s 2s 2c] [7s]
*** RIVER *** [9s 2s 2c] [7s] [3c]
Uncalled bet ($13.35) returned to warioman
Player#4282 collected $4.66 from pot
*** SUMMARY ***
Total Pot $4.90 | Rake $0.25
Board [9s 2s 2c 7s 3c]
Seat 1: Player#4282 shows [2c Ad] and won ($4.66) with 
Seat 2: Player#4092 (small blind) folded before the flop
Seat 3: warioman (big blind)
Seat 4: Player#7346 folded before the flop
Seat 5: Player#8351 folded before the flop
Seat 6: Player#0030 folded before the flop

PokerStars Hand #4c9afef3-5c76-4e93-92f9-c5b80ff35ab1:  Hold'em No Limit ($0.1/$0.20 USD) - 2021/11/20 11:16:00 ET
Table 'Bethlehem' 6-max Seat #5 is the button
Seat 1: Player#9000 ($22.38 in chips)
Seat 2: Player#9105 ($20.29 in chips)
Seat 3: Player#7248 ($36.43 in chips)
Seat 4: Player#0778 ($31.33 in chips)
Seat 5: Player#4041 ($56.15 in chips)
Seat 6: warioman ($25.46 in chips)
warioman: posts small blind $0.10
Player#9000: posts big blind $0.20
*** HOLE CARDS ***
Dealt to warioman [6s 8d]
Player#9105: folds
Player#7248: folds
Player#0778: folds
Player#4041: calls $0.20
warioman: folds
Player#9000: checks
*** FLOP *** [Td 6h 3s]
Player#9000: bets $0.60
Player#4041: folds
Player#9000: doesn't show hand
Uncalled bet ($0.60) returned to Player#9000
Player#9000 collected $0.48 from pot
*** SUMMARY ***
Total Pot $0.50 | Rake $0.03
Board [Td 6h 3s]
Seat 1: Player#9000 shows [] and won ($0.48) with 
Seat 2: Player#9105 folded before the flop
Seat 3: Player#7248 folded before the flop
Seat 4: Player#0778 folded before the flop
Seat 5: Player#4041 (button) folded on the flop
Seat 6: warioman (small blind) folded before the flop

PokerStars Hand #e70142c6-96ce-44b9-bc90-50bb16e85ffa:  Hold'em No Limit ($0.05/$0.10 USD) - 2021/11/20 11:16:00 ET
Table 'Aberdeen' 6-max Seat #6 is the button
Seat 1: Player#6234 ($4.80 in chips)
Seat 2: Player#2202 ($13.65 in chips)
Seat 3: warioman ($16.45 in chips)
Seat 4: Player#3235 ($9.15 in chips)
Seat 5: Player#9084 ($10.60 in chips)
Seat 6: Player#4256 ($3.10 in chips)
Player#6234: posts small blind $0.05
Player#2202: posts big blind $0.10
*** HOLE CARDS ***
Dealt to warioman [Ac Ks]
warioman: raises $0.10 to $0.5
Player#3235: folds
Player#9084: folds
Player#4256: raises $0.50 to $3.1
Player#6234: folds
Player#2202: folds
warioman: calls $2.60
warioman Showing Pocket Cards AK
Player#4256 Showing Pocket Cards TT
*** FLOP *** [Tc 2s 9h]
*** TURN *** [Tc 2s 9h] [9d]
*** RIVER *** [Tc 2s 9h] [9d] [Qc]
Player#4256 collected $6.03 from pot
*** SUMMARY ***
Total Pot $6.35 | Rake $0.32
Board [Tc 2s 9h 9d Qc]
Seat 1: Player#6234 (small blind) folded before the flop
Seat 2: Player#2202 (big blind) folded before the flop
Seat 3: warioman
Seat 4: Player#3235 folded before the flop
Seat 5: Player#9084 folded before the flop
Seat 6: Player#4256 shows [Th Td] and won ($6.03) with 

PokerStars Hand #3a4aadfe-39df-4119-857f-086dc19d3d12:  Hold'em No Limit ($0.1/$0.20 USD) - 2021/11/20 11:15:00 ET
Table 'Bel Air' 6-max Seat #6 is the button
Seat 1: Player#6436 ($34.91 in chips)
Seat 2: Player#2122 ($29.58 in chips)
Seat 3: warioman ($21.74 in chips)
Seat 4: Player#2543 ($27.95 in chips)
Seat 5: Player#8980 ($20.00 in chips)
Player#6436: posts small blind $0.10
Player#2122: posts big blind $0.20
*** HOLE CARDS ***
Dealt to warioman [Jc Tc]
warioman: raises $0.20 to $0.5
Player#2543: calls $0.50
Player#8980: folds
Player#6436: folds
Player#2122: folds
*** FLOP *** [8d 9c 3s]
warioman: checks
Player#2543: checks
*** TURN *** [8d 9c 3s] [8s]
warioman: bets $0.98
Player#2543: calls $0.98
*** RIVER *** [8d 9c 3s] [8s] [3s]
warioman: bets $2.85
Player#2543: folds
warioman: doesn't show hand
Uncalled bet ($2.85) returned to warioman
warioman collected $3.10 from pot
*** SUMMARY ***
Total Pot $3.26 | Rake $0.16
Board [8d 9c 3s 8s 3s]
Seat 1: Player#6436 (small blind) folded before the flop
Seat 2: Player#2122 (big blind) folded before the flop
Seat 3: warioman
Seat 4: Player#2543 folded on the river
Seat 5: Player#8980 folded before the flop

PokerStars Hand #ebea89c5-d873-4aca-befe-b462f5c71786:  Hold'em No Limit ($0.05/$0.10 USD) - 2021/11/20 11:15:00 ET
Table 'Aberdeen' 6-max Seat #5 is the button
Seat 1: Player#8721 ($4.90 in chips)
Seat 2: Player#5223 ($7.13 in chips)
Seat 3: warioman ($16.45 in chips)
Seat 4: Player#9841 ($9.15 in chips)
Seat 5: Player#6671 ($10.60 in chips)
Seat 6: Player#7477 ($10.23 in chips)
Player#7477: posts small blind $0.05
Player#8721: posts big blind $0.10
*** HOLE CARDS ***
Dealt to warioman [2d 7h]
Player#5223: raises $0.10 to $0.3
warioman: folds
Player#9841: folds
Player#6671: folds
Player#7477: calls $0.25
Player#8721: folds
*** FLOP *** [6d 5c Qs]
Player#7477: bets $0.70
Player#5223: calls $0.70
*** TURN *** [6d 5c Qs] [9h]
Player#7477: bets $2.10
Player#5223: calls $2.10
*** RIVER *** [6d 5c Qs] [9h] [3h]
Player#7477: bets $7.13
Player#5223: calls $4.03
*** SHOW DOWN *** 
Player#5223 collected $16.59 from pot
*** SUMMARY ***
Total Pot $17.46 | Rake $0.87
Board [6d 5c Qs 9h 3h]
Seat 1: Player#8721 (big blind) folded before the flop
Seat 2: Player#5223 shows [As Qc] and won ($16.59) with 
Seat 3: warioman folded before the flop
Seat 4: Player#9841 folded before the flop
Seat 5: Player#6671 (button) folded before the flop
Seat 6: Player#7477 (small blind) mucked

PokerStars Hand #278593b6-c0ba-4b20-9675-097bee53dccb:  Hold'em No Limit ($0.1/$0.20 USD) - 2021/11/20 11:15:00 ET
Table 'Bethlehem' 6-max Seat #4 is the button
Seat 1: Player#1282 ($22.38 in chips)
Seat 2: Player#7590 ($20.29 in chips)
Seat 3: Player#1051 ($36.43 in chips)
Seat 4: Player#6709 ($30.78 in chips)
Seat 5: Player#5661 ($56.55 in chips)
Seat 6: warioman ($25.66 in chips)
Player#5661: posts small blind $0.10
warioman: posts big blind $0.20
*** HOLE CARDS ***
Dealt to warioman [9h 2h]
Player#1282: folds
Player#7590: folds
Player#1051: folds
Player#6709: raises $0.20 to $0.4
Player#5661: calls $0.30
warioman: folds
*** FLOP *** [Ad Ah 3s]
Player#5661: checks
Player#6709: checks
*** TURN *** [Ad Ah 3s] [8s]
Player#5661: checks
Player#6709: checks
*** RIVER *** [Ad Ah 3s] [8s] [6s]
Player#5661: checks
Player#6709: checks
*** SHOW DOWN *** 
Player#6709 collected $0.95 from pot
*** SUMMARY ***
Total Pot $1.00 | Rake $0.05
Board [Ad Ah 3s 8s 6s]
Seat 1: Player#1282 folded before the flop
Seat 2: Player#7590 folded before the flop
Seat 3: Player#1051 folded before the flop
Seat 4: Player#6709 shows [5d 3d] and won ($0.95) with 
Seat 5: Player#5661 (small blind) mucked
Seat 6: warioman (big blind) folded before the flop

PokerStars Hand #f6918e9b-0a78-44c2-82ac-49153852cd00:  Hold'em No Limit ($0.05/$0.10 USD) - 2021/11/20 11:14:00 ET
Table 'Aberdeen' 6-max Seat #4 is the button
Seat 1: Player#1287 ($4.39 in chips)
Seat 2: Player#6126 ($7.13 in chips)
Seat 3: warioman ($16.45 in chips)
Seat 4: Player#3431 ($9.25 in chips)
Seat 5: Player#4881 ($10.65 in chips)
Seat 6: Player#0966 ($10.63 in chips)
Player#4881: posts small blind $0.05
Player#0966: posts big blind $0.10
*** HOLE CARDS ***
Dealt to warioman [9h 3d]
Player#1287: calls $0.10
Player#6126: folds
warioman: folds
Player#3431: calls $0.10
Player#4881: folds
Player#0966: checks
*** FLOP *** [Td Js 7s]
Player#0966: checks
Player#1287: checks
Player#3431: checks
*** TURN *** [Td Js 7s] [4h]
Player#0966: checks
Player#1287: bets $0.30
Player#3431: folds
Player#0966: calls $0.30
*** RIVER *** [Td Js 7s] [4h] [9h]
Player#0966: checks
Player#1287: bets $0.95
Player#0966: folds
Player#1287: doesn't show hand
Uncalled bet ($0.95) returned to Player#1287
Player#1287 collected $0.90 from pot
*** SUMMARY ***
Total Pot $0.95 | Rake $0.05
Board [Td Js 7s 4h 9h]
Seat 1: Player#1287 shows [] and won ($0.90) with 
Seat 2: Player#6126 folded before the flop
Seat 3: warioman folded before the flop
Seat 4: Player#3431 (button) folded on the turn
Seat 5: Player#4881 (small blind) folded before the flop
Seat 6: Player#0966 (big blind) folded on the river

PokerStars Hand #3b6139f5-cf45-4c89-88c3-88035e3724e4:  Hold'em No Limit ($0.1/$0.20 USD) - 2021/11/20 11:14:00 ET
Table 'Bethlehem' 6-max Seat #3 is the button
Seat 1: Player#8117 ($22.38 in chips)
Seat 2: Player#5273 ($20.29 in chips)
Seat 3: Player#1892 ($35.39 in chips)
Seat 4: Player#8750 ($30.88 in chips)
Seat 5: Player#4089 ($57.60 in chips)
Seat 6: warioman ($25.66 in chips)
Player#8750: posts small blind $0.10
Player#4089: posts big blind $0.20
*** HOLE CARDS ***
Dealt to warioman [Td 4h]
warioman: folds
Player#8117: folds
Player#5273: folds
Player#1892: raises $0.20 to $0.6
Player#8750: folds
Player#4089: calls $0.40
*** FLOP *** [3d 2s 9h]
Player#4089: checks
Player#1892: bets $0.45
Player#4089: calls $0.45
*** TURN *** [3d 2s 9h] [6s]
Player#4089: checks
Player#1892: checks
*** RIVER *** [3d 2s 9h] [6s] [6s]
Player#4089: checks
Player#1892: checks
*** SHOW DOWN *** 
Player#1892 collected $2.09 from pot
*** SUMMARY ***
Total Pot $2.20 | Rake $0.11
Board [3d 2s 9h 6s 6s]
Seat 1: Player#8117 folded before the flop
Seat 2: Player#5273 folded before the flop
Seat 3: Player#1892 shows [As 8h] and won ($2.09) with 
Seat 4: Player#8750 (small blind) folded before the flop
Seat 5: Player#4089 (big blind) mucked
Seat 6: warioman folded before the flop

PokerStars Hand #66ad2dff-3db3-44b5-b8be-d6bdc6c4d526:  Hold'em No Limit ($0.1/$0.20 USD) - 2021/11/20 11:14:00 ET
Table 'Bel Air' 6-max Seat #4 is the button
Seat 1: Player#8189 ($18.37 in chips)
Seat 2: Player#6500 ($29.58 in chips)
Seat 3: warioman ($21.74 in chips)
Seat 4: Player#3593 ($27.95 in chips)
Seat 5: Player#6912 ($22.46 in chips)
Player#6912: posts small blind $0.10
Player#8189: posts big blind $0.20
*** HOLE CARDS ***
Dealt to warioman [Qc 9h]
Player#6500: folds
warioman: folds
Player#3593: folds
Player#6912: raises $0.20 to $0.6
Player#8189: calls $0.40
*** FLOP *** [Ts 4s 3s]
Player#6912: bets $0.90
Player#8189: calls $0.90
*** TURN *** [Ts 4s 3s] [4h]
Player#6912: bets $4.40
Player#8189: calls $4.40
*** RIVER *** [Ts 4s 3s] [4h] [Ah]
Player#6912: bets $16.56
Player#8189: calls $12.47
*** SHOW DOWN *** 
Player#8189 collected $39.33 from pot
*** SUMMARY ***
Total Pot $40.83 | Rake $1.50
Board [Ts 4s 3s 4h Ah]
Seat 1: Player#8189 shows [Qs 6s] and won ($39.33) with 
Seat 2: Player#6500 folded before the flop
Seat 3: warioman folded before the flop
Seat 4: Player#3593 (button) folded before the flop
Seat 5: Player#6912 (small blind) mucked

PokerStars Hand #2d3aaa95-e7a3-4a2d-ab8e-f7f0085a3cb5:  Hold'em No Limit ($0.1/$0.20 USD) - 2021/11/20 11:14:00 ET
Table 'Bel Air' 6-max Seat #3 is the button
Seat 1: Player#6130 ($18.37 in chips)
Seat 2: Player#7843 ($29.58 in chips)
Seat 3: warioman ($21.74 in chips)
Seat 4: Player#1276 ($28.05 in chips)
Seat 5: Player#2946 ($22.36 in chips)
Player#1276: posts small blind $0.10
Player#2946: posts big blind $0.20
*** HOLE CARDS ***
Dealt to warioman [6s Ad]
Player#6130: folds
Player#7843: folds
warioman: folds
Player#1276: folds
Player#2946 collected $0.20 from pot
*** SUMMARY ***
Total Pot $0.20 | Rake $0.00
Seat 1: Player#6130 folded before the flop
Seat 2: Player#7843 folded before the flop
Seat 3: warioman (button) folded before the flop
Seat 4: Player#1276 (small blind) folded before the flop
Seat 5: Player#2946 shows [] and won ($0.20) with 

PokerStars Hand #348fbb2d-854c-4cfb-ad95-7272142d559b:  Hold'em No Limit ($0.1/$0.20 USD) - 2021/11/20 11:14:00 ET
Table 'Bel Air' 6-max Seat #2 is the button
Seat 1: Player#8158 ($18.37 in chips)
Seat 2: Player#2030 ($29.28 in chips)
Seat 3: warioman ($21.84 in chips)
Seat 4: Player#3229 ($28.25 in chips)
Seat 5: Player#1606 ($22.36 in chips)
warioman: posts small blind $0.10
Player#3229: posts big blind $0.20
*** HOLE CARDS ***
Dealt to warioman [4d 8h]
Player#1606: folds
Player#8158: folds
Player#2030: raises $0.20 to $0.7
warioman: folds
Player#3229: folds
Player#2030: doesn't show hand
Uncalled bet ($0.70) returned to Player#2030
Player#2030 collected $0.30 from pot
*** SUMMARY ***
Total Pot $0.30 | Rake $0.00
Seat 1: Player#8158 folded before the flop
Seat 2: Player#2030 shows [] and won ($0.30) with 
Seat 3: warioman (small blind) folded before the flop
Seat 4: Player#3229 (big blind) folded before the flop
Seat 5: Player#1606 folded before the flop

PokerStars Hand #3542abfe-ab2e-4965-b022-7a8661358c25:  Hold'em No Limit ($0.05/$0.10 USD) - 2021/11/20 11:13:00 ET
Table 'Aberdeen' 6-max Seat #3 is the button
Seat 1: Player#5127 ($4.59 in chips)
Seat 2: Player#5803 ($7.33 in chips)
Seat 3: warioman ($16.45 in chips)
Seat 4: Player#1141 ($9.30 in chips)
Seat 5: Player#1705 ($10.04 in chips)
Seat 6: Player#5921 ($10.83 in chips)
Player#1141: posts small blind $0.05
Player#1705: posts big blind $0.10
*** HOLE CARDS ***
Dealt to warioman [6d Ah]
Player#5803 Entry Bet 0.1
Player#5921: raises $0.10 to $0.2
Player#5127: calls $0.20
Player#5803: calls $0.10
warioman: folds
Player#1141: folds
Player#1705: calls $0.10
*** FLOP *** [Kh 5s 6h]
Player#1705: checks
Player#5921: checks
Player#5127: checks
Player#5803: checks
*** TURN *** [Kh 5s 6h] [6s]
Player#1705: bets $0.32
Player#5921: folds
Player#5127: folds
Player#5803: folds
Player#5127: doesn't show hand
Player#5803: doesn't show hand
warioman: doesn't show hand
Player#1141: doesn't show hand
Player#1705: doesn't show hand
Player#5921: doesn't show hand
Uncalled bet ($0.32) returned to Player#1705
Player#1705 collected $0.71 from pot
*** SUMMARY ***
Total Pot $0.75 | Rake $0.04
Board [Kh 5s 6h 6s]
Seat 1: Player#5127 folded on the turn
Seat 2: Player#5803 folded on the turn
Seat 3: warioman (button) folded before the flop
Seat 4: Player#1141 (small blind) folded before the flop
Seat 5: Player#1705 shows [] and won ($0.71) with 
Seat 6: Player#5921 folded on the turn

PokerStars Hand #fe84f85e-6c75-4a0e-bedc-32d28c234b5a:  Hold'em No Limit ($0.1/$0.20 USD) - 2021/11/20 11:13:00 ET
Table 'Bethlehem' 6-max Seat #2 is the button
Seat 1: Player#0511 ($22.38 in chips)
Seat 2: Player#6704 ($20.29 in chips)
Seat 3: Player#9275 ($36.29 in chips)
Seat 4: Player#6561 ($31.08 in chips)
Seat 5: Player#0698 ($57.60 in chips)
Seat 6: warioman ($26.56 in chips)
Player#9275: posts small blind $0.10
Player#6561: posts big blind $0.20
*** HOLE CARDS ***
Dealt to warioman [Kc Ad]
Player#0698: folds
warioman: raises $0.20 to $0.5
Player#0511: folds
Player#6704: folds
Player#9275: raises $0.50 to $2.1
Player#6561: folds
warioman: raises $2.10 to $4.5
Player#9275: raises $ 34.50 to $36.29
warioman: calls $22.06
Player#9275 Showing Pocket Cards KA
warioman Showing Pocket Cards KA
*** FLOP *** [7h Js 5c]
*** TURN *** [7h Js 5c] [8d]
*** RIVER *** [7h Js 5c] [8d] [2s]
 *** SUMMARY ***
Total Pot $63.05 | Rake $1.50
Board [7h Js 5c 8d 2s]
Seat 1: Player#0511 folded before the flop
Seat 2: Player#6704 (button) folded before the flop
Seat 3: Player#9275 (small blind) mucked
Seat 4: Player#6561 (big blind) folded before the flop
Seat 5: Player#0698 folded before the flop
Seat 6: warioman

PokerStars Hand #ff51d3ff-22eb-42f5-aeaa-0d78f6e0fed5:  Hold'em No Limit ($0.1/$0.20 USD) - 2021/11/20 11:13:00 ET
Table 'Bel Air' 6-max Seat #1 is the button
Seat 1: Player#7104 ($18.37 in chips)
Seat 2: Player#4870 ($29.08 in chips)
Seat 3: warioman ($22.04 in chips)
Seat 4: Player#4176 ($28.25 in chips)
Seat 5: Player#0050 ($22.36 in chips)
Player#4870: posts small blind $0.10
warioman: posts big blind $0.20
*** HOLE CARDS ***
Dealt to warioman [Ts 5d]
Player#4176: folds
Player#0050: folds
Player#7104: folds
Player#4870: raises $0.20 to $0.6
warioman: folds
Player#4870: doesn't show hand
Uncalled bet ($0.60) returned to Player#4870
Player#4870 collected $0.20 from pot
*** SUMMARY ***
Total Pot $0.20 | Rake $0.00
Seat 1: Player#7104 (button) folded before the flop
Seat 2: Player#4870 shows [] and won ($0.20) with 
Seat 3: warioman (big blind) folded before the flop
Seat 4: Player#4176 folded before the flop
Seat 5: Player#0050 folded before the flop

PokerStars Hand #c1d0b0ce-f1a7-4cb1-858d-0427705bb0b3:  Hold'em No Limit ($0.1/$0.20 USD) - 2021/11/20 11:13:00 ET
Table 'Bel Air' 6-max Seat #6 is the button
Seat 1: Player#7003 ($18.47 in chips)
Seat 2: Player#6972 ($30.53 in chips)
Seat 3: warioman ($22.04 in chips)
Seat 4: Player#0596 ($28.25 in chips)
Seat 5: Player#5528 ($20.96 in chips)
Player#7003: posts small blind $0.10
Player#6972: posts big blind $0.20
*** HOLE CARDS ***
Dealt to warioman [Th 4h]
warioman: folds
Player#0596: folds
Player#5528: raises $0.20 to $0.7
Player#7003: folds
Player#6972: calls $0.50
*** FLOP *** [Jc 9h 9s]
Player#6972: checks
Player#5528: bets $0.75
Player#6972: calls $0.75
*** TURN *** [Jc 9h 9s] [5d]
Player#6972: checks
Player#5528: bets $1.50
Player#6972: folds
Player#5528: doesn't show hand
Uncalled bet ($1.50) returned to Player#5528
Player#5528 collected $2.85 from pot
*** SUMMARY ***
Total Pot $3.00 | Rake $0.15
Board [Jc 9h 9s 5d]
Seat 1: Player#7003 (small blind) folded before the flop
Seat 2: Player#6972 (big blind) folded on the turn
Seat 3: warioman folded before the flop
Seat 4: Player#0596 folded before the flop
Seat 5: Player#5528 shows [] and won ($2.85) with 

PokerStars Hand #3ac600b2-69e7-4025-af1f-66ce7f880b92:  Hold'em No Limit ($0.05/$0.10 USD) - 2021/11/20 11:13:00 ET
Table 'Aberdeen' 6-max Seat #1 is the button
Seat 1: Player#1563 ($3.24 in chips)
Seat 2: warioman ($16.50 in chips)
Seat 3: Player#2680 ($10.00 in chips)
Seat 4: Player#2467 ($10.74 in chips)
Seat 5: Player#2949 ($10.83 in chips)
warioman: posts small blind $0.05
Player#2680: posts big blind $0.10
*** HOLE CARDS ***
Dealt to warioman [8c 7d]
Player#2467: raises $0.10 to $0.3
Player#2949: folds
Player#1563: raises $0.30 to $0.7
warioman: folds
Player#2680: calls $0.60
Player#2467: calls $0.40
*** FLOP *** [3h 4c 4s]
Player#2680: checks
Player#2467: checks
Player#1563: bets $0.60
Player#2680: folds
Player#2467: folds
Player#1563: doesn't show hand
Uncalled bet ($0.60) returned to Player#1563
Player#1563 collected $2.04 from pot
*** SUMMARY ***
Total Pot $2.15 | Rake $0.11
Board [3h 4c 4s]
Seat 1: Player#1563 shows [] and won ($2.04) with 
Seat 2: warioman (small blind) folded before the flop
Seat 3: Player#2680 (big blind) folded on the flop
Seat 4: Player#2467 folded on the flop
Seat 5: Player#2949 folded before the flop

PokerStars Hand #a060e2a4-e10c-425d-8e37-9557bc04be69:  Hold'em No Limit ($0.1/$0.20 USD) - 2021/11/20 11:12:00 ET
Table 'Bel Air' 6-max Seat #4 is the button
Seat 1: Player#8590 ($18.87 in chips)
Seat 2: Player#2612 ($30.07 in chips)
Seat 3: warioman ($22.04 in chips)
Seat 4: Player#9210 ($28.25 in chips)
Seat 5: Player#0616 ($21.06 in chips)
Player#0616: posts small blind $0.10
Player#8590: posts big blind $0.20
*** HOLE CARDS ***
Dealt to warioman [5h Ts]
Player#2612 Entry Bet 0.2
Player#2612: checks
warioman: folds
Player#9210: folds
Player#0616: folds
Player#8590: checks
*** FLOP *** [Ad 9h 4h]
Player#8590: bets $0.20
Player#2612: calls $0.20
*** TURN *** [Ad 9h 4h] [Kh]
Player#8590: checks
Player#2612: checks
*** RIVER *** [Ad 9h 4h] [Kh] [2h]
Player#8590: checks
Player#2612: checks
*** SHOW DOWN *** 
Player#2612 collected $0.66 from pot
*** SUMMARY ***
Total Pot $0.70 | Rake $0.03
Board [Ad 9h 4h Kh 2h]
Seat 1: Player#8590 (big blind) mucked
Seat 2: Player#2612 shows [9d 7c] and won ($0.66) with 
Seat 3: warioman folded before the flop
Seat 4: Player#9210 (button) folded before the flop
Seat 5: Player#0616 (small blind) folded before the flop

PokerStars Hand #07b7c45f-a226-4405-ac15-c901f335ab14:  Hold'em No Limit ($0.1/$0.20 USD) - 2021/11/20 11:12:00 ET
Table 'Bethlehem' 6-max Seat #1 is the button
Seat 1: Player#7172 ($24.33 in chips)
Seat 2: Player#3495 ($20.39 in chips)
Seat 3: Player#8020 ($36.49 in chips)
Seat 4: Player#0992 ($31.08 in chips)
Seat 5: Player#7206 ($55.56 in chips)
Seat 6: warioman ($26.56 in chips)
Player#3495: posts small blind $0.10
Player#8020: posts big blind $0.20
*** HOLE CARDS ***
Dealt to warioman [Kc 5d]
Player#0992: folds
Player#7206: calls $0.20
warioman: folds
Player#7172: raises $0.20 to $0.9
Player#3495: folds
Player#8020: folds
Player#7206: calls $0.70
*** FLOP *** [5h 9s Th]
Player#7206: checks
Player#7172: bets $1.05
Player#7206: raises $1.05 to $3.94
Player#7172: folds
Player#7172: doesn't show hand
Player#3495: doesn't show hand
Player#8020: doesn't show hand
Player#0992: doesn't show hand
Player#7206: doesn't show hand
warioman: doesn't show hand
Uncalled bet ($3.94) returned to Player#7206
Player#7206 collected $2.99 from pot
*** SUMMARY ***
Total Pot $3.15 | Rake $0.16
Board [5h 9s Th]
Seat 1: Player#7172 (button) folded on the flop
Seat 2: Player#3495 (small blind) folded before the flop
Seat 3: Player#8020 (big blind) folded before the flop
Seat 4: Player#0992 folded before the flop
Seat 5: Player#7206 shows [] and won ($2.99) with 
Seat 6: warioman folded before the flop

PokerStars Hand #4e714f75-f209-4ad1-95f8-673a23545e12:  Hold'em No Limit ($0.1/$0.20 USD) - 2021/11/20 11:12:00 ET
Table 'Bel Air' 6-max Seat #2 is the button
Seat 1: Player#1288 ($18.87 in chips)
Seat 2: warioman ($21.74 in chips)
Seat 3: Player#1636 ($28.35 in chips)
Seat 4: Player#8429 ($21.26 in chips)
Player#1636: posts small blind $0.10
Player#8429: posts big blind $0.20
*** HOLE CARDS ***
Dealt to warioman [6s As]
Player#1288: folds
warioman: raises $0.20 to $0.5
Player#1636: folds
Player#8429: folds
warioman: doesn't show hand
Uncalled bet ($0.50) returned to warioman
warioman collected $0.30 from pot
*** SUMMARY ***
Total Pot $0.30 | Rake $0.00
Seat 1: Player#1288 folded before the flop
Seat 2: warioman (button)
Seat 3: Player#1636 (small blind) folded before the flop
Seat 4: Player#8429 (big blind) folded before the flop

PokerStars Hand #53ab2b08-1b00-4f47-aa9c-ceef16069332:  Hold'em No Limit ($0.05/$0.10 USD) - 2021/11/20 11:12:00 ET
Table 'Aberdeen' 6-max Seat #3 is the button
Seat 1: Player#8488 ($3.10 in chips)
Seat 2: Player#6349 ($29.44 in chips)
Seat 3: warioman ($16.60 in chips)
Seat 4: Player#9868 ($10.00 in chips)
Seat 5: Player#4999 ($10.74 in chips)
Seat 6: Player#2797 ($10.83 in chips)
Player#9868: posts small blind $0.05
Player#6349: posts big blind $0.10
*** HOLE CARDS ***
Dealt to warioman [7d 8h]
Player#9868 Waiting
Player#4999: folds
Player#2797: folds
Player#8488: calls $0.10
Player#6349: folds
warioman: checks
*** FLOP *** [Kc Ad 6d]
warioman: checks
Player#8488: bets $0.20
warioman: folds
Player#8488: doesn't show hand
Uncalled bet ($0.20) returned to Player#8488
Player#8488 collected $0.24 from pot
*** SUMMARY ***
Total Pot $0.25 | Rake $0.01
Board [Kc Ad 6d]
Seat 1: Player#8488 shows [] and won ($0.24) with 
Seat 2: Player#6349 (big blind) folded before the flop
Seat 3: warioman (button) folded on the flop
Seat 4: Player#9868 (small blind) mucked
Seat 5: Player#4999 folded before the flop
Seat 6: Player#2797 folded before the flop

PokerStars Hand #17ebb023-a66b-41ba-a393-4107e362c524:  Hold'em No Limit ($0.1/$0.20 USD) - 2021/11/20 11:12:00 ET
Table 'Bel Air' 6-max Seat #1 is the button
Seat 1: Player#5466 ($18.87 in chips)
Seat 2: warioman ($21.84 in chips)
Seat 3: Player#7768 ($28.55 in chips)
Seat 4: Player#8824 ($20.96 in chips)
warioman: posts small blind $0.10
Player#7768: posts big blind $0.20
*** HOLE CARDS ***
Dealt to warioman [Th 2s]
Player#8824: raises $0.20 to $0.7
Player#5466: folds
warioman: folds
Player#7768: folds
Player#8824: doesn't show hand
Uncalled bet ($0.70) returned to Player#8824
Player#8824 collected $0.30 from pot
*** SUMMARY ***
Total Pot $0.30 | Rake $0.00
Seat 1: Player#5466 (button) folded before the flop
Seat 2: warioman (small blind) folded before the flop
Seat 3: Player#7768 (big blind) folded before the flop
Seat 4: Player#8824 shows [] and won ($0.30) with 

PokerStars Hand #480a5d01-5c49-45f2-9504-fad86a915c6e:  Hold'em No Limit ($0.1/$0.20 USD) - 2021/11/20 11:12:00 ET
Table 'Bethlehem' 6-max Seat #6 is the button
Seat 1: Player#6903 ($24.13 in chips)
Seat 2: Player#1051 ($20.59 in chips)
Seat 3: Player#9194 ($36.49 in chips)
Seat 4: Player#8404 ($31.08 in chips)
Seat 5: Player#9002 ($55.56 in chips)
Seat 6: warioman ($26.56 in chips)
Player#6903: posts small blind $0.10
Player#1051: posts big blind $0.20
*** HOLE CARDS ***
Dealt to warioman [4c 3s]
Player#9194: folds
Player#8404: folds
Player#9002: folds
warioman: folds
Player#6903: raises $0.20 to $0.6
Player#1051: folds
Player#6903: doesn't show hand
Uncalled bet ($0.60) returned to Player#6903
Player#6903 collected $0.20 from pot
*** SUMMARY ***
Total Pot $0.20 | Rake $0.00
Seat 1: Player#6903 shows [] and won ($0.20) with 
Seat 2: Player#1051 (big blind) folded before the flop
Seat 3: Player#9194 folded before the flop
Seat 4: Player#8404 folded before the flop
Seat 5: Player#9002 folded before the flop
Seat 6: warioman (button) folded before the flop

PokerStars Hand #6d31f2f2-dccb-462f-afeb-55e81e99bc04:  Hold'em No Limit ($0.05/$0.10 USD) - 2021/11/20 11:12:00 ET
Table 'Aberdeen' 6-max Seat #3 is the button
Seat 1: Player#2893 ($3.20 in chips)
Seat 2: Player#0243 ($29.34 in chips)
Seat 3: warioman ($16.60 in chips)
Seat 4: Player#5369 ($10.00 in chips)
Seat 5: Player#6155 ($10.74 in chips)
Seat 6: Player#6822 ($10.83 in chips)
Player#5369: posts small blind $0.05
Player#2893: posts big blind $0.10
*** HOLE CARDS ***
Dealt to warioman [7d 4h]
Player#5369 Waiting
warioman: folds
Player#6155: folds
Player#6822: folds
Player#2893: calls $0.05
Player#0243: raises $0.10 to $0.3
Player#2893: folds
Player#0243: doesn't show hand
Uncalled bet ($0.30) returned to Player#0243
Player#0243 collected $0.10 from pot
*** SUMMARY ***
Total Pot $0.10 | Rake $0.00
Seat 1: Player#2893 (big blind) folded before the flop
Seat 2: Player#0243 shows [] and won ($0.10) with 
Seat 3: warioman (button) folded before the flop
Seat 4: Player#5369 (small blind) mucked
Seat 5: Player#6155 folded before the flop
Seat 6: Player#6822 folded before the flop

PokerStars Hand #5e25386b-76c1-462f-8137-1002451e4f76:  Hold'em No Limit ($0.1/$0.20 USD) - 2021/11/20 11:12:00 ET
Table 'Bel Air' 6-max Seat #6 is the button
Seat 1: Player#9082 ($18.97 in chips)
Seat 2: warioman ($22.04 in chips)
Seat 3: Player#1425 ($28.25 in chips)
Seat 4: Player#0938 ($20.96 in chips)
Player#9082: posts small blind $0.10
warioman: posts big blind $0.20
*** HOLE CARDS ***
Dealt to warioman [4d 6s]
Player#1425: raises $0.20 to $0.6
Player#0938: folds
Player#9082: folds
warioman: folds
Player#1425: doesn't show hand
Uncalled bet ($0.60) returned to Player#1425
Player#1425 collected $0.30 from pot
*** SUMMARY ***
Total Pot $0.30 | Rake $0.00
Seat 1: Player#9082 (small blind) folded before the flop
Seat 2: warioman (big blind) folded before the flop
Seat 3: Player#1425 shows [] and won ($0.30) with 
Seat 4: Player#0938 folded before the flop

PokerStars Hand #5ea68b5b-731e-46a7-aaff-75fea81618cb:  Hold'em No Limit ($0.1/$0.20 USD) - 2021/11/20 11:12:00 ET
Table 'Bel Air' 6-max Seat #3 is the button
Seat 1: Player#5445 ($19.17 in chips)
Seat 2: warioman ($22.04 in chips)
Seat 3: Player#6620 ($27.95 in chips)
Seat 4: Player#0212 ($21.06 in chips)
Player#0212: posts small blind $0.10
Player#5445: posts big blind $0.20
*** HOLE CARDS ***
Dealt to warioman [7s 6h]
warioman: folds
Player#6620: raises $0.20 to $0.6
Player#0212: folds
Player#5445: folds
Player#6620: doesn't show hand
Uncalled bet ($0.60) returned to Player#6620
Player#6620 collected $0.30 from pot
*** SUMMARY ***
Total Pot $0.30 | Rake $0.00
Seat 1: Player#5445 (big blind) folded before the flop
Seat 2: warioman folded before the flop
Seat 3: Player#6620 shows [] and won ($0.30) with 
Seat 4: Player#0212 (small blind) folded before the flop

PokerStars Hand #9a63bf5b-a111-43c4-9074-639e96cfaa43:  Hold'em No Limit ($0.1/$0.20 USD) - 2021/11/20 11:11:00 ET
Table 'Bethlehem' 6-max Seat #5 is the button
Seat 1: Player#8761 ($24.33 in chips)
Seat 2: Player#7988 ($19.40 in chips)
Seat 3: Player#2512 ($36.49 in chips)
Seat 4: Player#4763 ($31.08 in chips)
Seat 5: Player#8776 ($56.56 in chips)
Seat 6: warioman ($26.66 in chips)
warioman: posts small blind $0.10
Player#8761: posts big blind $0.20
*** HOLE CARDS ***
Dealt to warioman [7d Ts]
Player#7988: raises0.20 to $1
Player#2512: folds
Player#4763: folds
Player#8776: calls $1.00
warioman: folds
Player#8761: folds
*** FLOP *** [Ad 9c 3d]
Player#7988: checks
Player#8776: checks
*** TURN *** [Ad 9c 3d] [3s]
Player#7988: bets $1.15
Player#8776: folds
Player#7988: doesn't show hand
Uncalled bet ($1.15) returned to Player#7988
Player#7988 collected $2.19 from pot
*** SUMMARY ***
Total Pot $2.30 | Rake $0.12
Board [Ad 9c 3d 3s]
Seat 1: Player#8761 (big blind) folded before the flop
Seat 2: Player#7988 shows [] and won ($2.19) with 
Seat 3: Player#2512 folded before the flop
Seat 4: Player#4763 folded before the flop
Seat 5: Player#8776 (button) folded on the turn
Seat 6: warioman (small blind) folded before the flop

PokerStars Hand #ff93a554-ea6d-4d5b-b147-15e836cdb53d:  Hold'em No Limit ($0.1/$0.20 USD) - 2021/11/20 11:11:00 ET
Table 'Bel Air' 6-max Seat #2 is the button
Seat 1: Player#2538 ($19.17 in chips)
Seat 2: warioman ($23.54 in chips)
Seat 3: Player#3669 ($26.41 in chips)
Seat 4: Player#7263 ($21.26 in chips)
Player#3669: posts small blind $0.10
Player#7263: posts big blind $0.20
*** HOLE CARDS ***
Dealt to warioman [Ad 9d]
Player#2538: folds
warioman: raises $0.20 to $0.5
Player#3669: raises $0.50 to $1.5
Player#7263: folds
warioman: calls $1.00
*** FLOP *** [3h Ks Ts]
Player#3669: bets $1.60
warioman: folds
Player#3669: doesn't show hand
Uncalled bet ($1.60) returned to Player#3669
Player#3669 collected $3.04 from pot
*** SUMMARY ***
Total Pot $3.20 | Rake $0.16
Board [3h Ks Ts]
Seat 1: Player#2538 folded before the flop
Seat 2: warioman (button) folded on the flop
Seat 3: Player#3669 shows [] and won ($3.04) with 
Seat 4: Player#7263 (big blind) folded before the flop

PokerStars Hand #2e06e6b2-9701-413a-819b-cdf53200295d:  Hold'em No Limit ($0.05/$0.10 USD) - 2021/11/20 11:11:00 ET
Table 'Aberdeen' 6-max Seat #3 is the button
Seat 1: Player#8399 ($3.50 in chips)
Seat 2: Player#4253 ($29.02 in chips)
Seat 3: warioman ($16.60 in chips)
Seat 4: Player#9323 ($10.00 in chips)
Seat 5: Player#3936 ($10.74 in chips)
Seat 6: Player#4791 ($10.88 in chips)
Player#9323: posts small blind $0.05
Player#4791: posts big blind $0.10
*** HOLE CARDS ***
Dealt to warioman [Th 6h]
Player#9323 Waiting
Player#4253: raises $0.10 to $0.3
warioman: folds
Player#3936: folds
Player#4791: folds
Player#8399: calls $0.20
*** FLOP *** [2d 3c 5h]
Player#8399: checks
Player#4253: bets $0.40
Player#8399: folds
Player#4253: doesn't show hand
Uncalled bet ($0.40) returned to Player#4253
Player#4253 collected $0.62 from pot
*** SUMMARY ***
Total Pot $0.65 | Rake $0.03
Board [2d 3c 5h]
Seat 1: Player#8399 folded on the flop
Seat 2: Player#4253 shows [] and won ($0.62) with 
Seat 3: warioman (button) folded before the flop
Seat 4: Player#9323 (small blind) mucked
Seat 5: Player#3936 folded before the flop
Seat 6: Player#4791 (big blind) folded before the flop

PokerStars Hand #890c204c-935b-4205-8ae2-a9a66eec5929:  Hold'em No Limit ($0.1/$0.20 USD) - 2021/11/20 11:11:00 ET
Table 'Bethlehem' 6-max Seat #4 is the button
Seat 1: Player#7860 ($24.33 in chips)
Seat 2: Player#0331 ($19.40 in chips)
Seat 3: Player#6482 ($36.19 in chips)
Seat 4: Player#1381 ($31.08 in chips)
Seat 5: Player#6235 ($56.66 in chips)
Seat 6: warioman ($26.86 in chips)
Player#6235: posts small blind $0.10
warioman: posts big blind $0.20
*** HOLE CARDS ***
Dealt to warioman [2h Kc]
Player#7860: folds
Player#0331: folds
Player#6482: raises $0.20 to $0.8
Player#1381: folds
Player#6235: folds
warioman: folds
Player#6482: doesn't show hand
Uncalled bet ($0.80) returned to Player#6482
Player#6482 collected $0.30 from pot
*** SUMMARY ***
Total Pot $0.30 | Rake $0.00
Seat 1: Player#7860 folded before the flop
Seat 2: Player#0331 folded before the flop
Seat 3: Player#6482 shows [] and won ($0.30) with 
Seat 4: Player#1381 (button) folded before the flop
Seat 5: Player#6235 (small blind) folded before the flop
Seat 6: warioman (big blind) folded before the flop

PokerStars Hand #97e889bd-b8d1-4426-8248-8042dcfd33db:  Hold'em No Limit ($0.1/$0.20 USD) - 2021/11/20 11:11:00 ET
Table 'Bel Air' 6-max Seat #1 is the button
Seat 1: Player#9364 ($19.17 in chips)
Seat 2: warioman ($23.34 in chips)
Seat 3: Player#5937 ($26.61 in chips)
Seat 4: Player#3652 ($21.26 in chips)
warioman: posts small blind $0.10
Player#5937: posts big blind $0.20
*** HOLE CARDS ***
Dealt to warioman [Kd Js]
Player#3652: folds
Player#9364: folds
warioman: raises $0.20 to $0.6
Player#5937: folds
warioman: doesn't show hand
Uncalled bet ($0.60) returned to warioman
warioman collected $0.20 from pot
*** SUMMARY ***
Total Pot $0.20 | Rake $0.00
Seat 1: Player#9364 (button) folded before the flop
Seat 2: warioman (small blind)
Seat 3: Player#5937 (big blind) folded before the flop
Seat 4: Player#3652 folded before the flop

PokerStars Hand #c801eb0e-4651-4d03-9e67-f0a300bc3ff9:  Hold'em No Limit ($0.1/$0.20 USD) - 2021/11/20 11:11:00 ET
Table 'Bethlehem' 6-max Seat #3 is the button
Seat 1: Player#7232 ($24.33 in chips)
Seat 2: Player#8483 ($19.40 in chips)
Seat 3: Player#9653 ($36.19 in chips)
Seat 4: Player#7950 ($31.18 in chips)
Seat 5: Player#3946 ($56.56 in chips)
Seat 6: warioman ($26.86 in chips)
Player#7950: posts small blind $0.10
Player#3946: posts big blind $0.20
*** HOLE CARDS ***
Dealt to warioman [5s 3d]
warioman: folds
Player#7232: folds
Player#8483: folds
Player#9653: folds
Player#7950: folds
Player#3946 collected $0.20 from pot
*** SUMMARY ***
Total Pot $0.20 | Rake $0.00
Seat 1: Player#7232 folded before the flop
Seat 2: Player#8483 folded before the flop
Seat 3: Player#9653 (button) folded before the flop
Seat 4: Player#7950 (small blind) folded before the flop
Seat 5: Player#3946 shows [] and won ($0.20) with 
Seat 6: warioman folded before the flop

PokerStars Hand #149287b8-6eac-45eb-80be-54f6176faff1:  Hold'em No Limit ($0.1/$0.20 USD) - 2021/11/20 11:11:00 ET
Table 'Bel Air' 6-max Seat #6 is the button
Seat 1: Player#6750 ($19.27 in chips)
Seat 2: warioman ($23.54 in chips)
Seat 3: Player#6208 ($26.31 in chips)
Seat 4: Player#1350 ($21.26 in chips)
Player#6750: posts small blind $0.10
warioman: posts big blind $0.20
*** HOLE CARDS ***
Dealt to warioman [Qc Th]
Player#6208: raises $0.20 to $0.6
Player#1350: folds
Player#6750: folds
warioman: folds
Player#6208: doesn't show hand
Uncalled bet ($0.60) returned to Player#6208
Player#6208 collected $0.30 from pot
*** SUMMARY ***
Total Pot $0.30 | Rake $0.00
Seat 1: Player#6750 (small blind) folded before the flop
Seat 2: warioman (big blind) folded before the flop
Seat 3: Player#6208 shows [] and won ($0.30) with 
Seat 4: Player#1350 folded before the flop

PokerStars Hand #e1485d9a-d1e2-4f93-9ce3-33c3352d5066:  Hold'em No Limit ($0.1/$0.20 USD) - 2021/11/20 11:11:00 ET
Table 'Bethlehem' 6-max Seat #2 is the button
Seat 1: Player#3257 ($24.33 in chips)
Seat 2: Player#5757 ($19.40 in chips)
Seat 3: Player#0516 ($35.99 in chips)
Seat 4: Player#5253 ($31.38 in chips)
Seat 5: Player#3704 ($56.56 in chips)
Seat 6: warioman ($26.86 in chips)
Player#0516: posts small blind $0.10
Player#5253: posts big blind $0.20
*** HOLE CARDS ***
Dealt to warioman [Th 8c]
Player#3704: folds
warioman: folds
Player#3257: folds
Player#5757: folds
Player#0516: raises $0.20 to $0.6
Player#5253: folds
Player#0516: doesn't show hand
Uncalled bet ($0.60) returned to Player#0516
Player#0516 collected $0.20 from pot
*** SUMMARY ***
Total Pot $0.20 | Rake $0.00
Seat 1: Player#3257 folded before the flop
Seat 2: Player#5757 (button) folded before the flop
Seat 3: Player#0516 shows [] and won ($0.20) with 
Seat 4: Player#5253 (big blind) folded before the flop
Seat 5: Player#3704 folded before the flop
Seat 6: warioman folded before the flop

PokerStars Hand #adbb850b-738e-48e7-b38a-3e2b5a1dbd0a:  Hold'em No Limit ($0.1/$0.20 USD) - 2021/11/20 11:11:00 ET
Table 'Bel Air' 6-max Seat #3 is the button
Seat 1: Player#4389 ($19.47 in chips)
Seat 2: warioman ($23.54 in chips)
Seat 3: Player#6627 ($26.01 in chips)
Seat 4: Player#4080 ($21.36 in chips)
Player#4080: posts small blind $0.10
Player#4389: posts big blind $0.20
*** HOLE CARDS ***
Dealt to warioman [2c As]
warioman: folds
Player#6627: raises $0.20 to $0.7
Player#4080: folds
Player#4389: folds
Player#6627: doesn't show hand
Uncalled bet ($0.70) returned to Player#6627
Player#6627 collected $0.30 from pot
*** SUMMARY ***
Total Pot $0.30 | Rake $0.00
Seat 1: Player#4389 (big blind) folded before the flop
Seat 2: warioman folded before the flop
Seat 3: Player#6627 shows [] and won ($0.30) with 
Seat 4: Player#4080 (small blind) folded before the flop

PokerStars Hand #4d688a4a-f22d-475a-a4e9-ec27f83b4df1:  Hold'em No Limit ($0.05/$0.10 USD) - 2021/11/20 11:10:00 ET
Table 'Aberdeen' 6-max Seat #3 is the button
Seat 1: Player#7711 ($3.60 in chips)
Seat 2: Player#1714 ($29.02 in chips)
Seat 3: warioman ($16.75 in chips)
Seat 4: Player#7758 ($10.41 in chips)
Seat 5: Player#1858 ($10.98 in chips)
Player#7758: posts small blind $0.05
Player#1858: posts big blind $0.10
*** HOLE CARDS ***
Dealt to warioman [Td 2h]
warioman BB + Dead Small 0.15
Player#7711: calls $0.10
Player#1714: folds
warioman: checks
Player#7758: calls $0.05
Player#1858: checks
*** FLOP *** [6h Ks 9c]
Player#7758: checks
Player#1858: checks
Player#7711: checks
warioman: checks
*** TURN *** [6h Ks 9c] [7c]
Player#7758: bets $0.30
Player#1858: folds
Player#7711: folds
warioman: folds
Player#7711: doesn't show hand
Player#1714: doesn't show hand
warioman: doesn't show hand
Player#7758: doesn't show hand
Player#1858: doesn't show hand
Uncalled bet ($0.30) returned to Player#7758
Player#7758 collected $0.29 from pot
*** SUMMARY ***
Total Pot $0.30 | Rake $0.02
Board [6h Ks 9c 7c]
Seat 1: Player#7711 folded on the turn
Seat 2: Player#1714 folded before the flop
Seat 3: warioman (button) folded on the turn
Seat 4: Player#7758 shows [] and won ($0.29) with 
Seat 5: Player#1858 (big blind) folded on the turn

PokerStars Hand #8e2b7175-9eac-48ac-b6ab-597f3374693e:  Hold'em No Limit ($0.1/$0.20 USD) - 2021/11/20 11:10:00 ET
Table 'Bethlehem' 6-max Seat #1 is the button
Seat 1: Player#1493 ($24.33 in chips)
Seat 2: Player#4977 ($19.50 in chips)
Seat 3: Player#1182 ($35.59 in chips)
Seat 4: Player#8395 ($31.38 in chips)
Seat 5: Player#9955 ($56.56 in chips)
Seat 6: warioman ($27.16 in chips)
Player#4977: posts small blind $0.10
Player#1182: posts big blind $0.20
*** HOLE CARDS ***
Dealt to warioman [4c 8s]
warioman BB + Dead Small 0.3
Player#8395: folds
Player#9955: folds
warioman: checks
Player#1493: folds
Player#4977: folds
Player#1182: raises0.20 to $1
warioman: folds
Player#1182: doesn't show hand
Uncalled bet ($1.00) returned to Player#1182
Player#1182 collected $0.10 from pot
*** SUMMARY ***
Total Pot $0.10 | Rake $0.00
Seat 1: Player#1493 (button) folded before the flop
Seat 2: Player#4977 (small blind) folded before the flop
Seat 3: Player#1182 shows [] and won ($0.10) with 
Seat 4: Player#8395 folded before the flop
Seat 5: Player#9955 folded before the flop
Seat 6: warioman folded before the flop

PokerStars Hand #b9a1bebc-202d-430f-a061-052a52348a58:  Hold'em No Limit ($0.1/$0.20 USD) - 2021/11/20 11:10:00 ET
Table 'Bel Air' 6-max Seat #2 is the button
Seat 1: Player#2120 ($19.47 in chips)
Seat 2: warioman ($22.90 in chips)
Seat 3: Player#1025 ($26.51 in chips)
Seat 4: Player#0709 ($21.56 in chips)
Player#1025: posts small blind $0.10
Player#0709: posts big blind $0.20
*** HOLE CARDS ***
Dealt to warioman [Ah 7h]
Player#2120: folds
warioman: raises $0.20 to $0.5
Player#1025: calls $0.40
Player#0709: folds
*** FLOP *** [8c 4d 6c]
Player#1025: checks
warioman: bets $0.36
Player#1025: folds
warioman: doesn't show hand
Uncalled bet ($0.36) returned to warioman
warioman collected $1.14 from pot
*** SUMMARY ***
Total Pot $1.20 | Rake $0.06
Board [8c 4d 6c]
Seat 1: Player#2120 folded before the flop
Seat 2: warioman (button)
Seat 3: Player#1025 (small blind) folded on the flop
Seat 4: Player#0709 (big blind) folded before the flop

PokerStars Hand #b49ea614-ac50-4965-9538-3ad61ca06b07:  Hold'em No Limit ($0.1/$0.20 USD) - 2021/11/20 11:10:00 ET
Table 'Bel Air' 6-max Seat #1 is the button
Seat 1: Player#7012 ($19.47 in chips)
Seat 2: warioman ($23.00 in chips)
Seat 3: Player#4946 ($26.71 in chips)
Seat 4: Player#1932 ($21.26 in chips)
warioman: posts small blind $0.10
Player#4946: posts big blind $0.20
*** HOLE CARDS ***
Dealt to warioman [Js 6h]
Player#1932: raises $0.20 to $0.7
Player#7012: folds
warioman: folds
Player#4946: folds
Player#1932: doesn't show hand
Uncalled bet ($0.70) returned to Player#1932
Player#1932 collected $0.30 from pot
*** SUMMARY ***
Total Pot $0.30 | Rake $0.00
Seat 1: Player#7012 (button) folded before the flop
Seat 2: warioman (small blind) folded before the flop
Seat 3: Player#4946 (big blind) folded before the flop
Seat 4: Player#1932 shows [] and won ($0.30) with 

PokerStars Hand #273c3018-d2c5-48a6-8bbe-34806614504a:  Hold'em No Limit ($0.1/$0.20 USD) - 2021/11/20 11:10:00 ET
Table 'Bel Air' 6-max Seat #6 is the button
Seat 1: Player#7022 ($19.27 in chips)
Seat 2: warioman ($23.20 in chips)
Seat 3: Player#1720 ($12.19 in chips)
Seat 4: Player#5466 ($26.71 in chips)
Seat 5: Player#4768 ($21.26 in chips)
Player#7022: posts small blind $0.10
warioman: posts big blind $0.20
*** HOLE CARDS ***
Dealt to warioman [Jd 8s]
Player#1720: folds
Player#5466: folds
Player#4768: folds
Player#7022: raises $0.20 to $0.6
warioman: folds
Player#7022: doesn't show hand
Uncalled bet ($0.60) returned to Player#7022
Player#7022 collected $0.20 from pot
*** SUMMARY ***
Total Pot $0.20 | Rake $0.00
Seat 1: Player#7022 shows [] and won ($0.20) with 
Seat 2: warioman (big blind) folded before the flop
Seat 3: Player#1720 folded before the flop
Seat 4: Player#5466 folded before the flop
Seat 5: Player#4768 folded before the flop

PokerStars Hand #83273201-3841-4e8c-8dff-6f1434778bfc:  Hold'em No Limit ($0.1/$0.20 USD) - 2021/11/20 11:09:00 ET
Table 'Bel Air' 6-max Seat #4 is the button
Seat 1: Player#3271 ($19.17 in chips)
Seat 2: warioman ($23.20 in chips)
Seat 3: Player#8056 ($12.19 in chips)
Seat 4: Player#4931 ($26.71 in chips)
Seat 5: Player#2967 ($21.36 in chips)
Player#2967: posts small blind $0.10
Player#3271: posts big blind $0.20
*** HOLE CARDS ***
Dealt to warioman [9s 6d]
warioman: folds
Player#8056: folds
Player#4931: folds
Player#2967: folds
Player#3271 collected $0.20 from pot
*** SUMMARY ***
Total Pot $0.20 | Rake $0.00
Seat 1: Player#3271 shows [] and won ($0.20) with 
Seat 2: warioman folded before the flop
Seat 3: Player#8056 folded before the flop
Seat 4: Player#4931 (button) folded before the flop
Seat 5: Player#2967 (small blind) folded before the flop

PokerStars Hand #b51d9ac1-089a-433d-8055-6d455556fa2b:  Hold'em No Limit ($0.1/$0.20 USD) - 2021/11/20 11:09:00 ET
Table 'Bethlehem' 6-max Seat #6 is the button
Seat 1: Player#8872 ($24.43 in chips)
Seat 2: Player#7347 ($19.70 in chips)
Seat 3: Player#2641 ($34.76 in chips)
Seat 4: Player#6589 ($31.38 in chips)
Seat 5: Player#5613 ($57.16 in chips)
Seat 6: warioman ($27.16 in chips)
Player#8872: posts small blind $0.10
Player#7347: posts big blind $0.20
*** HOLE CARDS ***
Dealt to warioman []
Player#2641: calls $0.20
Player#6589: folds
Player#5613: raises $0.20 to $0.6
Player#8872: folds
Player#7347: folds
Player#2641: calls $0.40
*** FLOP *** [8s Qs Jh]
Player#2641: checks
Player#5613: checks
*** TURN *** [8s Qs Jh] [4c]
Player#2641: bets $0.75
Player#5613: folds
Player#2641: doesn't show hand
Uncalled bet ($0.75) returned to Player#2641
Player#2641 collected $1.43 from pot
*** SUMMARY ***
Total Pot $1.50 | Rake $0.08
Board [8s Qs Jh 4c]
Seat 1: Player#8872 (small blind) folded before the flop
Seat 2: Player#7347 (big blind) folded before the flop
Seat 3: Player#2641 shows [] and won ($1.43) with 
Seat 4: Player#6589 folded before the flop
Seat 5: Player#5613 folded on the turn
Seat 6: warioman (button)

PokerStars Hand #36032e7c-f7bc-4915-86df-92b77653fb82:  Hold'em No Limit ($0.1/$0.20 USD) - 2021/11/20 11:08:00 ET
Table 'Bel Air' 6-max Seat #1 is the button
Seat 1: Player#3943 ($19.17 in chips)
Seat 2: warioman ($23.30 in chips)
Seat 3: Player#2568 ($14.69 in chips)
Seat 4: Player#0683 ($26.41 in chips)
Seat 5: Player#2994 ($19.30 in chips)
warioman: posts small blind $0.10
Player#2568: posts big blind $0.20
*** HOLE CARDS ***
Dealt to warioman [2h 8h]
Player#0683: raises $0.20 to $0.6
Player#2994: folds
Player#3943: folds
warioman: folds
Player#2568: folds
Player#0683: doesn't show hand
Uncalled bet ($0.60) returned to Player#0683
Player#0683 collected $0.30 from pot
*** SUMMARY ***
Total Pot $0.30 | Rake $0.00
Seat 1: Player#3943 (button) folded before the flop
Seat 2: warioman (small blind) folded before the flop
Seat 3: Player#2568 (big blind) folded before the flop
Seat 4: Player#0683 shows [] and won ($0.30) with 
Seat 5: Player#2994 folded before the flop

PokerStars Hand #1d2af93f-0636-42db-9ddb-1bc0613a94fc:  Hold'em No Limit ($0.1/$0.20 USD) - 2021/11/20 11:08:00 ET
Table 'Bethlehem' 6-max Seat #3 is the button
Seat 1: Player#8204 ($23.90 in chips)
Seat 2: Player#5904 ($19.70 in chips)
Seat 3: Player#1806 ($34.76 in chips)
Seat 4: Player#8630 ($31.48 in chips)
Seat 5: Player#1322 ($57.68 in chips)
Seat 6: warioman ($27.16 in chips)
Player#8630: posts small blind $0.10
Player#1322: posts big blind $0.20
*** HOLE CARDS ***
Dealt to warioman [7s Qd]
warioman: folds
Player#8204: raises $0.20 to $0.7
Player#5904: folds
Player#1806: folds
Player#8630: folds
Player#1322: calls $0.50
*** FLOP *** [Kd 6c 8h]
Player#1322: checks
Player#8204: checks
*** TURN *** [Kd 6c 8h] [3s]
Player#1322: checks
Player#8204: bets $0.75
Player#1322: folds
Player#8204: doesn't show hand
Uncalled bet ($0.75) returned to Player#8204
Player#8204 collected $1.43 from pot
*** SUMMARY ***
Total Pot $1.50 | Rake $0.08
Board [Kd 6c 8h 3s]
Seat 1: Player#8204 shows [] and won ($1.43) with 
Seat 2: Player#5904 folded before the flop
Seat 3: Player#1806 (button) folded before the flop
Seat 4: Player#8630 (small blind) folded before the flop
Seat 5: Player#1322 (big blind) folded on the turn
Seat 6: warioman folded before the flop

PokerStars Hand #496a6176-c441-49c7-91b2-c53ebacc5048:  Hold'em No Limit ($0.1/$0.20 USD) - 2021/11/20 11:08:00 ET
Table 'Bel Air' 6-max Seat #6 is the button
Seat 1: Player#5825 ($18.99 in chips)
Seat 2: warioman ($23.50 in chips)
Seat 3: Player#2166 ($14.69 in chips)
Seat 4: Player#2623 ($26.41 in chips)
Seat 5: Player#6859 ($19.30 in chips)
Player#5825: posts small blind $0.10
warioman: posts big blind $0.20
*** HOLE CARDS ***
Dealt to warioman [4c Js]
Player#2166: folds
Player#2623: folds
Player#6859: folds
Player#5825: calls $0.10
warioman: checks
*** FLOP *** [6d Ac 3d]
Player#5825: bets $0.20
warioman: folds
Player#5825: doesn't show hand
Uncalled bet ($0.20) returned to Player#5825
Player#5825 collected $0.38 from pot
*** SUMMARY ***
Total Pot $0.40 | Rake $0.02
Board [6d Ac 3d]
Seat 1: Player#5825 shows [] and won ($0.38) with 
Seat 2: warioman (big blind) folded on the flop
Seat 3: Player#2166 folded before the flop
Seat 4: Player#2623 folded before the flop
Seat 5: Player#6859 folded before the flop

PokerStars Hand #9c4d3762-e2c0-42af-98e7-5d60062d2a13:  Hold'em No Limit ($0.05/$0.10 USD) - 2021/11/20 11:08:00 ET
Table 'Aberdeen' 6-max Seat #3 is the button
Seat 1: Player#1217 ($5.86 in chips)
Seat 2: Player#9499 ($23.75 in chips)
Seat 3: warioman ($16.75 in chips)
Seat 4: Player#1706 ($13.07 in chips)
Seat 5: Player#4250 ($10.00 in chips)
Seat 6: Player#8471 ($10.71 in chips)
Player#1706: posts small blind $0.05
Player#4250: posts big blind $0.10
*** HOLE CARDS ***
Dealt to warioman []
Player#8471: folds
Player#1217: raises $0.10 to $0.3
Player#9499: raises $0.30 to $1.2
Player#1706: folds
Player#4250: folds
Player#1217: calls $0.90
*** FLOP *** [Jh Js 7c]
Player#1217: checks
Player#9499: checks
*** TURN *** [Jh Js 7c] [9h]
Player#1217: bets $4.66
Player#9499: calls $4.66
Player#1217 Showing Pocket Cards QT
Player#9499 Showing Pocket Cards Q9
*** RIVER *** [Jh Js 7c] [9h] [7s]
Player#9499 collected $11.28 from pot
*** SUMMARY ***
Total Pot $11.87 | Rake $0.59
Board [Jh Js 7c 9h 7s]
Seat 1: Player#1217 mucked
Seat 2: Player#9499 shows [Qs 9s] and won ($11.28) with 
Seat 3: warioman (button)
Seat 4: Player#1706 (small blind) folded before the flop
Seat 5: Player#4250 (big blind) folded before the flop
Seat 6: Player#8471 folded before the flop

PokerStars Hand #4e08c4dc-23c9-4c92-9e0f-c54155150ad8:  Hold'em No Limit ($0.1/$0.20 USD) - 2021/11/20 11:07:00 ET
Table 'Bel Air' 6-max Seat #4 is the button
Seat 1: Player#9818 ($18.89 in chips)
Seat 2: warioman ($23.50 in chips)
Seat 3: Player#9804 ($14.69 in chips)
Seat 4: Player#8042 ($26.41 in chips)
Seat 5: Player#8603 ($19.40 in chips)
Player#8603: posts small blind $0.10
Player#9818: posts big blind $0.20
*** HOLE CARDS ***
Dealt to warioman [Td 2d]
warioman: folds
Player#9804: folds
Player#8042: folds
Player#8603: folds
Player#9818 collected $0.20 from pot
*** SUMMARY ***
Total Pot $0.20 | Rake $0.00
Seat 1: Player#9818 shows [] and won ($0.20) with 
Seat 2: warioman folded before the flop
Seat 3: Player#9804 folded before the flop
Seat 4: Player#8042 (button) folded before the flop
Seat 5: Player#8603 (small blind) folded before the flop

PokerStars Hand #e8866450-1cdf-4620-8115-a601b322a88e:  Hold'em No Limit ($0.1/$0.20 USD) - 2021/11/20 11:06:00 ET
Table 'Bel Air' 6-max Seat #2 is the button
Seat 1: Player#3278 ($19.29 in chips)
Seat 2: Player#8267 ($30.07 in chips)
Seat 3: warioman ($23.60 in chips)
Seat 4: Player#6580 ($15.39 in chips)
Seat 5: Player#0252 ($24.77 in chips)
Seat 6: Player#1785 ($20.00 in chips)
warioman: posts small blind $0.10
Player#6580: posts big blind $0.20
*** HOLE CARDS ***
Dealt to warioman [8h 9s]
Player#0252: raises $0.20 to $0.6
Player#1785: folds
Player#3278: folds
Player#8267: folds
warioman: folds
Player#6580: calls $0.40
*** FLOP *** [5h 4s 9d]
Player#6580: checks
Player#0252: bets $0.65
Player#6580: folds
Player#0252: doesn't show hand
Uncalled bet ($0.65) returned to Player#0252
Player#0252 collected $1.24 from pot
*** SUMMARY ***
Total Pot $1.30 | Rake $0.07
Board [5h 4s 9d]
Seat 1: Player#3278 folded before the flop
Seat 2: Player#8267 (button) folded before the flop
Seat 3: warioman (small blind) folded before the flop
Seat 4: Player#6580 (big blind) folded on the flop
Seat 5: Player#0252 shows [] and won ($1.24) with 
Seat 6: Player#1785 folded before the flop

PokerStars Hand #5b27cffc-92b5-44b3-a92f-9c553f261311:  Hold'em No Limit ($0.05/$0.10 USD) - 2021/11/20 11:05:00 ET
Table 'Aberdeen' 6-max Seat #3 is the button
Seat 1: Player#0306 ($9.05 in chips)
Seat 2: Player#0025 ($23.53 in chips)
Seat 3: warioman ($16.75 in chips)
Seat 4: Player#7021 ($11.28 in chips)
Seat 5: Player#6657 ($9.85 in chips)
Player#7021: posts small blind $0.05
Player#6657: posts big blind $0.10
*** HOLE CARDS ***
Dealt to warioman [8s Tc]
Player#0306: calls $0.10
Player#0025: folds
warioman: folds
Player#7021: folds
Player#6657: raises $0.10 to $0.2
Player#0306: calls $0.10
*** FLOP *** [4d Kd 5d]
Player#6657: bets $0.10
Player#0306: raises $0.10 to $0.75
Player#6657: calls $0.65
*** TURN *** [4d Kd 5d] [5h]
Player#6657: checks
Player#0306: checks
*** RIVER *** [4d Kd 5d] [5h] [2h]
Player#6657: bets $1.95
Player#0306: folds
Player#6657: doesn't show hand
Uncalled bet ($1.95) returned to Player#6657
Player#6657 collected $1.85 from pot
*** SUMMARY ***
Total Pot $1.95 | Rake $0.10
Board [4d Kd 5d 5h 2h]
Seat 1: Player#0306 folded on the river
Seat 2: Player#0025 folded before the flop
Seat 3: warioman (button) folded before the flop
Seat 4: Player#7021 (small blind) folded before the flop
Seat 5: Player#6657 shows [] and won ($1.85) with 

PokerStars Hand #f3516ef5-c632-4432-a0cc-241ae30a210b:  Hold'em No Limit ($0.05/$0.10 USD) - 2021/11/20 11:05:00 ET
Table 'Aberdeen' 6-max Seat #2 is the button
Seat 1: Player#2373 ($9.05 in chips)
Seat 2: Player#4598 ($23.53 in chips)
Seat 3: warioman ($16.80 in chips)
Seat 4: Player#3885 ($11.23 in chips)
Seat 5: Player#3640 ($9.85 in chips)
warioman: posts small blind $0.05
Player#3885: posts big blind $0.10
*** HOLE CARDS ***
Dealt to warioman [Ts 3s]
Player#3640: folds
Player#2373: folds
Player#4598: folds
warioman: folds
Player#3885 collected $0.10 from pot
*** SUMMARY ***
Total Pot $0.10 | Rake $0.00
Seat 1: Player#2373 folded before the flop
Seat 2: Player#4598 (button) folded before the flop
Seat 3: warioman (small blind) folded before the flop
Seat 4: Player#3885 shows [] and won ($0.10) with 
Seat 5: Player#3640 folded before the flop

PokerStars Hand #3689893c-3127-494b-8db6-5101c98951ed:  Hold'em No Limit ($0.1/$0.20 USD) - 2021/11/20 11:05:00 ET
Table 'Bethlehem' 6-max Seat #5 is the button
Seat 1: Player#6209 ($24.20 in chips)
Seat 2: Player#9333 ($19.30 in chips)
Seat 3: Player#2049 ($33.16 in chips)
Seat 4: Player#5283 ($32.11 in chips)
Seat 5: Player#0206 ($62.88 in chips)
Seat 6: warioman ($23.10 in chips)
warioman: posts small blind $0.10
Player#6209: posts big blind $0.20
*** HOLE CARDS ***
Dealt to warioman [Jd Qd]
Player#9333: folds
Player#2049: folds
Player#5283: folds
Player#0206: raises $0.20 to $0.6
warioman: raises $0.60 to $2.4
Player#6209: folds
Player#0206: calls $1.80
*** FLOP *** [9s Th Jh]
warioman: checks
Player#0206: checks
*** TURN *** [9s Th Jh] [7s]
warioman: checks
Player#0206: bets $1.90
warioman: calls $1.90
*** RIVER *** [9s Th Jh] [7s] [Ts]
warioman: checks
Player#0206: checks
*** SHOW DOWN *** 
warioman collected $8.36 from pot
*** SUMMARY ***
Total Pot $8.80 | Rake $0.44
Board [9s Th Jh 7s Ts]
Seat 1: Player#6209 (big blind) folded before the flop
Seat 2: Player#9333 folded before the flop
Seat 3: Player#2049 folded before the flop
Seat 4: Player#5283 folded before the flop
Seat 5: Player#0206 (button) mucked
Seat 6: warioman (small blind)

PokerStars Hand #64d19f61-1fbd-440f-9641-e9c94a728406:  Hold'em No Limit ($0.1/$0.20 USD) - 2021/11/20 11:05:00 ET
Table 'Bel Air' 6-max Seat #1 is the button
Seat 1: Player#0671 ($14.87 in chips)
Seat 2: Player#2257 ($30.97 in chips)
Seat 3: warioman ($23.80 in chips)
Seat 4: Player#1388 ($16.29 in chips)
Seat 5: Player#4325 ($24.77 in chips)
Seat 6: Player#7711 ($20.00 in chips)
Player#2257: posts small blind $0.10
warioman: posts big blind $0.20
*** HOLE CARDS ***
Dealt to warioman [4c Ah]
Player#1388: calls $0.20
Player#4325: folds
Player#7711: raises $0.20 to $0.9
Player#0671: calls $0.90
Player#2257: calls $0.80
warioman: folds
Player#1388: calls $0.70
*** FLOP *** [3c 2d Qd]
Player#2257: checks
Player#1388: checks
Player#7711: checks
Player#0671: bets $1.90
Player#2257: folds
Player#1388: folds
Player#7711: calls $1.90
*** TURN *** [3c 2d Qd] [7h]
Player#7711: checks
Player#0671: checks
*** RIVER *** [3c 2d Qd] [7h] [Jh]
Player#7711: checks
Player#0671: bets $3.80
Player#7711: folds
Player#0671: doesn't show hand
Uncalled bet ($3.80) returned to Player#0671
Player#0671 collected $7.22 from pot
*** SUMMARY ***
Total Pot $7.60 | Rake $0.38
Board [3c 2d Qd 7h Jh]
Seat 1: Player#0671 shows [] and won ($7.22) with 
Seat 2: Player#2257 (small blind) folded on the flop
Seat 3: warioman (big blind) folded before the flop
Seat 4: Player#1388 folded on the flop
Seat 5: Player#4325 folded before the flop
Seat 6: Player#7711 folded on the river

PokerStars Hand #59bd77dc-fd3c-439b-bf9a-dcf508477d34:  Hold'em No Limit ($0.1/$0.20 USD) - 2021/11/20 11:04:00 ET
Table 'Bethlehem' 6-max Seat #4 is the button
Seat 1: Player#8296 ($24.20 in chips)
Seat 2: Player#8223 ($19.30 in chips)
Seat 3: Player#3906 ($33.16 in chips)
Seat 4: Player#9131 ($32.11 in chips)
Seat 5: Player#0394 ($62.70 in chips)
Seat 6: warioman ($23.30 in chips)
Player#0394: posts small blind $0.10
warioman: posts big blind $0.20
*** HOLE CARDS ***
Dealt to warioman [4c 7d]
Player#8296: folds
Player#8223: folds
Player#3906: folds
Player#9131: folds
Player#0394: calls $0.10
warioman: checks
*** FLOP *** [Ah 2s 3h]
Player#0394: checks
warioman: checks
*** TURN *** [Ah 2s 3h] [9h]
Player#0394: checks
warioman: checks
*** RIVER *** [Ah 2s 3h] [9h] [Ah]
Player#0394: checks
warioman: checks
*** SHOW DOWN *** 
Player#0394 collected $0.38 from pot
*** SUMMARY ***
Total Pot $0.40 | Rake $0.02
Board [Ah 2s 3h 9h Ah]
Seat 1: Player#8296 folded before the flop
Seat 2: Player#8223 folded before the flop
Seat 3: Player#3906 folded before the flop
Seat 4: Player#9131 (button) folded before the flop
Seat 5: Player#0394 shows [6h 8s] and won ($0.38) with 
Seat 6: warioman (big blind)

PokerStars Hand #a8eda4df-6268-4926-a833-16b1aaad61af:  Hold'em No Limit ($0.1/$0.20 USD) - 2021/11/20 11:04:00 ET
Table 'Bethlehem' 6-max Seat #3 is the button
Seat 1: Player#1682 ($23.90 in chips)
Seat 2: Player#6301 ($19.30 in chips)
Seat 3: Player#2371 ($33.16 in chips)
Seat 4: Player#7134 ($32.21 in chips)
Seat 5: Player#1323 ($62.90 in chips)
Seat 6: warioman ($23.30 in chips)
Player#7134: posts small blind $0.10
Player#1323: posts big blind $0.20
*** HOLE CARDS ***
Dealt to warioman [5d Ah]
warioman: folds
Player#1682: raises $0.20 to $0.7
Player#6301: folds
Player#2371: folds
Player#7134: folds
Player#1323: folds
Player#1682: doesn't show hand
Uncalled bet ($0.70) returned to Player#1682
Player#1682 collected $0.30 from pot
*** SUMMARY ***
Total Pot $0.30 | Rake $0.00
Seat 1: Player#1682 shows [] and won ($0.30) with 
Seat 2: Player#6301 folded before the flop
Seat 3: Player#2371 (button) folded before the flop
Seat 4: Player#7134 (small blind) folded before the flop
Seat 5: Player#1323 (big blind) folded before the flop
Seat 6: warioman folded before the flop

PokerStars Hand #1e99daf2-d5d4-4236-a7a4-a6a1e3494a31:  Hold'em No Limit ($0.05/$0.10 USD) - 2021/11/20 11:04:00 ET
Table 'Aberdeen' 6-max Seat #1 is the button
Seat 1: Player#7081 ($9.15 in chips)
Seat 2: Player#6461 ($22.31 in chips)
Seat 3: warioman ($18.05 in chips)
Seat 4: Player#6916 ($9.85 in chips)
Player#6461: posts small blind $0.05
warioman: posts big blind $0.10
*** HOLE CARDS ***
Dealt to warioman [Ac Qs]
Player#6916: folds
Player#7081: calls $0.10
Player#6461: calls $0.05
warioman: raises $0.10 to $0.6
Player#7081: folds
Player#6461: calls $0.50
*** FLOP *** [Th Jc 8c]
Player#6461: checks
warioman: checks
*** TURN *** [Th Jc 8c] [3c]
Player#6461: bets $0.65
warioman: calls $0.65
*** RIVER *** [Th Jc 8c] [3c] [4c]
Player#6461: checks
warioman: checks
*** SHOW DOWN *** 
Player#6461 collected $2.47 from pot
*** SUMMARY ***
Total Pot $2.60 | Rake $0.13
Board [Th Jc 8c 3c 4c]
Seat 1: Player#7081 (button) folded before the flop
Seat 2: Player#6461 shows [9h 8h] and won ($2.47) with 
Seat 3: warioman (big blind)
Seat 4: Player#6916 folded before the flop

PokerStars Hand #ddad92b4-bf94-4474-a37d-9bcafcb0a548:  Hold'em No Limit ($0.1/$0.20 USD) - 2021/11/20 11:04:00 ET
Table 'Bel Air' 6-max Seat #6 is the button
Seat 1: Player#7445 ($14.97 in chips)
Seat 2: Player#3919 ($33.27 in chips)
Seat 3: warioman ($23.80 in chips)
Seat 4: Player#1975 ($13.27 in chips)
Seat 5: Player#9959 ($24.77 in chips)
Seat 6: Player#6381 ($19.03 in chips)
Player#7445: posts small blind $0.10
Player#3919: posts big blind $0.20
*** HOLE CARDS ***
Dealt to warioman [Td 8d]
warioman: folds
Player#1975: calls $0.20
Player#9959: folds
Player#6381: raises $0.20 to $0.9
Player#7445: folds
Player#3919: calls $0.70
Player#1975: calls $0.70
*** FLOP *** [8c Kd 7c]
Player#3919: checks
Player#1975: checks
Player#6381: checks
*** TURN *** [8c Kd 7c] [7d]
Player#3919: bets $1.40
Player#1975: calls $1.40
Player#6381: folds
*** RIVER *** [8c Kd 7c] [7d] [5d]
Player#3919: checks
Player#1975: bets $5.60
Player#3919: folds
Player#1975: doesn't show hand
Uncalled bet ($5.60) returned to Player#1975
Player#1975 collected $5.32 from pot
*** SUMMARY ***
Total Pot $5.60 | Rake $0.28
Board [8c Kd 7c 7d 5d]
Seat 1: Player#7445 (small blind) folded before the flop
Seat 2: Player#3919 (big blind) folded on the river
Seat 3: warioman folded before the flop
Seat 4: Player#1975 shows [] and won ($5.32) with 
Seat 5: Player#9959 folded before the flop
Seat 6: Player#6381 (button) folded on the turn

PokerStars Hand #f4c3ee98-56d6-4ef6-9822-b11c0c05384a:  Hold'em No Limit ($0.1/$0.20 USD) - 2021/11/20 11:04:00 ET
Table 'Bethlehem' 6-max Seat #2 is the button
Seat 1: Player#2659 ($23.90 in chips)
Seat 2: Player#5133 ($20.00 in chips)
Seat 3: Player#3675 ($33.26 in chips)
Seat 4: Player#9777 ($32.41 in chips)
Seat 5: Player#7599 ($61.98 in chips)
Seat 6: warioman ($23.30 in chips)
Player#3675: posts small blind $0.10
Player#9777: posts big blind $0.20
*** HOLE CARDS ***
Dealt to warioman [6s 6c]
Player#7599: raises $0.20 to $0.7
warioman: folds
Player#2659: folds
Player#5133: calls $0.70
Player#3675: folds
Player#9777: folds
*** FLOP *** [Tc 2c 9d]
Player#7599: bets $0.85
Player#5133: folds
Player#2659: doesn't show hand
Player#5133: doesn't show hand
Player#3675: doesn't show hand
Player#9777: doesn't show hand
Player#7599: doesn't show hand
warioman: doesn't show hand
Uncalled bet ($0.85) returned to Player#7599
Player#7599 collected $1.61 from pot
*** SUMMARY ***
Total Pot $1.70 | Rake $0.08
Board [Tc 2c 9d]
Seat 1: Player#2659 folded before the flop
Seat 2: Player#5133 (button) folded on the flop
Seat 3: Player#3675 (small blind) folded before the flop
Seat 4: Player#9777 (big blind) folded before the flop
Seat 5: Player#7599 shows [] and won ($1.61) with 
Seat 6: warioman folded before the flop

PokerStars Hand #4c24d8d4-9a40-46eb-82dd-9a97a3861b78:  Hold'em No Limit ($0.05/$0.10 USD) - 2021/11/20 11:03:00 ET
Table 'Aberdeen' 6-max Seat #6 is the button
Seat 1: Player#8264 ($10.05 in chips)
Seat 2: Player#7026 ($21.50 in chips)
Seat 3: warioman ($18.05 in chips)
Seat 4: Player#2051 ($9.85 in chips)
Player#8264: posts small blind $0.05
Player#7026: posts big blind $0.10
*** HOLE CARDS ***
Dealt to warioman [5s 2h]
warioman: folds
Player#2051: folds
Player#8264: raises $0.10 to $0.3
Player#7026: calls $0.20
*** FLOP *** [3c 3d 6s]
Player#8264: checks
Player#7026: checks
*** TURN *** [3c 3d 6s] [Ah]
Player#8264: checks
Player#7026: checks
*** RIVER *** [3c 3d 6s] [Ah] [8h]
Player#8264: bets $0.60
Player#7026: calls $0.60
*** SHOW DOWN *** 
Player#7026 collected $1.71 from pot
*** SUMMARY ***
Total Pot $1.80 | Rake $0.09
Board [3c 3d 6s Ah 8h]
Seat 1: Player#8264 (small blind) mucked
Seat 2: Player#7026 shows [8c 6d] and won ($1.71) with 
Seat 3: warioman folded before the flop
Seat 4: Player#2051 folded before the flop

PokerStars Hand #2f29bc2c-f41e-4531-b6b7-0fdcd646717f:  Hold'em No Limit ($0.05/$0.10 USD) - 2021/11/20 11:03:00 ET
Table 'Aberdeen' 6-max Seat #4 is the button
Seat 1: Player#0626 ($10.00 in chips)
Seat 2: Player#3236 ($21.50 in chips)
Seat 3: warioman ($18.05 in chips)
Seat 4: Player#7019 ($11.23 in chips)
Seat 5: Player#0941 ($9.90 in chips)
Player#0941: posts small blind $0.05
Player#0626: posts big blind $0.10
*** HOLE CARDS ***
Dealt to warioman [Kc 6s]
Player#3236: folds
warioman: folds
Player#7019: folds
Player#0941: folds
Player#0626 collected $0.10 from pot
*** SUMMARY ***
Total Pot $0.10 | Rake $0.00
Seat 1: Player#0626 shows [] and won ($0.10) with 
Seat 2: Player#3236 folded before the flop
Seat 3: warioman folded before the flop
Seat 4: Player#7019 (button) folded before the flop
Seat 5: Player#0941 (small blind) folded before the flop

PokerStars Hand #ca8712c7-7bc6-42d3-8ad7-c1daf0449189:  Hold'em No Limit ($0.1/$0.20 USD) - 2021/11/20 11:03:00 ET
Table 'Bel Air' 6-max Seat #5 is the button
Seat 1: Player#3156 ($15.17 in chips)
Seat 2: Player#7247 ($33.27 in chips)
Seat 3: warioman ($23.80 in chips)
Seat 4: Player#6281 ($9.30 in chips)
Seat 5: Player#5678 ($24.77 in chips)
Seat 6: Player#2580 ($23.23 in chips)
Player#2580: posts small blind $0.10
Player#3156: posts big blind $0.20
*** HOLE CARDS ***
Dealt to warioman [7d Td]
Player#7247: folds
warioman: folds
Player#6281: calls $0.20
Player#5678: folds
Player#2580: calls $0.10
Player#3156: checks
*** FLOP *** [6s Jh 8c]
Player#2580: bets $0.60
Player#3156: folds
Player#6281: calls $0.60
*** TURN *** [6s Jh 8c] [4d]
Player#2580: bets $1.20
Player#6281: calls $1.20
*** RIVER *** [6s Jh 8c] [4d] [4d]
Player#2580: bets $2.20
Player#6281: raises $2.20 to $7.3
Player#2580: folds
Player#6281: doesn't show hand
Uncalled bet ($7.30) returned to Player#6281
Player#6281 collected $6.08 from pot
*** SUMMARY ***
Total Pot $6.40 | Rake $0.32
Board [6s Jh 8c 4d 4d]
Seat 1: Player#3156 (big blind) folded on the flop
Seat 2: Player#7247 folded before the flop
Seat 3: warioman folded before the flop
Seat 4: Player#6281 shows [] and won ($6.08) with 
Seat 5: Player#5678 (button) folded before the flop
Seat 6: Player#2580 (small blind) folded on the river

PokerStars Hand #f2c838c3-7804-44c1-8701-7bc672f3f02c:  Hold'em No Limit ($0.1/$0.20 USD) - 2021/11/20 11:02:00 ET
Table 'Bel Air' 6-max Seat #4 is the button
Seat 1: Player#2924 ($15.17 in chips)
Seat 2: Player#9243 ($33.27 in chips)
Seat 3: warioman ($23.80 in chips)
Seat 4: Player#9682 ($9.00 in chips)
Seat 5: Player#2609 ($24.87 in chips)
Seat 6: Player#9608 ($23.43 in chips)
Player#2609: posts small blind $0.10
Player#9608: posts big blind $0.20
*** HOLE CARDS ***
Dealt to warioman [Jd 8h]
Player#2924: folds
Player#9243: folds
warioman: folds
Player#9682: raises0.20 to $2
Player#2609: folds
Player#9608: folds
Player#9682: doesn't show hand
Uncalled bet ($2.00) returned to Player#9682
Player#9682 collected $0.30 from pot
*** SUMMARY ***
Total Pot $0.30 | Rake $0.00
Seat 1: Player#2924 folded before the flop
Seat 2: Player#9243 folded before the flop
Seat 3: warioman folded before the flop
Seat 4: Player#9682 shows [] and won ($0.30) with 
Seat 5: Player#2609 (small blind) folded before the flop
Seat 6: Player#9608 (big blind) folded before the flop

PokerStars Hand #5b4c260b-98c8-463e-8c38-e9363989ab72:  Hold'em No Limit ($0.1/$0.20 USD) - 2021/11/20 11:02:00 ET
Table 'Bethlehem' 6-max Seat #1 is the button
Seat 1: Player#0173 ($23.90 in chips)
Seat 2: Player#0192 ($18.62 in chips)
Seat 3: Player#8769 ($33.86 in chips)
Seat 4: Player#2580 ($30.73 in chips)
Seat 5: Player#3562 ($62.58 in chips)
Seat 6: warioman ($23.30 in chips)
Player#0192: posts small blind $0.10
Player#8769: posts big blind $0.20
*** HOLE CARDS ***
Dealt to warioman [Tc 8c]
Player#2580: raises $0.20 to $0.6
Player#3562: calls $0.60
warioman: folds
Player#0173: folds
Player#0192: calls $0.50
Player#8769: calls $0.40
*** FLOP *** [6d 7h 2d]
Player#0192: checks
Player#8769: checks
Player#2580: checks
Player#3562: checks
*** TURN *** [6d 7h 2d] [5h]
Player#0192: checks
Player#8769: checks
Player#2580: checks
Player#3562: checks
*** RIVER *** [6d 7h 2d] [5h] [9h]
Player#0192: checks
Player#8769: checks
Player#2580: checks
Player#3562: checks
*** SHOW DOWN *** 
Player#2580 collected $2.28 from pot
*** SUMMARY ***
Total Pot $2.40 | Rake $0.12
Board [6d 7h 2d 5h 9h]
Seat 1: Player#0173 (button) folded before the flop
Seat 2: Player#0192 (small blind) mucked
Seat 3: Player#8769 (big blind) mucked
Seat 4: Player#2580 shows [5s 3s] and won ($2.28) with 
Seat 5: Player#3562 mucked
Seat 6: warioman folded before the flop

PokerStars Hand #bab48c77-3f11-4a13-bf0f-389995a84641:  Hold'em No Limit ($0.05/$0.10 USD) - 2021/11/20 11:02:00 ET
Table 'Aberdeen' 6-max Seat #2 is the button
Seat 1: Player#3630 ($22.70 in chips)
Seat 2: warioman ($18.05 in chips)
Seat 3: Player#0385 ($10.05 in chips)
Seat 4: Player#7280 ($10.00 in chips)
Player#0385: posts small blind $0.05
Player#7280: posts big blind $0.10
*** HOLE CARDS ***
Dealt to warioman [9d Ts]
Player#3630: raises $0.10 to $0.3
warioman: folds
Player#0385: raises $0.30 to $1.2
Player#7280: folds
Player#3630: calls $0.90
*** FLOP *** [4h Qc 3c]
Player#0385: bets $0.72
Player#3630: folds
Player#0385: doesn't show hand
Uncalled bet ($0.72) returned to Player#0385
Player#0385 collected $2.38 from pot
*** SUMMARY ***
Total Pot $2.50 | Rake $0.12
Board [4h Qc 3c]
Seat 1: Player#3630 folded on the flop
Seat 2: warioman (button) folded before the flop
Seat 3: Player#0385 shows [] and won ($2.38) with 
Seat 4: Player#7280 (big blind) folded before the flop

PokerStars Hand #dc30766e-e9f0-4eb6-a479-ecbf78f6bcd4:  Hold'em No Limit ($0.05/$0.10 USD) - 2021/11/20 11:02:00 ET
Table 'Aberdeen' 6-max Seat #1 is the button
Seat 1: Player#1211 ($22.70 in chips)
Seat 2: warioman ($18.10 in chips)
Seat 3: Player#6319 ($10.00 in chips)
Seat 4: Player#5722 ($10.00 in chips)
warioman: posts small blind $0.05
Player#6319: posts big blind $0.10
*** HOLE CARDS ***
Dealt to warioman [6s Jc]
Player#5722: folds
Player#1211: folds
warioman: folds
Player#6319 collected $0.10 from pot
*** SUMMARY ***
Total Pot $0.10 | Rake $0.00
Seat 1: Player#1211 (button) folded before the flop
Seat 2: warioman (small blind) folded before the flop
Seat 3: Player#6319 shows [] and won ($0.10) with 
Seat 4: Player#5722 folded before the flop

PokerStars Hand #00e40078-21c4-4ca7-940e-3c5e6a18d691:  Hold'em No Limit ($0.05/$0.10 USD) - 2021/11/20 11:02:00 ET
Table 'Aberdeen' 6-max Seat #6 is the button
Seat 1: Player#4777 ($22.75 in chips)
Seat 2: warioman ($18.05 in chips)
Seat 3: Player#4433 ($10.00 in chips)
Seat 4: Player#2828 ($10.00 in chips)
Player#4777: posts small blind $0.05
warioman: posts big blind $0.10
*** HOLE CARDS ***
Dealt to warioman [5h 7s]
Player#4433: folds
Player#2828: folds
Player#4777: folds
warioman collected $0.10 from pot
*** SUMMARY ***
Total Pot $0.10 | Rake $0.00
Seat 1: Player#4777 (small blind) folded before the flop
Seat 2: warioman (big blind)
Seat 3: Player#4433 folded before the flop
Seat 4: Player#2828 folded before the flop

PokerStars Hand #f5db371c-54b2-49fd-a2d7-db0093a68fba:  Hold'em No Limit ($0.1/$0.20 USD) - 2021/11/20 11:01:00 ET
Table 'Bel Air' 6-max Seat #3 is the button
Seat 1: Player#2844 ($14.71 in chips)
Seat 2: Player#1882 ($33.27 in chips)
Seat 3: warioman ($23.80 in chips)
Seat 4: Player#3499 ($9.10 in chips)
Seat 5: Player#6528 ($25.27 in chips)
Seat 6: Player#1066 ($23.43 in chips)
Player#3499: posts small blind $0.10
Player#6528: posts big blind $0.20
*** HOLE CARDS ***
Dealt to warioman [Qd 4c]
Player#1066: folds
Player#2844: calls $0.20
Player#1882: folds
warioman: folds
Player#3499: folds
Player#6528: checks
*** FLOP *** [Kd Qc 5s]
Player#6528: checks
Player#2844: bets $0.20
Player#6528: calls $0.20
*** TURN *** [Kd Qc 5s] [Th]
Player#6528: checks
Player#2844: checks
*** RIVER *** [Kd Qc 5s] [Th] [Jh]
Player#6528: checks
Player#2844: checks
*** SHOW DOWN *** 
Player#2844 collected $0.85 from pot
*** SUMMARY ***
Total Pot $0.90 | Rake $0.04
Board [Kd Qc 5s Th Jh]
Seat 1: Player#2844 shows [Jh Tc] and won ($0.85) with 
Seat 2: Player#1882 folded before the flop
Seat 3: warioman (button) folded before the flop
Seat 4: Player#3499 (small blind) folded before the flop
Seat 5: Player#6528 (big blind) mucked
Seat 6: Player#1066 folded before the flop

PokerStars Hand #1d2e980c-a1de-48cc-a850-23102e9f1e4c:  Hold'em No Limit ($0.05/$0.10 USD) - 2021/11/20 11:01:00 ET
Table 'Aberdeen' 6-max Seat #3 is the button
Seat 1: Player#0366 ($22.85 in chips)
Seat 2: warioman ($18.05 in chips)
Seat 3: Player#2324 ($10.00 in chips)
Seat 4: Player#6428 ($9.90 in chips)
Player#6428: posts small blind $0.05
Player#0366: posts big blind $0.10
*** HOLE CARDS ***
Dealt to warioman [9c Ts]
warioman: folds
Player#2324: folds
Player#6428: raises $0.10 to $0.2
Player#0366: folds
Player#6428: doesn't show hand
Uncalled bet ($0.20) returned to Player#6428
Player#6428 collected $0.10 from pot
*** SUMMARY ***
Total Pot $0.10 | Rake $0.00
Seat 1: Player#0366 (big blind) folded before the flop
Seat 2: warioman folded before the flop
Seat 3: Player#2324 (button) folded before the flop
Seat 4: Player#6428 shows [] and won ($0.10) with 

PokerStars Hand #68a496fb-a233-4edc-b473-7978763db996:  Hold'em No Limit ($0.1/$0.20 USD) - 2021/11/20 11:01:00 ET
Table 'Bethlehem' 6-max Seat #6 is the button
Seat 1: Player#0466 ($24.00 in chips)
Seat 2: Player#0949 ($19.52 in chips)
Seat 3: Player#8125 ($34.76 in chips)
Seat 4: Player#5260 ($30.73 in chips)
Seat 5: Player#8102 ($60.82 in chips)
Seat 6: warioman ($23.30 in chips)
Player#0466: posts small blind $0.10
Player#0949: posts big blind $0.20
*** HOLE CARDS ***
Dealt to warioman [9s 6d]
Player#8125: calls $0.20
Player#5260: folds
Player#8102: raises $0.20 to $0.9
warioman: folds
Player#0466: folds
Player#0949: calls $0.70
Player#8125: calls $0.70
*** FLOP *** [2d 3h 9h]
Player#0949: checks
Player#8125: checks
Player#8102: bets $1.40
Player#0949: folds
Player#8125: folds
Player#0466: doesn't show hand
Player#0949: doesn't show hand
Player#8125: doesn't show hand
Player#5260: doesn't show hand
Player#8102: doesn't show hand
warioman: doesn't show hand
Uncalled bet ($1.40) returned to Player#8102
Player#8102 collected $2.66 from pot
*** SUMMARY ***
Total Pot $2.80 | Rake $0.14
Board [2d 3h 9h]
Seat 1: Player#0466 (small blind) folded before the flop
Seat 2: Player#0949 (big blind) folded on the flop
Seat 3: Player#8125 folded on the flop
Seat 4: Player#5260 folded before the flop
Seat 5: Player#8102 shows [] and won ($2.66) with 
Seat 6: warioman (button) folded before the flop

PokerStars Hand #f3c790d5-18c8-48a7-8ce4-02388b0ad6ff:  Hold'em No Limit ($0.1/$0.20 USD) - 2021/11/20 11:01:00 ET
Table 'Bel Air' 6-max Seat #2 is the button
Seat 1: Player#1364 ($14.71 in chips)
Seat 2: Player#7922 ($33.27 in chips)
Seat 3: warioman ($23.90 in chips)
Seat 4: Player#2513 ($9.30 in chips)
Seat 5: Player#7228 ($24.97 in chips)
Seat 6: Player#0711 ($23.43 in chips)
warioman: posts small blind $0.10
Player#2513: posts big blind $0.20
*** HOLE CARDS ***
Dealt to warioman [2h 3d]
Player#7228: raises $0.20 to $0.6
Player#0711: folds
Player#1364: folds
Player#7922: folds
warioman: folds
Player#2513: folds
Player#7228: doesn't show hand
Uncalled bet ($0.60) returned to Player#7228
Player#7228 collected $0.30 from pot
*** SUMMARY ***
Total Pot $0.30 | Rake $0.00
Seat 1: Player#1364 folded before the flop
Seat 2: Player#7922 (button) folded before the flop
Seat 3: warioman (small blind) folded before the flop
Seat 4: Player#2513 (big blind) folded before the flop
Seat 5: Player#7228 shows [] and won ($0.30) with 
Seat 6: Player#0711 folded before the flop

PokerStars Hand #d7e42ea0-2bf6-45c3-b668-6995885038dc:  Hold'em No Limit ($0.05/$0.10 USD) - 2021/11/20 11:01:00 ET
Table 'Aberdeen' 6-max Seat #2 is the button
Seat 1: Player#4444 ($22.70 in chips)
Seat 2: warioman ($18.05 in chips)
Seat 3: Player#1965 ($10.05 in chips)
Seat 4: Player#1006 ($10.00 in chips)
Player#1965: posts small blind $0.05
Player#1006: posts big blind $0.10
*** HOLE CARDS ***
Dealt to warioman [8d Jh]
Player#4444: raises $0.10 to $0.3
warioman: folds
Player#1965: folds
Player#1006: folds
Player#4444: doesn't show hand
Uncalled bet ($0.30) returned to Player#4444
Player#4444 collected $0.15 from pot
*** SUMMARY ***
Total Pot $0.15 | Rake $0.00
Seat 1: Player#4444 shows [] and won ($0.15) with 
Seat 2: warioman (button) folded before the flop
Seat 3: Player#1965 (small blind) folded before the flop
Seat 4: Player#1006 (big blind) folded before the flop

PokerStars Hand #e11daf8a-9a35-4592-be67-f86b65f4ebac:  Hold'em No Limit ($0.1/$0.20 USD) - 2021/11/20 11:01:00 ET
Table 'Bel Air' 6-max Seat #1 is the button
Seat 1: Player#5394 ($14.71 in chips)
Seat 2: Player#3859 ($33.67 in chips)
Seat 3: warioman ($24.10 in chips)
Seat 4: Player#5822 ($8.75 in chips)
Seat 5: Player#1567 ($24.97 in chips)
Seat 6: Player#1205 ($23.43 in chips)
Player#3859: posts small blind $0.10
warioman: posts big blind $0.20
*** HOLE CARDS ***
Dealt to warioman [5c 6h]
Player#5822: raises $0.20 to $0.4
Player#1567: folds
Player#1205: folds
Player#5394: folds
Player#3859: calls $0.30
warioman: folds
*** FLOP *** [Jh 3s Td]
Player#3859: checks
Player#5822: bets $0.75
Player#3859: folds
Player#5822: doesn't show hand
Uncalled bet ($0.75) returned to Player#5822
Player#5822 collected $0.95 from pot
*** SUMMARY ***
Total Pot $1.00 | Rake $0.05
Board [Jh 3s Td]
Seat 1: Player#5394 (button) folded before the flop
Seat 2: Player#3859 (small blind) folded on the flop
Seat 3: warioman (big blind) folded before the flop
Seat 4: Player#5822 shows [] and won ($0.95) with 
Seat 5: Player#1567 folded before the flop
Seat 6: Player#1205 folded before the flop

PokerStars Hand #73f047f5-a3ba-4ce0-9728-262993e2ff0f:  Hold'em No Limit ($0.05/$0.10 USD) - 2021/11/20 11:01:00 ET
Table 'Aberdeen' 6-max Seat #3 is the button
Seat 1: Player#2557 ($22.70 in chips)
Seat 2: warioman ($18.10 in chips)
Seat 3: Player#2481 ($10.00 in chips)
Seat 4: Player#2619 ($10.00 in chips)
Player#2619: posts small blind $0.05
warioman: posts big blind $0.10
*** HOLE CARDS ***
Dealt to warioman [4d 3s]
Player#2619 Waiting
Player#2557: folds
warioman: folds
Player#2481 collected $0.10 from pot
*** SUMMARY ***
Total Pot $0.10 | Rake $0.00
Seat 1: Player#2557 folded before the flop
Seat 2: warioman (big blind) folded before the flop
Seat 3: Player#2481 shows [] and won ($0.10) with 
Seat 4: Player#2619 (small blind) mucked

PokerStars Hand #ee6c5500-cf34-49d5-8020-b851fe7936c6:  Hold'em No Limit ($0.1/$0.20 USD) - 2021/11/20 11:01:00 ET
Table 'Bel Air' 6-max Seat #6 is the button
Seat 1: Player#6765 ($14.81 in chips)
Seat 2: Player#4359 ($34.27 in chips)
Seat 3: warioman ($24.10 in chips)
Seat 4: Player#8760 ($8.11 in chips)
Seat 5: Player#9818 ($24.97 in chips)
Seat 6: Player#5911 ($23.43 in chips)
Player#6765: posts small blind $0.10
Player#4359: posts big blind $0.20
*** HOLE CARDS ***
Dealt to warioman [Tc 5c]
warioman: folds
Player#8760: raises $0.20 to $0.6
Player#9818: folds
Player#5911: folds
Player#6765: folds
Player#4359: calls $0.40
*** FLOP *** [7h As 3s]
Player#4359: checks
Player#8760: bets $1.30
Player#4359: folds
Player#8760: doesn't show hand
Uncalled bet ($1.30) returned to Player#8760
Player#8760 collected $1.24 from pot
*** SUMMARY ***
Total Pot $1.30 | Rake $0.07
Board [7h As 3s]
Seat 1: Player#6765 (small blind) folded before the flop
Seat 2: Player#4359 (big blind) folded on the flop
Seat 3: warioman folded before the flop
Seat 4: Player#8760 shows [] and won ($1.24) with 
Seat 5: Player#9818 folded before the flop
Seat 6: Player#5911 (button) folded before the flop

PokerStars Hand #fe8f4bca-6d36-4776-b760-54b6580cfa0f:  Hold'em No Limit ($0.05/$0.10 USD) - 2021/11/20 11:00:00 ET
Table 'Aberdeen' 6-max Seat #6 is the button
Seat 1: Player#8126 ($22.75 in chips)
Seat 2: warioman ($18.05 in chips)
Seat 3: Player#3126 ($10.00 in chips)
Seat 4: Player#0209 ($8.00 in chips)
Player#8126: posts small blind $0.05
warioman: posts big blind $0.10
*** HOLE CARDS ***
Dealt to warioman [8d 6h]
Player#3126: folds
Player#0209: folds
Player#8126: folds
warioman collected $0.10 from pot
*** SUMMARY ***
Total Pot $0.10 | Rake $0.00
Seat 1: Player#8126 (small blind) folded before the flop
Seat 2: warioman (big blind)
Seat 3: Player#3126 folded before the flop
Seat 4: Player#0209 folded before the flop

PokerStars Hand #21e8ee76-7c48-4cd4-a1df-33a394c34870:  Hold'em No Limit ($0.1/$0.20 USD) - 2021/11/20 11:00:00 ET
Table 'Bethlehem' 6-max Seat #4 is the button
Seat 1: Player#9280 ($24.60 in chips)
Seat 2: Player#1610 ($19.52 in chips)
Seat 3: Player#5142 ($30.09 in chips)
Seat 4: Player#9796 ($60.82 in chips)
Seat 5: warioman ($23.40 in chips)
warioman: posts small blind $0.10
Player#9280: posts big blind $0.20
*** HOLE CARDS ***
Dealt to warioman [4c 5s]
Player#1610: folds
Player#5142: raises $0.20 to $0.6
Player#9796: folds
warioman: folds
Player#9280: calls $0.40
*** FLOP *** [2h 9d 4d]
Player#9280: checks
Player#5142: checks
*** TURN *** [2h 9d 4d] [Jd]
Player#9280: checks
Player#5142: bets $0.98
Player#9280: folds
Player#9280: doesn't show hand
Player#1610: doesn't show hand
Player#5142: doesn't show hand
Player#9796: doesn't show hand
warioman: doesn't show hand
Uncalled bet ($0.98) returned to Player#5142
Player#5142 collected $1.24 from pot
*** SUMMARY ***
Total Pot $1.30 | Rake $0.07
Board [2h 9d 4d Jd]
Seat 1: Player#9280 (big blind) folded on the turn
Seat 2: Player#1610 folded before the flop
Seat 3: Player#5142 shows [] and won ($1.24) with 
Seat 4: Player#9796 (button) folded before the flop
Seat 5: warioman (small blind) folded before the flop

PokerStars Hand #361ca27a-037b-4030-85f5-262ee46a7aa9:  Hold'em No Limit ($0.1/$0.20 USD) - 2021/11/20 11:00:00 ET
Table 'Bel Air' 6-max Seat #5 is the button
Seat 1: Player#5289 ($15.01 in chips)
Seat 2: Player#9817 ($34.47 in chips)
Seat 3: warioman ($24.10 in chips)
Seat 4: Player#1932 ($7.61 in chips)
Seat 5: Player#2044 ($24.97 in chips)
Seat 6: Player#9958 ($23.53 in chips)
Player#9958: posts small blind $0.10
Player#5289: posts big blind $0.20
*** HOLE CARDS ***
Dealt to warioman [8c Kc]
Player#9817: calls $0.20
warioman: folds
Player#1932: raises0.20 to $1
Player#2044: folds
Player#9958: folds
Player#5289: folds
Player#9817: folds
Player#1932: doesn't show hand
Uncalled bet ($1.00) returned to Player#1932
Player#1932 collected $0.50 from pot
*** SUMMARY ***
Total Pot $0.50 | Rake $0.00
Seat 1: Player#5289 (big blind) folded before the flop
Seat 2: Player#9817 folded before the flop
Seat 3: warioman folded before the flop
Seat 4: Player#1932 shows [] and won ($0.50) with 
Seat 5: Player#2044 (button) folded before the flop
Seat 6: Player#9958 (small blind) folded before the flop

PokerStars Hand #1f0d8edc-49d6-4111-9f05-887e0c9c4293:  Hold'em No Limit ($0.1/$0.20 USD) - 2021/11/20 11:00:00 ET
Table 'Bethlehem' 6-max Seat #4 is the button
Seat 1: Player#4084 ($24.60 in chips)
Seat 2: Player#6419 ($19.52 in chips)
Seat 3: Player#9905 ($34.76 in chips)
Seat 4: Player#9044 ($30.09 in chips)
Seat 5: Player#7568 ($60.92 in chips)
Seat 6: warioman ($23.30 in chips)
Player#7568: posts small blind $0.10
warioman: posts big blind $0.20
*** HOLE CARDS ***
Dealt to warioman [Js Qc]
Player#4084: folds
Player#6419: folds
Player#9905: folds
Player#9044: folds
Player#7568: folds
warioman collected $0.20 from pot
*** SUMMARY ***
Total Pot $0.20 | Rake $0.00
Seat 1: Player#4084 folded before the flop
Seat 2: Player#6419 folded before the flop
Seat 3: Player#9905 folded before the flop
Seat 4: Player#9044 (button) folded before the flop
Seat 5: Player#7568 (small blind) folded before the flop
Seat 6: warioman (big blind)

PokerStars Hand #28fc9b77-dc1b-4fc6-9152-be1dd5ec0df0:  Hold'em No Limit ($0.05/$0.10 USD) - 2021/11/20 11:00:00 ET
Table 'Aberdeen' 6-max Seat #6 is the button
Seat 1: Player#5510 ($4.56 in chips)
Seat 2: Player#6548 ($18.64 in chips)
Seat 3: warioman ($18.05 in chips)
Seat 4: Player#5034 ($10.00 in chips)
Seat 5: Player#8627 ($8.00 in chips)
Player#5510: posts small blind $0.05
Player#6548: posts big blind $0.10
*** HOLE CARDS ***
Dealt to warioman [5c 7s]
warioman: folds
Player#5034: folds
Player#8627: folds
Player#5510: calls $0.05
Player#6548: checks
*** FLOP *** [4c Tc 3h]
Player#5510: bets $0.20
Player#6548: calls $0.20
*** TURN *** [4c Tc 3h] [Ac]
Player#5510: bets $0.30
Player#6548: raises0.30 to $1
Player#5510: raises $1.00 to $4.26
Player#6548: calls $3.26
Player#5510 Showing Pocket Cards 9T
Player#6548 Showing Pocket Cards 6J
*** RIVER *** [4c Tc 3h] [Ac] [3c]
Player#6548 collected $8.66 from pot
*** SUMMARY ***
Total Pot $9.12 | Rake $0.46
Board [4c Tc 3h Ac 3c]
Seat 1: Player#5510 (small blind) mucked
Seat 2: Player#6548 shows [6c Jc] and won ($8.66) with 
Seat 3: warioman folded before the flop
Seat 4: Player#5034 folded before the flop
Seat 5: Player#8627 folded before the flop

PokerStars Hand #c74976a6-f722-425b-b2b2-01170ae1cd0f:  Hold'em No Limit ($0.05/$0.10 USD) - 2021/11/20 10:59:00 ET
Table 'Aberdeen' 6-max Seat #4 is the button
Seat 1: Player#6330 ($4.01 in chips)
Seat 2: Player#9388 ($18.64 in chips)
Seat 3: warioman ($18.55 in chips)
Seat 4: Player#7881 ($10.00 in chips)
Seat 5: Player#3424 ($8.05 in chips)
Player#3424: posts small blind $0.05
Player#6330: posts big blind $0.10
*** HOLE CARDS ***
Dealt to warioman [Ad 4d]
Player#9388: folds
warioman: raises $0.10 to $0.5
Player#7881: folds
Player#3424: folds
Player#6330: raises $0.50 to $4.01
warioman: folds
Player#6330: doesn't show hand
Uncalled bet ($4.01) returned to Player#6330
Player#6330 collected $0.55 from pot
*** SUMMARY ***
Total Pot $0.55 | Rake $0.00
Seat 1: Player#6330 shows [] and won ($0.55) with 
Seat 2: Player#9388 folded before the flop
Seat 3: warioman folded before the flop
Seat 4: Player#7881 (button) folded before the flop
Seat 5: Player#3424 (small blind) folded before the flop

PokerStars Hand #9a0ce094-d91e-40ff-9f50-00cb8b0a18ed:  Hold'em No Limit ($0.1/$0.20 USD) - 2021/11/20 10:59:00 ET
Table 'Bethlehem' 6-max Seat #3 is the button
Seat 1: Player#5160 ($24.60 in chips)
Seat 2: Player#0827 ($19.52 in chips)
Seat 3: Player#9453 ($34.46 in chips)
Seat 4: Player#9217 ($30.19 in chips)
Seat 5: Player#3433 ($61.12 in chips)
Seat 6: warioman ($23.30 in chips)
Player#9217: posts small blind $0.10
Player#3433: posts big blind $0.20
*** HOLE CARDS ***
Dealt to warioman [3d 8s]
warioman: folds
Player#5160: folds
Player#0827: folds
Player#9453: raises $0.20 to $0.6
Player#9217: folds
Player#3433: folds
Player#9453: doesn't show hand
Uncalled bet ($0.60) returned to Player#9453
Player#9453 collected $0.30 from pot
*** SUMMARY ***
Total Pot $0.30 | Rake $0.00
Seat 1: Player#5160 folded before the flop
Seat 2: Player#0827 folded before the flop
Seat 3: Player#9453 shows [] and won ($0.30) with 
Seat 4: Player#9217 (small blind) folded before the flop
Seat 5: Player#3433 (big blind) folded before the flop
Seat 6: warioman folded before the flop

PokerStars Hand #38c9a177-7642-420a-a5dc-da4ed1cf89de:  Hold'em No Limit ($0.1/$0.20 USD) - 2021/11/20 10:59:00 ET
Table 'Bel Air' 6-max Seat #4 is the button
Seat 1: Player#4988 ($15.01 in chips)
Seat 2: Player#8182 ($18.04 in chips)
Seat 3: warioman ($24.10 in chips)
Seat 4: Player#8432 ($25.55 in chips)
Seat 5: Player#9226 ($25.07 in chips)
Seat 6: Player#5371 ($23.73 in chips)
Player#9226: posts small blind $0.10
Player#5371: posts big blind $0.20
*** HOLE CARDS ***
Dealt to warioman [4d Qh]
Player#8182 BB + Dead Small 0.3
Player#4988: folds
Player#8182: raises $0.20 to $0.8
warioman: folds
Player#8432: calls $0.80
Player#9226: folds
Player#5371: folds
*** FLOP *** [9d 9s 7h]
Player#8182: checks
Player#8432: bets $2.00
Player#8182: calls $2.00
*** TURN *** [9d 9s 7h] [Ts]
Player#8182: checks
Player#8432: bets $3.00
Player#8182: calls $3.00
*** RIVER *** [9d 9s 7h] [Ts] [9s]
Player#8182: checks
Player#8432: bets $6.00
Player#8182: raises $ 16.00 to $12.14
Player#8432: calls $6.14
*** SHOW DOWN *** 
Player#8432: doesn't show hand
Player#8182 collected $34.68 from pot
*** SUMMARY ***
Total Pot $36.18 | Rake $1.50
Board [9d 9s 7h Ts 9s]
Seat 1: Player#4988 folded before the flop
Seat 2: Player#8182 shows [Ac As] and won ($34.68) with 
Seat 3: warioman folded before the flop
Seat 4: Player#8432 (button) mucked
Seat 5: Player#9226 (small blind) folded before the flop
Seat 6: Player#5371 (big blind) folded before the flop

PokerStars Hand #ed102831-8f74-44f3-890c-ad7e39fb6960:  Hold'em No Limit ($0.05/$0.10 USD) - 2021/11/20 10:59:00 ET
Table 'Aberdeen' 6-max Seat #3 is the button
Seat 1: Player#1168 ($3.86 in chips)
Seat 2: Player#6642 ($18.64 in chips)
Seat 3: warioman ($18.55 in chips)
Seat 4: Player#9790 ($10.05 in chips)
Seat 5: Player#1104 ($8.15 in chips)
Player#9790: posts small blind $0.05
Player#1104: posts big blind $0.10
*** HOLE CARDS ***
Dealt to warioman [7c As]
Player#1168: raises $0.10 to $3.86
Player#6642: folds
warioman: folds
Player#9790: folds
Player#1104: folds
Player#1168: doesn't show hand
Uncalled bet ($3.86) returned to Player#1168
Player#1168 collected $0.15 from pot
*** SUMMARY ***
Total Pot $0.15 | Rake $0.00
Seat 1: Player#1168 shows [] and won ($0.15) with 
Seat 2: Player#6642 folded before the flop
Seat 3: warioman (button) folded before the flop
Seat 4: Player#9790 (small blind) folded before the flop
Seat 5: Player#1104 (big blind) folded before the flop

PokerStars Hand #b195194f-5642-49d1-ae02-5d724575b464:  Hold'em No Limit ($0.1/$0.20 USD) - 2021/11/20 10:59:00 ET
Table 'Bethlehem' 6-max Seat #2 is the button
Seat 1: Player#7869 ($24.60 in chips)
Seat 2: Player#4976 ($19.52 in chips)
Seat 3: Player#1715 ($34.26 in chips)
Seat 4: Player#1338 ($30.39 in chips)
Seat 5: Player#8117 ($61.12 in chips)
Seat 6: warioman ($23.30 in chips)
Player#1715: posts small blind $0.10
Player#1338: posts big blind $0.20
*** HOLE CARDS ***
Dealt to warioman [4s 6d]
Player#8117: folds
warioman: folds
Player#7869: folds
Player#4976: folds
Player#1715: raises $0.20 to $0.6
Player#1338: folds
Player#1715: doesn't show hand
Uncalled bet ($0.60) returned to Player#1715
Player#1715 collected $0.20 from pot
*** SUMMARY ***
Total Pot $0.20 | Rake $0.00
Seat 1: Player#7869 folded before the flop
Seat 2: Player#4976 (button) folded before the flop
Seat 3: Player#1715 shows [] and won ($0.20) with 
Seat 4: Player#1338 (big blind) folded before the flop
Seat 5: Player#8117 folded before the flop
Seat 6: warioman folded before the flop

PokerStars Hand #bd2141f0-49e2-4908-9926-c64b5b5fa18c:  Hold'em No Limit ($0.05/$0.10 USD) - 2021/11/20 10:59:00 ET
Table 'Aberdeen' 6-max Seat #2 is the button
Seat 1: Player#5716 ($3.71 in chips)
Seat 2: Player#4620 ($18.64 in chips)
Seat 3: warioman ($18.60 in chips)
Seat 4: Player#7748 ($10.15 in chips)
Seat 5: Player#7092 ($8.15 in chips)
warioman: posts small blind $0.05
Player#7748: posts big blind $0.10
*** HOLE CARDS ***
Dealt to warioman [8h 8s]
Player#7092: folds
Player#5716: raises $0.10 to $3.71
Player#4620: folds
warioman: folds
Player#7748: folds
Player#5716: doesn't show hand
Uncalled bet ($3.71) returned to Player#5716
Player#5716 collected $0.15 from pot
*** SUMMARY ***
Total Pot $0.15 | Rake $0.00
Seat 1: Player#5716 shows [] and won ($0.15) with 
Seat 2: Player#4620 (button) folded before the flop
Seat 3: warioman (small blind) folded before the flop
Seat 4: Player#7748 (big blind) folded before the flop
Seat 5: Player#7092 folded before the flop

PokerStars Hand #8f2abae5-1956-44fc-82f1-9cec4aaea15b:  Hold'em No Limit ($0.1/$0.20 USD) - 2021/11/20 10:59:00 ET
Table 'Bel Air' 6-max Seat #2 is the button
Seat 1: Player#3468 ($15.01 in chips)
Seat 2: warioman ($24.10 in chips)
Seat 3: Player#3678 ($25.19 in chips)
Seat 4: Player#9655 ($25.47 in chips)
Seat 5: Player#4513 ($23.73 in chips)
Player#3678: posts small blind $0.10
Player#9655: posts big blind $0.20
*** HOLE CARDS ***
Dealt to warioman [Js 6s]
Player#4513: folds
Player#3468: folds
warioman: folds
Player#3678: raises $0.20 to $0.4
Player#9655: calls $0.20
*** FLOP *** [7c 3c 2h]
Player#3678: bets $0.40
Player#9655: folds
Player#3678: doesn't show hand
Uncalled bet ($0.40) returned to Player#3678
Player#3678 collected $0.76 from pot
*** SUMMARY ***
Total Pot $0.80 | Rake $0.04
Board [7c 3c 2h]
Seat 1: Player#3468 folded before the flop
Seat 2: warioman (button) folded before the flop
Seat 3: Player#3678 shows [] and won ($0.76) with 
Seat 4: Player#9655 (big blind) folded on the flop
Seat 5: Player#4513 folded before the flop

PokerStars Hand #9194febc-12b6-440c-b9f4-fc7e058fc730:  Hold'em No Limit ($0.1/$0.20 USD) - 2021/11/20 10:59:00 ET
Table 'Bethlehem' 6-max Seat #1 is the button
Seat 1: Player#7550 ($24.60 in chips)
Seat 2: Player#9799 ($19.62 in chips)
Seat 3: Player#6860 ($34.16 in chips)
Seat 4: Player#7183 ($30.39 in chips)
Seat 5: Player#9577 ($61.12 in chips)
Seat 6: warioman ($23.30 in chips)
Player#9799: posts small blind $0.10
Player#6860: posts big blind $0.20
*** HOLE CARDS ***
Dealt to warioman [8h 4h]
Player#7183: folds
Player#9577: folds
warioman: folds
Player#7550: folds
Player#9799: folds
Player#6860 collected $0.20 from pot
*** SUMMARY ***
Total Pot $0.20 | Rake $0.00
Seat 1: Player#7550 (button) folded before the flop
Seat 2: Player#9799 (small blind) folded before the flop
Seat 3: Player#6860 shows [] and won ($0.20) with 
Seat 4: Player#7183 folded before the flop
Seat 5: Player#9577 folded before the flop
Seat 6: warioman folded before the flop

PokerStars Hand #c4caada7-2bf7-42cc-8ec1-0ca71c938573:  Hold'em No Limit ($0.05/$0.10 USD) - 2021/11/20 10:59:00 ET
Table 'Aberdeen' 6-max Seat #1 is the button
Seat 1: Player#9112 ($3.71 in chips)
Seat 2: Player#5788 ($18.69 in chips)
Seat 3: warioman ($18.70 in chips)
Seat 4: Player#6525 ($10.00 in chips)
Seat 5: Player#8403 ($8.15 in chips)
Player#5788: posts small blind $0.05
warioman: posts big blind $0.10
*** HOLE CARDS ***
Dealt to warioman [2d Jd]
Player#6525: raises $0.10 to $0.3
Player#8403: folds
Player#9112: folds
Player#5788: folds
warioman: folds
Player#6525: doesn't show hand
Uncalled bet ($0.30) returned to Player#6525
Player#6525 collected $0.15 from pot
*** SUMMARY ***
Total Pot $0.15 | Rake $0.00
Seat 1: Player#9112 (button) folded before the flop
Seat 2: Player#5788 (small blind) folded before the flop
Seat 3: warioman (big blind) folded before the flop
Seat 4: Player#6525 shows [] and won ($0.15) with 
Seat 5: Player#8403 folded before the flop

PokerStars Hand #13c9a0da-910f-4090-bab2-73649ba4dbe1:  Hold'em No Limit ($0.1/$0.20 USD) - 2021/11/20 10:59:00 ET
Table 'Bel Air' 6-max Seat #1 is the button
Seat 1: Player#1347 ($15.01 in chips)
Seat 2: warioman ($24.20 in chips)
Seat 3: Player#9238 ($25.09 in chips)
Seat 4: Player#3304 ($25.47 in chips)
Seat 5: Player#5236 ($23.73 in chips)
warioman: posts small blind $0.10
Player#9238: posts big blind $0.20
*** HOLE CARDS ***
Dealt to warioman [Jc 5c]
Player#3304: folds
Player#5236: folds
Player#1347: folds
warioman: folds
Player#9238 collected $0.20 from pot
*** SUMMARY ***
Total Pot $0.20 | Rake $0.00
Seat 1: Player#1347 (button) folded before the flop
Seat 2: warioman (small blind) folded before the flop
Seat 3: Player#9238 shows [] and won ($0.20) with 
Seat 4: Player#3304 folded before the flop
Seat 5: Player#5236 folded before the flop

PokerStars Hand #14cec6f4-32c7-4019-9857-116a1b4255d7:  Hold'em No Limit ($0.1/$0.20 USD) - 2021/11/20 10:59:00 ET
Table 'Bethlehem' 6-max Seat #6 is the button
Seat 1: Player#4367 ($24.70 in chips)
Seat 2: Player#7644 ($19.52 in chips)
Seat 3: Player#7456 ($34.16 in chips)
Seat 4: Player#8430 ($30.39 in chips)
Seat 5: Player#0056 ($61.12 in chips)
Seat 6: warioman ($23.30 in chips)
Player#4367: posts small blind $0.10
Player#7644: posts big blind $0.20
*** HOLE CARDS ***
Dealt to warioman [Qc 9h]
Player#7456: folds
Player#8430: folds
Player#0056: folds
warioman: folds
Player#4367: folds
Player#7644 collected $0.20 from pot
*** SUMMARY ***
Total Pot $0.20 | Rake $0.00
Seat 1: Player#4367 (small blind) folded before the flop
Seat 2: Player#7644 shows [] and won ($0.20) with 
Seat 3: Player#7456 folded before the flop
Seat 4: Player#8430 folded before the flop
Seat 5: Player#0056 folded before the flop
Seat 6: warioman (button) folded before the flop

PokerStars Hand #ebe24f7d-f744-41af-b7e0-2ee6d85b9114:  Hold'em No Limit ($0.05/$0.10 USD) - 2021/11/20 10:58:00 ET
Table 'Aberdeen' 6-max Seat #6 is the button
Seat 1: Player#5034 ($1.75 in chips)
Seat 2: Player#3111 ($18.79 in chips)
Seat 3: warioman ($18.70 in chips)
Seat 4: Player#1960 ($10.58 in chips)
Seat 5: Player#8964 ($8.45 in chips)
Player#5034: posts small blind $0.05
Player#3111: posts big blind $0.10
*** HOLE CARDS ***
Dealt to warioman [4d 7c]
warioman: folds
Player#1960: raises $0.10 to $0.3
Player#8964: calls $0.30
Player#5034: raises $0.30 to $1.75
Player#3111: folds
Player#1960: calls $1.45
Player#8964: folds
Player#5034 Showing Pocket Cards A7
Player#1960 Showing Pocket Cards QJ
*** FLOP *** [2d 8h Qd]
*** TURN *** [2d 8h Qd] [As]
*** RIVER *** [2d 8h Qd] [As] [6h]
Player#5034 collected $3.71 from pot
*** SUMMARY ***
Total Pot $3.90 | Rake $0.20
Board [2d 8h Qd As 6h]
Seat 1: Player#5034 shows [Ad 7h] and won ($3.71) with 
Seat 2: Player#3111 (big blind) folded before the flop
Seat 3: warioman folded before the flop
Seat 4: Player#1960 mucked
Seat 5: Player#8964 folded before the flop

PokerStars Hand #a7038a55-b845-446b-83d9-837ebe884eb8:  Hold'em No Limit ($0.05/$0.10 USD) - 2021/11/20 10:58:00 ET
Table 'Aberdeen' 6-max Seat #4 is the button
Seat 1: Player#5043 ($1.85 in chips)
Seat 2: Player#8182 ($18.79 in chips)
Seat 3: warioman ($18.70 in chips)
Seat 4: Player#4997 ($10.58 in chips)
Seat 5: Player#8176 ($8.35 in chips)
Player#8176: posts small blind $0.05
Player#5043: posts big blind $0.10
*** HOLE CARDS ***
Dealt to warioman [8d Ac]
Player#8182: folds
warioman: folds
Player#4997: folds
Player#8176: raises $0.10 to $0.5
Player#5043: folds
Player#8176: doesn't show hand
Uncalled bet ($0.50) returned to Player#8176
Player#8176 collected $0.10 from pot
*** SUMMARY ***
Total Pot $0.10 | Rake $0.00
Seat 1: Player#5043 (big blind) folded before the flop
Seat 2: Player#8182 folded before the flop
Seat 3: warioman folded before the flop
Seat 4: Player#4997 (button) folded before the flop
Seat 5: Player#8176 shows [] and won ($0.10) with 

PokerStars Hand #4b8d6ddc-fcc8-4679-844b-29d252bd7858:  Hold'em No Limit ($0.1/$0.20 USD) - 2021/11/20 10:58:00 ET
Table 'Bethlehem' 6-max Seat #5 is the button
Seat 1: Player#0266 ($28.70 in chips)
Seat 2: Player#5962 ($19.52 in chips)
Seat 3: Player#0470 ($34.16 in chips)
Seat 4: Player#3545 ($30.39 in chips)
Seat 5: Player#8203 ($61.12 in chips)
Seat 6: warioman ($19.70 in chips)
warioman: posts small blind $0.10
Player#0266: posts big blind $0.20
*** HOLE CARDS ***
Dealt to warioman [Td Tc]
Player#5962: folds
Player#0470: folds
Player#3545: folds
Player#8203: folds
warioman: calls $0.10
Player#0266: raises0.20 to $1
warioman: calls $0.80
*** FLOP *** [7c Jh 2h]
warioman: checks
Player#0266: bets $1.00
warioman: calls $1.00
*** TURN *** [7c Jh 2h] [2s]
warioman: checks
Player#0266: checks
*** RIVER *** [7c Jh 2h] [2s] [7s]
warioman: checks
Player#0266: bets $2.00
warioman: calls $2.00
*** SHOW DOWN *** 
warioman collected $7.60 from pot
*** SUMMARY ***
Total Pot $8.00 | Rake $0.40
Board [7c Jh 2h 2s 7s]
Seat 1: Player#0266 (big blind) mucked
Seat 2: Player#5962 folded before the flop
Seat 3: Player#0470 folded before the flop
Seat 4: Player#3545 folded before the flop
Seat 5: Player#8203 (button) folded before the flop
Seat 6: warioman (small blind)

PokerStars Hand #85a98b91-1c65-46a6-9212-6c41482ab997:  Hold'em No Limit ($0.1/$0.20 USD) - 2021/11/20 10:58:00 ET
Table 'Bel Air' 6-max Seat #6 is the button
Seat 1: Player#8476 ($14.65 in chips)
Seat 2: warioman ($24.60 in chips)
Seat 3: Player#1689 ($25.09 in chips)
Seat 4: Player#6215 ($25.47 in chips)
Seat 5: Player#7124 ($23.73 in chips)
Player#8476: posts small blind $0.10
warioman: posts big blind $0.20
*** HOLE CARDS ***
Dealt to warioman [9h 6d]
Player#1689: folds
Player#6215: folds
Player#7124: folds
Player#8476: calls $0.10
warioman: checks
*** FLOP *** [8d Kd 6h]
Player#8476: bets $0.20
warioman: calls $0.20
*** TURN *** [8d Kd 6h] [3s]
Player#8476: checks
warioman: checks
*** RIVER *** [8d Kd 6h] [3s] [2s]
Player#8476: bets $0.60
warioman: folds
Player#8476: doesn't show hand
Uncalled bet ($0.60) returned to Player#8476
Player#8476 collected $0.76 from pot
*** SUMMARY ***
Total Pot $0.80 | Rake $0.04
Board [8d Kd 6h 3s 2s]
Seat 1: Player#8476 shows [] and won ($0.76) with 
Seat 2: warioman (big blind) folded on the river
Seat 3: Player#1689 folded before the flop
Seat 4: Player#6215 folded before the flop
Seat 5: Player#7124 folded before the flop

PokerStars Hand #abb34424-0aaf-4088-a405-a999d1d12986:  Hold'em No Limit ($0.1/$0.20 USD) - 2021/11/20 10:58:00 ET
Table 'Bel Air' 6-max Seat #4 is the button
Seat 1: Player#7214 ($14.85 in chips)
Seat 2: warioman ($24.60 in chips)
Seat 3: Player#8315 ($25.09 in chips)
Seat 4: Player#4020 ($25.17 in chips)
Seat 5: Player#2003 ($23.83 in chips)
Player#2003: posts small blind $0.10
Player#7214: posts big blind $0.20
*** HOLE CARDS ***
Dealt to warioman [8h 3s]
warioman: folds
Player#8315: folds
Player#4020: raises $0.20 to $0.6
Player#2003: folds
Player#7214: folds
Player#4020: doesn't show hand
Uncalled bet ($0.60) returned to Player#4020
Player#4020 collected $0.30 from pot
*** SUMMARY ***
Total Pot $0.30 | Rake $0.00
Seat 1: Player#7214 (big blind) folded before the flop
Seat 2: warioman folded before the flop
Seat 3: Player#8315 folded before the flop
Seat 4: Player#4020 shows [] and won ($0.30) with 
Seat 5: Player#2003 (small blind) folded before the flop

PokerStars Hand #7a27ce13-9e9e-4830-8a68-0472884eed5f:  Hold'em No Limit ($0.1/$0.20 USD) - 2021/11/20 10:58:00 ET
Table 'Bethlehem' 6-max Seat #4 is the button
Seat 1: Player#7856 ($28.70 in chips)
Seat 2: Player#8513 ($19.72 in chips)
Seat 3: Player#3018 ($34.16 in chips)
Seat 4: Player#9757 ($30.39 in chips)
Seat 5: Player#3539 ($60.72 in chips)
Seat 6: warioman ($19.90 in chips)
Player#3539: posts small blind $0.10
warioman: posts big blind $0.20
*** HOLE CARDS ***
Dealt to warioman [6s 9d]
Player#7856: folds
Player#8513: calls $0.20
Player#3018: folds
Player#9757: folds
Player#3539: raises $0.20 to $0.8
warioman: folds
Player#8513: folds
Player#7856: doesn't show hand
Player#8513: doesn't show hand
Player#3018: doesn't show hand
Player#9757: doesn't show hand
Player#3539: doesn't show hand
warioman: doesn't show hand
Uncalled bet ($0.80) returned to Player#3539
Player#3539 collected $0.40 from pot
*** SUMMARY ***
Total Pot $0.40 | Rake $0.00
Seat 1: Player#7856 folded before the flop
Seat 2: Player#8513 folded before the flop
Seat 3: Player#3018 folded before the flop
Seat 4: Player#9757 (button) folded before the flop
Seat 5: Player#3539 shows [] and won ($0.40) with 
Seat 6: warioman (big blind) folded before the flop

PokerStars Hand #8a8a6ecd-f0c7-4d35-a901-9d4cbd0be92b:  Hold'em No Limit ($0.05/$0.10 USD) - 2021/11/20 10:57:00 ET
Table 'Aberdeen' 6-max Seat #3 is the button
Seat 1: Player#3903 ($0.63 in chips)
Seat 2: Player#9705 ($19.42 in chips)
Seat 3: warioman ($18.70 in chips)
Seat 4: Player#7911 ($10.63 in chips)
Seat 5: Player#9765 ($8.98 in chips)
Player#7911: posts small blind $0.05
Player#9765: posts big blind $0.10
*** HOLE CARDS ***
Dealt to warioman [2s 4s]
Player#3903: raises $0.10 to $0.63
Player#9705: calls $0.63
warioman: folds
Player#7911: folds
Player#9765: calls $0.53
*** FLOP *** [6s 7h Kc]
Player#9765: checks
Player#9705: checks
*** TURN *** [6s 7h Kc] [5c]
Player#9765: bets $0.80
Player#9705: folds
Player#9765 Showing Pocket Cards TK
Player#3903 Showing Pocket Cards 65
*** RIVER *** [6s 7h Kc] [5c] [8s]
Uncalled bet ($0.80) returned to Player#9765
Player#3903 collected $1.84 from pot
*** SUMMARY ***
Total Pot $1.94 | Rake $0.10
Board [6s 7h Kc 5c 8s]
Seat 1: Player#3903 shows [6h 5s] and won ($1.84) with 
Seat 2: Player#9705 folded on the turn
Seat 3: warioman (button) folded before the flop
Seat 4: Player#7911 (small blind) folded before the flop
Seat 5: Player#9765 (big blind) mucked

PokerStars Hand #9e5d2f0a-7606-4b4c-ab4e-231171eb61a1:  Hold'em No Limit ($0.1/$0.20 USD) - 2021/11/20 10:57:00 ET
Table 'Bethlehem' 6-max Seat #3 is the button
Seat 1: Player#7220 ($28.70 in chips)
Seat 2: Player#4376 ($19.72 in chips)
Seat 3: Player#2037 ($34.16 in chips)
Seat 4: Player#2187 ($30.19 in chips)
Seat 5: Player#9026 ($60.92 in chips)
Seat 6: warioman ($19.90 in chips)
Player#2187: posts small blind $0.10
Player#9026: posts big blind $0.20
*** HOLE CARDS ***
Dealt to warioman [6h Th]
warioman: folds
Player#7220: folds
Player#4376: folds
Player#2037: folds
Player#2187: raises $0.20 to $0.6
Player#9026: folds
Player#7220: doesn't show hand
Player#4376: doesn't show hand
Player#2037: doesn't show hand
Player#2187: doesn't show hand
Player#9026: doesn't show hand
warioman: doesn't show hand
Uncalled bet ($0.60) returned to Player#2187
Player#2187 collected $0.20 from pot
*** SUMMARY ***
Total Pot $0.20 | Rake $0.00
Seat 1: Player#7220 folded before the flop
Seat 2: Player#4376 folded before the flop
Seat 3: Player#2037 (button) folded before the flop
Seat 4: Player#2187 shows [] and won ($0.20) with 
Seat 5: Player#9026 (big blind) folded before the flop
Seat 6: warioman folded before the flop

PokerStars Hand #e8e703c1-2a69-4c12-b669-5d15c0dedec8:  Hold'em No Limit ($0.1/$0.20 USD) - 2021/11/20 10:57:00 ET
Table 'Bel Air' 6-max Seat #3 is the button
Seat 1: Player#4532 ($18.04 in chips)
Seat 2: warioman ($24.60 in chips)
Seat 3: Player#2445 ($24.63 in chips)
Seat 4: Player#3453 ($25.27 in chips)
Seat 5: Player#5341 ($24.23 in chips)
Player#3453: posts small blind $0.10
Player#5341: posts big blind $0.20
*** HOLE CARDS ***
Dealt to warioman [7c 2s]
Player#4532: folds
warioman: folds
Player#2445: raises $0.20 to $0.4
Player#3453: folds
Player#5341: calls $0.20
*** FLOP *** [5c 3d 3c]
Player#5341: checks
Player#2445: bets $0.68
Player#5341: folds
Player#2445: doesn't show hand
Uncalled bet ($0.68) returned to Player#2445
Player#2445 collected $0.85 from pot
*** SUMMARY ***
Total Pot $0.90 | Rake $0.05
Board [5c 3d 3c]
Seat 1: Player#4532 folded before the flop
Seat 2: warioman folded before the flop
Seat 3: Player#2445 shows [] and won ($0.85) with 
Seat 4: Player#3453 (small blind) folded before the flop
Seat 5: Player#5341 (big blind) folded on the flop

PokerStars Hand #b76f8d01-fbe7-453d-a794-bccb75914927:  Hold'em No Limit ($0.1/$0.20 USD) - 2021/11/20 10:56:00 ET
Table 'Bethlehem' 6-max Seat #2 is the button
Seat 1: Player#7348 ($28.70 in chips)
Seat 2: Player#5383 ($19.72 in chips)
Seat 3: Player#2122 ($35.86 in chips)
Seat 4: Player#1088 ($30.39 in chips)
Seat 5: Player#1356 ($59.20 in chips)
Seat 6: warioman ($19.90 in chips)
Player#2122: posts small blind $0.10
Player#1088: posts big blind $0.20
*** HOLE CARDS ***
Dealt to warioman [8c 3d]
Player#1356: calls $0.20
warioman: folds
Player#7348: folds
Player#5383: folds
Player#2122: raises0.20 to $1
Player#1088: folds
Player#1356: calls $0.80
*** FLOP *** [2d Qd Qh]
Player#2122: bets $0.70
Player#1356: calls $0.70
*** TURN *** [2d Qd Qh] [3c]
Player#2122: checks
Player#1356: bets $1.80
Player#2122: folds
Player#1356: doesn't show hand
Uncalled bet ($1.80) returned to Player#1356
Player#1356 collected $3.42 from pot
*** SUMMARY ***
Total Pot $3.60 | Rake $0.18
Board [2d Qd Qh 3c]
Seat 1: Player#7348 folded before the flop
Seat 2: Player#5383 (button) folded before the flop
Seat 3: Player#2122 (small blind) folded on the turn
Seat 4: Player#1088 (big blind) folded before the flop
Seat 5: Player#1356 shows [] and won ($3.42) with 
Seat 6: warioman folded before the flop

PokerStars Hand #920996fc-8412-4122-b87b-9732bb845424:  Hold'em No Limit ($0.05/$0.10 USD) - 2021/11/20 10:56:00 ET
Table 'Aberdeen' 6-max Seat #2 is the button
Seat 1: Player#4659 ($10.70 in chips)
Seat 2: Player#0748 ($10.07 in chips)
Seat 3: warioman ($18.75 in chips)
Seat 4: Player#4438 ($10.73 in chips)
Seat 5: Player#7856 ($8.98 in chips)
Seat 6: Player#6151 ($6.71 in chips)
warioman: posts small blind $0.05
Player#4438: posts big blind $0.10
*** HOLE CARDS ***
Dealt to warioman [5s Qs]
Player#6151 BB + Dead Small 0.15
Player#7856: folds
Player#6151: checks
Player#4659: raises $0.10 to $0.2
Player#0748: raises $0.20 to $1.2
warioman: folds
Player#4438: folds
Player#6151: folds
Player#4659: calls $1.00
*** FLOP *** [9d 3d Qh]
Player#4659: bets $9.50
Player#0748: calls $8.87
Player#4659 Showing Pocket Cards 8J
Player#0748 Showing Pocket Cards TT
*** TURN *** [9d 3d Qh] [Kc]
*** RIVER *** [9d 3d Qh] [Kc] [4c]
Player#0748 collected $19.87 from pot
*** SUMMARY ***
Total Pot $20.92 | Rake $1.05
Board [9d 3d Qh Kc 4c]
Seat 1: Player#4659 mucked
Seat 2: Player#0748 shows [Ts Tc] and won ($19.87) with 
Seat 3: warioman (small blind) folded before the flop
Seat 4: Player#4438 (big blind) folded before the flop
Seat 5: Player#7856 folded before the flop
Seat 6: Player#6151 folded before the flop

PokerStars Hand #ce3beab0-70b3-474b-a546-539a49e959d1:  Hold'em No Limit ($0.1/$0.20 USD) - 2021/11/20 10:56:00 ET
Table 'Bel Air' 6-max Seat #2 is the button
Seat 1: Player#4311 ($18.34 in chips)
Seat 2: warioman ($25.60 in chips)
Seat 3: Player#7243 ($24.73 in chips)
Seat 4: Player#3104 ($27.27 in chips)
Seat 5: Player#2836 ($21.10 in chips)
Player#7243: posts small blind $0.10
Player#3104: posts big blind $0.20
*** HOLE CARDS ***
Dealt to warioman [6d 6c]
Player#4311 BB + Dead Small 0.3
Player#2836: raises0.20 to $1
Player#4311: folds
warioman: calls $1.00
Player#7243: folds
Player#3104: calls $0.80
*** FLOP *** [Kc Ad Ks]
Player#3104: checks
Player#2836: checks
warioman: checks
*** TURN *** [Kc Ad Ks] [8h]
Player#3104: bets $1.00
Player#2836: raises1.00 to $2
warioman: folds
Player#3104: folds
Player#2836: doesn't show hand
Uncalled bet ($2.00) returned to Player#2836
Player#2836 collected $3.89 from pot
*** SUMMARY ***
Total Pot $4.10 | Rake $0.20
Board [Kc Ad Ks 8h]
Seat 1: Player#4311 folded before the flop
Seat 2: warioman (button) folded on the turn
Seat 3: Player#7243 (small blind) folded before the flop
Seat 4: Player#3104 (big blind) folded on the turn
Seat 5: Player#2836 shows [] and won ($3.89) with 

PokerStars Hand #81164a01-b045-4270-af91-65109e60bfcb:  Hold'em No Limit ($0.1/$0.20 USD) - 2021/11/20 10:56:00 ET
Table 'Bethlehem' 6-max Seat #1 is the button
Seat 1: Player#3691 ($28.70 in chips)
Seat 2: Player#5472 ($19.82 in chips)
Seat 3: Player#4834 ($36.06 in chips)
Seat 4: Player#3812 ($30.39 in chips)
Seat 5: Player#7113 ($59.20 in chips)
Seat 6: warioman ($19.60 in chips)
Player#5472: posts small blind $0.10
Player#4834: posts big blind $0.20
*** HOLE CARDS ***
Dealt to warioman [7h Kh]
Player#3812: folds
Player#7113: folds
warioman: raises $0.20 to $0.5
Player#3691: folds
Player#5472: folds
Player#4834: folds
warioman: doesn't show hand
Uncalled bet ($0.50) returned to warioman
warioman collected $0.30 from pot
*** SUMMARY ***
Total Pot $0.30 | Rake $0.00
Seat 1: Player#3691 (button) folded before the flop
Seat 2: Player#5472 (small blind) folded before the flop
Seat 3: Player#4834 (big blind) folded before the flop
Seat 4: Player#3812 folded before the flop
Seat 5: Player#7113 folded before the flop
Seat 6: warioman

PokerStars Hand #8c8a6f7c-ff95-4c9b-932f-0c1e2ff421b9:  Hold'em No Limit ($0.05/$0.10 USD) - 2021/11/20 10:56:00 ET
Table 'Aberdeen' 6-max Seat #1 is the button
Seat 1: Player#7253 ($11.20 in chips)
Seat 2: Player#6478 ($9.52 in chips)
Seat 3: warioman ($18.85 in chips)
Seat 4: Player#6290 ($10.73 in chips)
Seat 5: Player#7811 ($8.98 in chips)
Player#6478: posts small blind $0.05
warioman: posts big blind $0.10
*** HOLE CARDS ***
Dealt to warioman [8h 2c]
Player#6290: folds
Player#7811: folds
Player#7253: calls $0.10
Player#6478: raises $0.10 to $0.5
warioman: folds
Player#7253: calls $0.40
*** FLOP *** [Td Kh Qc]
Player#6478: bets $0.90
Player#7253: folds
Player#6478: doesn't show hand
Uncalled bet ($0.90) returned to Player#6478
Player#6478 collected $1.05 from pot
*** SUMMARY ***
Total Pot $1.10 | Rake $0.06
Board [Td Kh Qc]
Seat 1: Player#7253 (button) folded on the flop
Seat 2: Player#6478 shows [] and won ($1.05) with 
Seat 3: warioman (big blind) folded before the flop
Seat 4: Player#6290 folded before the flop
Seat 5: Player#7811 folded before the flop

PokerStars Hand #765664d1-e9c8-4137-8b3d-aef00a98f3c2:  Hold'em No Limit ($0.1/$0.20 USD) - 2021/11/20 10:55:00 ET
Table 'Bethlehem' 6-max Seat #6 is the button
Seat 1: Player#8182 ($28.50 in chips)
Seat 2: Player#0338 ($20.02 in chips)
Seat 3: Player#1477 ($36.06 in chips)
Seat 4: Player#3035 ($30.39 in chips)
Seat 5: Player#6693 ($59.20 in chips)
Seat 6: warioman ($19.60 in chips)
Player#8182: posts small blind $0.10
Player#0338: posts big blind $0.20
*** HOLE CARDS ***
Dealt to warioman [9h 3d]
Player#1477: folds
Player#3035: folds
Player#6693: folds
warioman: folds
Player#8182: raises $0.20 to $0.6
Player#0338: folds
Player#8182: doesn't show hand
Uncalled bet ($0.60) returned to Player#8182
Player#8182 collected $0.20 from pot
*** SUMMARY ***
Total Pot $0.20 | Rake $0.00
Seat 1: Player#8182 shows [] and won ($0.20) with 
Seat 2: Player#0338 (big blind) folded before the flop
Seat 3: Player#1477 folded before the flop
Seat 4: Player#3035 folded before the flop
Seat 5: Player#6693 folded before the flop
Seat 6: warioman (button) folded before the flop

PokerStars Hand #27da83d8-2154-4139-ac97-9be6cd86faf5:  Hold'em No Limit ($0.05/$0.10 USD) - 2021/11/20 10:55:00 ET
Table 'Aberdeen' 6-max Seat #6 is the button
Seat 1: Player#3926 ($10.10 in chips)
Seat 2: Player#6314 ($9.62 in chips)
Seat 3: warioman ($19.35 in chips)
Seat 4: Player#6669 ($10.73 in chips)
Seat 5: Player#1296 ($9.48 in chips)
Player#3926: posts small blind $0.05
Player#6314: posts big blind $0.10
*** HOLE CARDS ***
Dealt to warioman [9s Js]
warioman: raises $0.10 to $0.5
Player#6669: folds
Player#1296: calls $0.50
Player#3926: raises0.50 to $2
Player#6314: folds
warioman: folds
Player#1296: folds
Player#3926: doesn't show hand
Uncalled bet ($2.00) returned to Player#3926
Player#3926 collected $1.10 from pot
*** SUMMARY ***
Total Pot $1.10 | Rake $0.00
Seat 1: Player#3926 shows [] and won ($1.10) with 
Seat 2: Player#6314 (big blind) folded before the flop
Seat 3: warioman folded before the flop
Seat 4: Player#6669 folded before the flop
Seat 5: Player#1296 folded before the flop

PokerStars Hand #16a09464-2b2c-4ff3-af9f-c3f473ff5af8:  Hold'em No Limit ($0.1/$0.20 USD) - 2021/11/20 10:55:00 ET
Table 'Bel Air' 6-max Seat #6 is the button
Seat 1: warioman ($25.15 in chips)
Seat 2: Player#1498 ($25.23 in chips)
Seat 3: Player#1902 ($27.27 in chips)
Seat 4: Player#5465 ($21.10 in chips)
warioman: posts small blind $0.10
Player#1498: posts big blind $0.20
*** HOLE CARDS ***
Dealt to warioman [As Js]
Player#1902: folds
Player#5465: folds
warioman: raises $0.20 to $0.5
Player#1498: calls $0.30
*** FLOP *** [Qc Qd 8d]
warioman: checks
Player#1498: checks
*** TURN *** [Qc Qd 8d] [Td]
warioman: checks
Player#1498: checks
*** RIVER *** [Qc Qd 8d] [Td] [9d]
warioman: checks
Player#1498: checks
*** SHOW DOWN *** 
warioman collected $0.95 from pot
*** SUMMARY ***
Total Pot $1.00 | Rake $0.05
Board [Qc Qd 8d Td 9d]
Seat 1: warioman (small blind)
Seat 2: Player#1498 (big blind) mucked
Seat 3: Player#1902 folded before the flop
Seat 4: Player#5465 folded before the flop

PokerStars Hand #d5fa6b5c-a96e-47d8-8e88-cf322a02f1fb:  Hold'em No Limit ($0.05/$0.10 USD) - 2021/11/20 10:55:00 ET
Table 'Aberdeen' 6-max Seat #4 is the button
Seat 1: Player#5342 ($9.78 in chips)
Seat 2: Player#0091 ($9.92 in chips)
Seat 3: warioman ($19.35 in chips)
Seat 4: Player#2901 ($10.73 in chips)
Seat 5: Player#8872 ($9.53 in chips)
Player#8872: posts small blind $0.05
Player#5342: posts big blind $0.10
*** HOLE CARDS ***
Dealt to warioman [Ts 4s]
Player#0091: raises $0.10 to $0.3
warioman: folds
Player#2901: folds
Player#8872: folds
Player#5342: calls $0.20
*** FLOP *** [3c 9d Qc]
Player#5342: bets $0.33
Player#0091: folds
Player#5342: doesn't show hand
Uncalled bet ($0.33) returned to Player#5342
Player#5342 collected $0.62 from pot
*** SUMMARY ***
Total Pot $0.65 | Rake $0.03
Board [3c 9d Qc]
Seat 1: Player#5342 shows [] and won ($0.62) with 
Seat 2: Player#0091 folded on the flop
Seat 3: warioman folded before the flop
Seat 4: Player#2901 (button) folded before the flop
Seat 5: Player#8872 (small blind) folded before the flop

PokerStars Hand #8cf7725f-95d0-4820-a194-ab61522d7abb:  Hold'em No Limit ($0.05/$0.10 USD) - 2021/11/20 10:55:00 ET
Table 'Aberdeen' 6-max Seat #3 is the button
Seat 1: Player#0187 ($9.78 in chips)
Seat 2: Player#7652 ($9.92 in chips)
Seat 3: warioman ($19.35 in chips)
Seat 4: Player#5658 ($10.78 in chips)
Seat 5: Player#1360 ($9.48 in chips)
Player#5658: posts small blind $0.05
Player#1360: posts big blind $0.10
*** HOLE CARDS ***
Dealt to warioman [3h 3d]
Player#0187: folds
Player#7652: folds
warioman: folds
Player#5658: folds
Player#1360 collected $0.10 from pot
*** SUMMARY ***
Total Pot $0.10 | Rake $0.00
Seat 1: Player#0187 folded before the flop
Seat 2: Player#7652 folded before the flop
Seat 3: warioman (button) folded before the flop
Seat 4: Player#5658 (small blind) folded before the flop
Seat 5: Player#1360 shows [] and won ($0.10) with 

PokerStars Hand #dabe0dd7-244f-48fe-bce8-0b2c5a85709c:  Hold'em No Limit ($0.1/$0.20 USD) - 2021/11/20 10:55:00 ET
Table 'Bethlehem' 6-max Seat #5 is the button
Seat 1: Player#1949 ($28.70 in chips)
Seat 2: Player#8993 ($20.02 in chips)
Seat 3: Player#1683 ($36.26 in chips)
Seat 4: Player#4898 ($30.59 in chips)
Seat 5: Player#0563 ($58.54 in chips)
Seat 6: warioman ($19.70 in chips)
warioman: posts small blind $0.10
Player#1949: posts big blind $0.20
*** HOLE CARDS ***
Dealt to warioman [5h Tc]
Player#8993: folds
Player#1683: calls $0.20
Player#4898: calls $0.20
Player#0563: calls $0.20
warioman: folds
Player#1949: checks
*** FLOP *** [5c Qd 9s]
Player#1949: checks
Player#1683: checks
Player#4898: checks
Player#0563: bets $0.60
Player#1949: folds
Player#1683: folds
Player#4898: folds
Player#1949: doesn't show hand
Player#8993: doesn't show hand
Player#1683: doesn't show hand
Player#4898: doesn't show hand
Player#0563: doesn't show hand
warioman: doesn't show hand
Uncalled bet ($0.60) returned to Player#0563
Player#0563 collected $0.85 from pot
*** SUMMARY ***
Total Pot $0.90 | Rake $0.05
Board [5c Qd 9s]
Seat 1: Player#1949 (big blind) folded on the flop
Seat 2: Player#8993 folded before the flop
Seat 3: Player#1683 folded on the flop
Seat 4: Player#4898 folded on the flop
Seat 5: Player#0563 shows [] and won ($0.85) with 
Seat 6: warioman (small blind) folded before the flop

PokerStars Hand #b093c32a-02f2-4779-b83c-6444c6344fb2:  Hold'em No Limit ($0.1/$0.20 USD) - 2021/11/20 10:54:00 ET
Table 'Bel Air' 6-max Seat #6 is the button
Seat 1: Player#6351 ($8.20 in chips)
Seat 2: warioman ($25.35 in chips)
Seat 3: Player#8127 ($25.23 in chips)
Seat 4: Player#9473 ($19.70 in chips)
Seat 5: Player#2905 ($21.10 in chips)
Player#6351: posts small blind $0.10
warioman: posts big blind $0.20
*** HOLE CARDS ***
Dealt to warioman [2s Jc]
Player#8127: folds
Player#9473: raises $0.20 to $0.6
Player#2905: folds
Player#6351: raises0.60 to $1
warioman: folds
Player#9473: calls $0.40
*** FLOP *** [Ts As Jd]
Player#6351: bets $1.65
Player#9473: raises $1.65 to $3.3
Player#6351: raises $3.30 to $7.2
Player#9473: calls $3.90
Player#6351 Showing Pocket Cards KK
Player#9473 Showing Pocket Cards TJ
*** TURN *** [Ts As Jd] [Th]
*** RIVER *** [Ts As Jd] [Th] [9d]
Player#9473 collected $15.77 from pot
*** SUMMARY ***
Total Pot $16.60 | Rake $0.83
Board [Ts As Jd Th 9d]
Seat 1: Player#6351 (small blind) mucked
Seat 2: warioman (big blind) folded before the flop
Seat 3: Player#8127 folded before the flop
Seat 4: Player#9473 shows [Tc Jh] and won ($15.77) with 
Seat 5: Player#2905 folded before the flop

PokerStars Hand #0e21fe2b-4ce1-452f-b5d0-82034aba7916:  Hold'em No Limit ($0.05/$0.10 USD) - 2021/11/20 10:54:00 ET
Table 'Aberdeen' 6-max Seat #2 is the button
Seat 1: Player#8128 ($9.63 in chips)
Seat 2: Player#7375 ($9.92 in chips)
Seat 3: warioman ($19.40 in chips)
Seat 4: Player#9661 ($10.88 in chips)
Seat 5: Player#8298 ($9.48 in chips)
warioman: posts small blind $0.05
Player#9661: posts big blind $0.10
*** HOLE CARDS ***
Dealt to warioman [Jd Qc]
Player#8298: folds
Player#8128: raises $0.10 to $0.5
Player#7375: folds
warioman: folds
Player#9661: folds
Player#8128: doesn't show hand
Uncalled bet ($0.50) returned to Player#8128
Player#8128 collected $0.15 from pot
*** SUMMARY ***
Total Pot $0.15 | Rake $0.00
Seat 1: Player#8128 shows [] and won ($0.15) with 
Seat 2: Player#7375 (button) folded before the flop
Seat 3: warioman (small blind) folded before the flop
Seat 4: Player#9661 (big blind) folded before the flop
Seat 5: Player#8298 folded before the flop

PokerStars Hand #9fcc099f-ee91-40cd-8606-8950a63513ae:  Hold'em No Limit ($0.05/$0.10 USD) - 2021/11/20 10:54:00 ET
Table 'Aberdeen' 6-max Seat #1 is the button
Seat 1: Player#4586 ($9.63 in chips)
Seat 2: Player#9967 ($9.97 in chips)
Seat 3: warioman ($19.50 in chips)
Seat 4: Player#1597 ($10.88 in chips)
Seat 5: Player#5315 ($9.33 in chips)
Player#9967: posts small blind $0.05
warioman: posts big blind $0.10
*** HOLE CARDS ***
Dealt to warioman [Ts 4s]
Player#1597: folds
Player#5315: raises $0.10 to $0.4
Player#4586: folds
Player#9967: folds
warioman: folds
Player#5315: doesn't show hand
Uncalled bet ($0.40) returned to Player#5315
Player#5315 collected $0.15 from pot
*** SUMMARY ***
Total Pot $0.15 | Rake $0.00
Seat 1: Player#4586 (button) folded before the flop
Seat 2: Player#9967 (small blind) folded before the flop
Seat 3: warioman (big blind) folded before the flop
Seat 4: Player#1597 folded before the flop
Seat 5: Player#5315 shows [] and won ($0.15) with 

PokerStars Hand #99313f32-5bb5-4a58-85d7-6ae9c363943e:  Hold'em No Limit ($0.1/$0.20 USD) - 2021/11/20 10:54:00 ET
Table 'Bel Air' 6-max Seat #5 is the button
Seat 1: Player#7295 ($8.40 in chips)
Seat 2: Player#2096 ($18.34 in chips)
Seat 3: warioman ($25.85 in chips)
Seat 4: Player#9388 ($25.23 in chips)
Seat 5: Player#1632 ($19.70 in chips)
Seat 6: Player#2199 ($20.40 in chips)
Player#2199: posts small blind $0.10
Player#7295: posts big blind $0.20
*** HOLE CARDS ***
Dealt to warioman [Ah Js]
Player#2096: folds
warioman: raises $0.20 to $0.5
Player#9388: folds
Player#1632: folds
Player#2199: raises $0.50 to $1.9
Player#7295: folds
warioman: folds
Player#2199: doesn't show hand
Uncalled bet ($1.90) returned to Player#2199
Player#2199 collected $0.70 from pot
*** SUMMARY ***
Total Pot $0.70 | Rake $0.00
Seat 1: Player#7295 (big blind) folded before the flop
Seat 2: Player#2096 folded before the flop
Seat 3: warioman folded before the flop
Seat 4: Player#9388 folded before the flop
Seat 5: Player#1632 (button) folded before the flop
Seat 6: Player#2199 shows [] and won ($0.70) with 

PokerStars Hand #8dcdb7d2-e174-4954-ab3e-e1fb266d4684:  Hold'em No Limit ($0.05/$0.10 USD) - 2021/11/20 10:54:00 ET
Table 'Aberdeen' 6-max Seat #6 is the button
Seat 1: Player#7539 ($9.03 in chips)
Seat 2: Player#0138 ($10.07 in chips)
Seat 3: warioman ($20.00 in chips)
Seat 4: Player#1173 ($10.88 in chips)
Seat 5: Player#2425 ($9.33 in chips)
Player#7539: posts small blind $0.05
Player#0138: posts big blind $0.10
*** HOLE CARDS ***
Dealt to warioman [Qd Ks]
warioman: raises $0.10 to $0.5
Player#1173: folds
Player#2425: folds
Player#7539: raises0.50 to $2
Player#0138: folds
warioman: folds
Player#7539: doesn't show hand
Uncalled bet ($2.00) returned to Player#7539
Player#7539 collected $0.60 from pot
*** SUMMARY ***
Total Pot $0.60 | Rake $0.00
Seat 1: Player#7539 shows [] and won ($0.60) with 
Seat 2: Player#0138 (big blind) folded before the flop
Seat 3: warioman folded before the flop
Seat 4: Player#1173 folded before the flop
Seat 5: Player#2425 folded before the flop

PokerStars Hand #53ddfd81-b5c5-4d46-a540-19f7a40caba0:  Hold'em No Limit ($0.1/$0.20 USD) - 2021/11/20 10:54:00 ET
Table 'Bethlehem' 6-max Seat #4 is the button
Seat 1: Player#6595 ($28.70 in chips)
Seat 2: Player#8370 ($20.22 in chips)
Seat 3: Player#9531 ($36.26 in chips)
Seat 4: Player#3385 ($29.31 in chips)
Seat 5: Player#0496 ($59.54 in chips)
Seat 6: warioman ($19.90 in chips)
Player#0496: posts small blind $0.10
warioman: posts big blind $0.20
*** HOLE CARDS ***
Dealt to warioman [Ks 4s]
Player#6595: folds
Player#8370: calls $0.20
Player#9531: folds
Player#3385: raises0.20 to $1
Player#0496: calls $0.90
warioman: folds
Player#8370: folds
*** FLOP *** [Kc 7h 4d]
Player#0496: checks
Player#3385: bets $1.20
Player#0496: folds
Player#3385: doesn't show hand
Uncalled bet ($1.20) returned to Player#3385
Player#3385 collected $2.28 from pot
*** SUMMARY ***
Total Pot $2.40 | Rake $0.12
Board [Kc 7h 4d]
Seat 1: Player#6595 folded before the flop
Seat 2: Player#8370 folded before the flop
Seat 3: Player#9531 folded before the flop
Seat 4: Player#3385 shows [] and won ($2.28) with 
Seat 5: Player#0496 (small blind) folded on the flop
Seat 6: warioman (big blind) folded before the flop

PokerStars Hand #ae44955b-f47e-4b83-b5a7-11374f9cfab8:  Hold'em No Limit ($0.1/$0.20 USD) - 2021/11/20 10:54:00 ET
Table 'Bel Air' 6-max Seat #4 is the button
Seat 1: Player#0924 ($8.40 in chips)
Seat 2: Player#6309 ($18.34 in chips)
Seat 3: warioman ($25.85 in chips)
Seat 4: Player#1387 ($25.23 in chips)
Seat 5: Player#4692 ($19.80 in chips)
Seat 6: Player#5721 ($20.30 in chips)
Player#4692: posts small blind $0.10
Player#5721: posts big blind $0.20
*** HOLE CARDS ***
Dealt to warioman [4s Jd]
Player#0924: folds
Player#6309: folds
warioman: folds
Player#1387: folds
Player#4692: folds
Player#5721 collected $0.20 from pot
*** SUMMARY ***
Total Pot $0.20 | Rake $0.00
Seat 1: Player#0924 folded before the flop
Seat 2: Player#6309 folded before the flop
Seat 3: warioman folded before the flop
Seat 4: Player#1387 (button) folded before the flop
Seat 5: Player#4692 (small blind) folded before the flop
Seat 6: Player#5721 shows [] and won ($0.20) with 

PokerStars Hand #8c869c28-67fb-4af2-9c83-8cb7bcd8ecf7:  Hold'em No Limit ($0.1/$0.20 USD) - 2021/11/20 10:54:00 ET
Table 'Bethlehem' 6-max Seat #3 is the button
Seat 1: Player#0430 ($28.70 in chips)
Seat 2: Player#2773 ($20.22 in chips)
Seat 3: Player#9203 ($36.26 in chips)
Seat 4: Player#5628 ($29.41 in chips)
Seat 5: Player#0400 ($59.44 in chips)
Seat 6: warioman ($19.90 in chips)
Player#5628: posts small blind $0.10
Player#0400: posts big blind $0.20
*** HOLE CARDS ***
Dealt to warioman [2c 3c]
warioman: folds
Player#0430: folds
Player#2773: folds
Player#9203: folds
Player#5628: folds
Player#0400 collected $0.20 from pot
*** SUMMARY ***
Total Pot $0.20 | Rake $0.00
Seat 1: Player#0430 folded before the flop
Seat 2: Player#2773 folded before the flop
Seat 3: Player#9203 (button) folded before the flop
Seat 4: Player#5628 (small blind) folded before the flop
Seat 5: Player#0400 shows [] and won ($0.20) with 
Seat 6: warioman folded before the flop

PokerStars Hand #f065a2dd-878e-4bbf-ad01-17bc4bcef5e6:  Hold'em No Limit ($0.05/$0.10 USD) - 2021/11/20 10:53:00 ET
Table 'Aberdeen' 6-max Seat #4 is the button
Seat 1: Player#2387 ($8.85 in chips)
Seat 2: Player#7972 ($10.07 in chips)
Seat 3: warioman ($20.00 in chips)
Seat 4: Player#3720 ($10.88 in chips)
Seat 5: Player#4611 ($9.53 in chips)
Seat 6: Player#4996 ($6.71 in chips)
Player#4611: posts small blind $0.05
Player#2387: posts big blind $0.10
*** HOLE CARDS ***
Dealt to warioman [7s 9h]
Player#4996 Decline Entry Bet
Player#7972: folds
warioman: folds
Player#3720: folds
Player#4611: calls $0.05
Player#2387: raises $0.10 to $0.2
Player#4611: calls $0.10
*** FLOP *** [Ad Kh 8d]
Player#4611: checks
Player#2387: bets $0.10
Player#4611: folds
Player#2387: doesn't show hand
Uncalled bet ($0.10) returned to Player#2387
Player#2387 collected $0.38 from pot
*** SUMMARY ***
Total Pot $0.40 | Rake $0.02
Board [Ad Kh 8d]
Seat 1: Player#2387 shows [] and won ($0.38) with 
Seat 2: Player#7972 folded before the flop
Seat 3: warioman folded before the flop
Seat 4: Player#3720 (button) folded before the flop
Seat 5: Player#4611 (small blind) folded on the flop
Seat 6: Player#4996 mucked

PokerStars Hand #80fed985-c7dc-4018-bd24-9fd6ff90a555:  Hold'em No Limit ($0.05/$0.10 USD) - 2021/11/20 10:53:00 ET
Table 'Aberdeen' 6-max Seat #6 is the button
Seat 1: Player#3462 ($8.85 in chips)
Seat 2: Player#7716 ($10.07 in chips)
Seat 3: warioman ($19.85 in chips)
Seat 4: Player#2561 ($10.93 in chips)
Seat 5: Player#4690 ($9.63 in chips)
Seat 6: Player#9553 ($6.71 in chips)
Player#3462: posts small blind $0.05
Player#2561: posts big blind $0.10
*** HOLE CARDS ***
Dealt to warioman [Kh Ts]
Player#3462 Waiting
Player#9553: folds
Player#7716: folds
warioman: raises $0.10 to $0.3
Player#2561: folds
Player#4690: folds
warioman: doesn't show hand
Uncalled bet ($0.30) returned to warioman
warioman collected $0.15 from pot
*** SUMMARY ***
Total Pot $0.15 | Rake $0.00
Seat 1: Player#3462 (small blind) mucked
Seat 2: Player#7716 folded before the flop
Seat 3: warioman
Seat 4: Player#2561 (big blind) folded before the flop
Seat 5: Player#4690 folded before the flop
Seat 6: Player#9553 (button) folded before the flop

PokerStars Hand #de5de908-4f10-45af-9fa8-8a568ce4b33e:  Hold'em No Limit ($0.1/$0.20 USD) - 2021/11/20 10:53:00 ET
Table 'Bel Air' 6-max Seat #3 is the button
Seat 1: Player#0860 ($8.40 in chips)
Seat 2: Player#9890 ($16.08 in chips)
Seat 3: warioman ($25.85 in chips)
Seat 4: Player#3119 ($27.53 in chips)
Seat 5: Player#3403 ($20.00 in chips)
Seat 6: Player#2929 ($20.30 in chips)
Player#3119: posts small blind $0.10
Player#3403: posts big blind $0.20
*** HOLE CARDS ***
Dealt to warioman [Ts 8d]
Player#9890 BB + Dead Small 0.3
Player#2929: folds
Player#0860: folds
Player#9890: checks
warioman: folds
Player#3119: calls $0.10
Player#3403: checks
*** FLOP *** [Qh 3s 2s]
Player#3119: checks
Player#3403: checks
Player#9890: bets $0.70
Player#3119: calls $0.70
Player#3403: folds
*** TURN *** [Qh 3s 2s] [4c]
Player#3119: checks
Player#9890: checks
*** RIVER *** [Qh 3s 2s] [4c] [3c]
Player#3119: bets $1.40
Player#9890: calls $1.40
*** SHOW DOWN *** 
Player#9890 collected $4.37 from pot
*** SUMMARY ***
Total Pot $4.60 | Rake $0.23
Board [Qh 3s 2s 4c 3c]
Seat 1: Player#0860 folded before the flop
Seat 2: Player#9890 shows [4h Ac] and won ($4.37) with 
Seat 3: warioman (button) folded before the flop
Seat 4: Player#3119 (small blind) mucked
Seat 5: Player#3403 (big blind) folded on the flop
Seat 6: Player#2929 folded before the flop

PokerStars Hand #c2b124ac-3045-4b7e-80a5-a2f2ec4a01e3:  Hold'em No Limit ($0.1/$0.20 USD) - 2021/11/20 10:53:00 ET
Table 'Bethlehem' 6-max Seat #2 is the button
Seat 1: Player#5673 ($28.70 in chips)
Seat 2: Player#0090 ($20.22 in chips)
Seat 3: Player#2611 ($36.36 in chips)
Seat 4: Player#4128 ($29.61 in chips)
Seat 5: Player#1242 ($59.16 in chips)
Seat 6: warioman ($19.90 in chips)
Player#2611: posts small blind $0.10
Player#4128: posts big blind $0.20
*** HOLE CARDS ***
Dealt to warioman [Kc 3s]
Player#1242: calls $0.20
warioman: folds
Player#5673: folds
Player#0090: folds
Player#2611: folds
Player#4128: checks
*** FLOP *** [Qd 8d 5d]
Player#4128: checks
Player#1242: checks
*** TURN *** [Qd 8d 5d] [9s]
Player#4128: checks
Player#1242: bets $0.40
Player#4128: folds
Player#5673: doesn't show hand
Player#0090: doesn't show hand
Player#2611: doesn't show hand
Player#4128: doesn't show hand
Player#1242: doesn't show hand
warioman: doesn't show hand
Uncalled bet ($0.40) returned to Player#1242
Player#1242 collected $0.47 from pot
*** SUMMARY ***
Total Pot $0.50 | Rake $0.03
Board [Qd 8d 5d 9s]
Seat 1: Player#5673 folded before the flop
Seat 2: Player#0090 (button) folded before the flop
Seat 3: Player#2611 (small blind) folded before the flop
Seat 4: Player#4128 (big blind) folded on the turn
Seat 5: Player#1242 shows [] and won ($0.47) with 
Seat 6: warioman folded before the flop

PokerStars Hand #c1284793-edee-4582-bbc9-891183d70f92:  Hold'em No Limit ($0.1/$0.20 USD) - 2021/11/20 10:53:00 ET
Table 'Bel Air' 6-max Seat #2 is the button
Seat 1: Player#2353 ($8.40 in chips)
Seat 2: Player#2605 ($16.08 in chips)
Seat 3: warioman ($25.95 in chips)
Seat 4: Player#4911 ($27.73 in chips)
Seat 5: Player#7110 ($20.00 in chips)
warioman: posts small blind $0.10
Player#4911: posts big blind $0.20
*** HOLE CARDS ***
Dealt to warioman [Qs Jc]
Player#7110: raises $0.20 to $0.7
Player#2353: folds
warioman: folds
Player#4911: folds
Player#7110: doesn't show hand
Uncalled bet ($0.70) returned to Player#7110
Player#7110 collected $0.30 from pot
*** SUMMARY ***
Total Pot $0.30 | Rake $0.00
Seat 1: Player#2353 folded before the flop
Seat 2: Player#2605 (button) mucked
Seat 3: warioman (small blind) folded before the flop
Seat 4: Player#4911 (big blind) folded before the flop
Seat 5: Player#7110 shows [] and won ($0.30) with 

PokerStars Hand #ca8c2aac-e634-4bb3-b3da-aa53f85bda8f:  Hold'em No Limit ($0.1/$0.20 USD) - 2021/11/20 10:53:00 ET
Table 'Bethlehem' 6-max Seat #1 is the button
Seat 1: Player#0097 ($28.70 in chips)
Seat 2: Player#9434 ($20.32 in chips)
Seat 3: Player#1796 ($36.06 in chips)
Seat 4: Player#7461 ($29.61 in chips)
Seat 5: Player#1352 ($59.36 in chips)
Seat 6: warioman ($19.90 in chips)
Player#9434: posts small blind $0.10
Player#1796: posts big blind $0.20
*** HOLE CARDS ***
Dealt to warioman [Kd 9h]
Player#7461: folds
Player#1352: calls $0.20
warioman: folds
Player#0097: folds
Player#9434: folds
Player#1796: raises0.20 to $1
Player#1352: folds
Player#1796: doesn't show hand
Uncalled bet ($1.00) returned to Player#1796
Player#1796 collected $0.30 from pot
*** SUMMARY ***
Total Pot $0.30 | Rake $0.00
Seat 1: Player#0097 (button) folded before the flop
Seat 2: Player#9434 (small blind) folded before the flop
Seat 3: Player#1796 shows [] and won ($0.30) with 
Seat 4: Player#7461 folded before the flop
Seat 5: Player#1352 folded before the flop
Seat 6: warioman folded before the flop

PokerStars Hand #bae40959-1e1a-47cb-a9d6-d85048a958ed:  Hold'em No Limit ($0.1/$0.20 USD) - 2021/11/20 10:52:00 ET
Table 'Bethlehem' 6-max Seat #6 is the button
Seat 1: Player#3699 ($28.80 in chips)
Seat 2: Player#1792 ($20.22 in chips)
Seat 3: Player#1934 ($36.06 in chips)
Seat 4: Player#7836 ($29.61 in chips)
Seat 5: Player#6291 ($59.36 in chips)
Seat 6: warioman ($19.90 in chips)
Player#3699: posts small blind $0.10
Player#1792: posts big blind $0.20
*** HOLE CARDS ***
Dealt to warioman [5c As]
Player#1934: folds
Player#7836: folds
Player#6291: folds
warioman: folds
Player#3699: folds
Player#1792 collected $0.20 from pot
*** SUMMARY ***
Total Pot $0.20 | Rake $0.00
Seat 1: Player#3699 (small blind) folded before the flop
Seat 2: Player#1792 shows [] and won ($0.20) with 
Seat 3: Player#1934 folded before the flop
Seat 4: Player#7836 folded before the flop
Seat 5: Player#6291 folded before the flop
Seat 6: warioman (button) folded before the flop

PokerStars Hand #7d41589a-f2fd-407d-9c27-4ff431756791:  Hold'em No Limit ($0.05/$0.10 USD) - 2021/11/20 10:52:00 ET
Table 'Aberdeen' 6-max Seat #1 is the button
Seat 1: Player#4825 ($9.75 in chips)
Seat 2: warioman ($19.90 in chips)
Seat 3: Player#5302 ($11.23 in chips)
Seat 4: Player#5060 ($9.63 in chips)
Seat 5: Player#2111 ($6.71 in chips)
warioman: posts small blind $0.05
Player#5302: posts big blind $0.10
*** HOLE CARDS ***
Dealt to warioman [Ts 2s]
Player#5060: folds
Player#2111: folds
Player#4825: raises $0.10 to $0.3
warioman: folds
Player#5302: calls $0.20
*** FLOP *** [7h 8h Jd]
Player#5302: checks
Player#4825: bets $0.40
Player#5302: folds
Player#4825: doesn't show hand
Uncalled bet ($0.40) returned to Player#4825
Player#4825 collected $0.62 from pot
*** SUMMARY ***
Total Pot $0.65 | Rake $0.03
Board [7h 8h Jd]
Seat 1: Player#4825 shows [] and won ($0.62) with 
Seat 2: warioman (small blind) folded before the flop
Seat 3: Player#5302 (big blind) folded on the flop
Seat 4: Player#5060 folded before the flop
Seat 5: Player#2111 folded before the flop

PokerStars Hand #4f1171d0-de4e-4857-865c-8060b7718d49:  Hold'em No Limit ($0.05/$0.10 USD) - 2021/11/20 10:52:00 ET
Table 'Aberdeen' 6-max Seat #6 is the button
Seat 1: Player#4021 ($9.80 in chips)
Seat 2: warioman ($19.85 in chips)
Seat 3: Player#3538 ($11.23 in chips)
Seat 4: Player#7876 ($9.63 in chips)
Seat 5: Player#2098 ($6.71 in chips)
Player#4021: posts small blind $0.05
warioman: posts big blind $0.10
*** HOLE CARDS ***
Dealt to warioman [3c 2h]
Player#3538: folds
Player#7876: folds
Player#2098: folds
Player#4021: folds
warioman collected $0.10 from pot
*** SUMMARY ***
Total Pot $0.10 | Rake $0.00
Seat 1: Player#4021 (small blind) folded before the flop
Seat 2: warioman (big blind)
Seat 3: Player#3538 folded before the flop
Seat 4: Player#7876 folded before the flop
Seat 5: Player#2098 folded before the flop

PokerStars Hand #50f2e1bc-e31f-4c9f-a79b-26a966ed1109:  Hold'em No Limit ($0.1/$0.20 USD) - 2021/11/20 10:52:00 ET
Table 'Bethlehem' 6-max Seat #5 is the button
Seat 1: Player#5922 ($29.00 in chips)
Seat 2: Player#9051 ($20.22 in chips)
Seat 3: Player#7574 ($34.38 in chips)
Seat 4: Player#1209 ($31.16 in chips)
Seat 5: Player#8194 ($59.36 in chips)
Seat 6: warioman ($20.00 in chips)
warioman: posts small blind $0.10
Player#5922: posts big blind $0.20
*** HOLE CARDS ***
Dealt to warioman [8h 2d]
Player#9051: folds
Player#7574: calls $0.20
Player#1209: raises0.20 to $1
Player#8194: folds
warioman: folds
Player#5922: folds
Player#7574: calls $0.80
*** FLOP *** [4c 7h Ah]
Player#7574: checks
Player#1209: checks
*** TURN *** [4c 7h Ah] [Qh]
Player#7574: bets $0.55
Player#1209: calls $0.55
*** RIVER *** [4c 7h Ah] [Qh] [Kh]
Player#7574: checks
Player#1209: checks
*** SHOW DOWN *** 
Player#7574 collected $3.23 from pot
*** SUMMARY ***
Total Pot $3.40 | Rake $0.17
Board [4c 7h Ah Qh Kh]
Seat 1: Player#5922 (big blind) folded before the flop
Seat 2: Player#9051 folded before the flop
Seat 3: Player#7574 shows [5c Ad] and won ($3.23) with 
Seat 4: Player#1209 mucked
Seat 5: Player#8194 (button) folded before the flop
Seat 6: warioman (small blind) folded before the flop

PokerStars Hand #b887dd95-207e-405d-81a8-87bf9209267b:  Hold'em No Limit ($0.1/$0.20 USD) - 2021/11/20 10:51:00 ET
Table 'Bel Air' 6-max Seat #6 is the button
Seat 1: Player#7886 ($9.30 in chips)
Seat 2: warioman ($26.15 in chips)
Seat 3: Player#5924 ($14.04 in chips)
Seat 4: Player#3159 ($27.25 in chips)
Player#7886: posts small blind $0.10
warioman: posts big blind $0.20
*** HOLE CARDS ***
Dealt to warioman [Jh Ks]
Player#5924: calls $0.20
Player#3159: raises $0.20 to $0.9
Player#7886: calls $0.80
warioman: folds
Player#5924: calls $0.70
*** FLOP *** [Js 6c Tc]
Player#7886: checks
Player#5924: checks
Player#3159: bets $2.17
Player#7886: folds
Player#5924: calls $2.17
*** TURN *** [Js 6c Tc] [8c]
Player#5924: checks
Player#3159: bets $15.00
Player#5924: calls $10.97
Player#5924 Showing Pocket Cards TK
Player#3159 Showing Pocket Cards 9K
*** RIVER *** [Js 6c Tc] [8c] [8d]
Player#5924 collected $31.71 from pot
*** SUMMARY ***
Total Pot $33.21 | Rake $1.50
Board [Js 6c Tc 8c 8d]
Seat 1: Player#7886 (small blind) folded on the flop
Seat 2: warioman (big blind) folded before the flop
Seat 3: Player#5924 shows [Ts Kc] and won ($31.71) with 
Seat 4: Player#3159 mucked

PokerStars Hand #d0e15139-fc5b-4b82-aaa3-724599686bdc:  Hold'em No Limit ($0.1/$0.20 USD) - 2021/11/20 10:51:00 ET
Table 'Bel Air' 6-max Seat #3 is the button
Seat 1: Player#1380 ($9.20 in chips)
Seat 2: warioman ($26.15 in chips)
Seat 3: Player#9980 ($14.04 in chips)
Seat 4: Player#1874 ($27.35 in chips)
Player#1874: posts small blind $0.10
Player#1380: posts big blind $0.20
*** HOLE CARDS ***
Dealt to warioman [4d 9c]
warioman: folds
Player#9980: folds
Player#1874: folds
Player#1380 collected $0.20 from pot
*** SUMMARY ***
Total Pot $0.20 | Rake $0.00
Seat 1: Player#1380 shows [] and won ($0.20) with 
Seat 2: warioman folded before the flop
Seat 3: Player#9980 (button) folded before the flop
Seat 4: Player#1874 (small blind) folded before the flop

PokerStars Hand #1e380a16-78de-4347-9187-c1f754dc8acf:  Hold'em No Limit ($0.05/$0.10 USD) - 2021/11/20 10:51:00 ET
Table 'Aberdeen' 6-max Seat #6 is the button
Seat 1: Player#9574 ($9.90 in chips)
Seat 2: warioman ($19.85 in chips)
Seat 3: Player#2590 ($11.79 in chips)
Seat 4: Player#0485 ($9.63 in chips)
Seat 5: Player#1767 ($6.11 in chips)
Player#9574: posts small blind $0.05
warioman: posts big blind $0.10
*** HOLE CARDS ***
Dealt to warioman [9h 3d]
warioman: folds
Player#2590: raises $0.10 to $0.3
Player#0485: folds
Player#1767: calls $0.30
Player#9574: folds
*** FLOP *** [4c 4d 7h]
Player#2590: bets $0.26
Player#1767: calls $0.26
*** TURN *** [4c 4d 7h] [Ah]
Player#2590: checks
Player#1767: checks
*** RIVER *** [4c 4d 7h] [Ah] [4h]
Player#2590: checks
Player#1767: bets $1.22
Player#2590: folds
Player#1767: doesn't show hand
Uncalled bet ($1.22) returned to Player#1767
Player#1767 collected $1.16 from pot
*** SUMMARY ***
Total Pot $1.22 | Rake $0.06
Board [4c 4d 7h Ah 4h]
Seat 1: Player#9574 (small blind) folded before the flop
Seat 2: warioman (big blind) folded before the flop
Seat 3: Player#2590 folded on the river
Seat 4: Player#0485 folded before the flop
Seat 5: Player#1767 shows [] and won ($1.16) with 

PokerStars Hand #2ce91524-e275-4037-b631-0d0d90445b09:  Hold'em No Limit ($0.1/$0.20 USD) - 2021/11/20 10:51:00 ET
Table 'Bel Air' 6-max Seat #2 is the button
Seat 1: Player#7707 ($8.92 in chips)
Seat 2: warioman ($26.15 in chips)
Seat 3: Player#2294 ($14.14 in chips)
Seat 4: Player#5772 ($27.55 in chips)
Player#2294: posts small blind $0.10
Player#5772: posts big blind $0.20
*** HOLE CARDS ***
Dealt to warioman [2c Qd]
Player#7707: calls $0.20
warioman: folds
Player#2294: folds
Player#5772: checks
*** FLOP *** [8d 4d Jh]
Player#5772: checks
Player#7707: bets $0.60
Player#5772: folds
Player#7707: doesn't show hand
Uncalled bet ($0.60) returned to Player#7707
Player#7707 collected $0.48 from pot
*** SUMMARY ***
Total Pot $0.50 | Rake $0.03
Board [8d 4d Jh]
Seat 1: Player#7707 shows [] and won ($0.48) with 
Seat 2: warioman (button) folded before the flop
Seat 3: Player#2294 (small blind) folded before the flop
Seat 4: Player#5772 (big blind) folded on the flop

PokerStars Hand #11e83867-9f94-4be4-b5bb-291f2f61f338:  Hold'em No Limit ($0.1/$0.20 USD) - 2021/11/20 10:51:00 ET
Table 'Bethlehem' 6-max Seat #4 is the button
Seat 1: Player#2845 ($29.00 in chips)
Seat 2: Player#5300 ($20.22 in chips)
Seat 3: Player#6352 ($34.38 in chips)
Seat 4: Player#8278 ($30.43 in chips)
Seat 5: Player#3246 ($59.96 in chips)
Seat 6: warioman ($19.10 in chips)
Player#3246: posts small blind $0.10
warioman: posts big blind $0.20
*** HOLE CARDS ***
Dealt to warioman [8c 5h]
Player#2845: folds
Player#5300: folds
Player#6352: folds
Player#8278: raises $0.20 to $0.6
Player#3246: calls $0.50
warioman: folds
*** FLOP *** [Ts Tc Kh]
Player#3246: checks
Player#8278: checks
*** TURN *** [Ts Tc Kh] [Ah]
Player#3246: checks
Player#8278: checks
*** RIVER *** [Ts Tc Kh] [Ah] [4h]
Player#3246: checks
Player#8278: checks
*** SHOW DOWN *** 
Player#8278 collected $1.33 from pot
*** SUMMARY ***
Total Pot $1.40 | Rake $0.07
Board [Ts Tc Kh Ah 4h]
Seat 1: Player#2845 folded before the flop
Seat 2: Player#5300 folded before the flop
Seat 3: Player#6352 folded before the flop
Seat 4: Player#8278 shows [9h 9d] and won ($1.33) with 
Seat 5: Player#3246 (small blind) mucked
Seat 6: warioman (big blind) folded before the flop

PokerStars Hand #ebb02fbe-98e0-4864-b6c1-4a9f77c18f1c:  Hold'em No Limit ($0.05/$0.10 USD) - 2021/11/20 10:51:00 ET
Table 'Aberdeen' 6-max Seat #5 is the button
Seat 1: Player#4935 ($10.00 in chips)
Seat 2: Player#7105 ($9.90 in chips)
Seat 3: warioman ($19.70 in chips)
Seat 4: Player#4478 ($11.79 in chips)
Seat 5: Player#3808 ($9.63 in chips)
Seat 6: Player#7073 ($6.16 in chips)
Player#7073: posts small blind $0.05
Player#4935: posts big blind $0.10
*** HOLE CARDS ***
Dealt to warioman [Qd Kd]
Player#7105: folds
warioman: raises $0.10 to $0.5
Player#4478: folds
Player#3808: folds
Player#7073: folds
Player#4935: folds
warioman: doesn't show hand
Uncalled bet ($0.50) returned to warioman
warioman collected $0.15 from pot
*** SUMMARY ***
Total Pot $0.15 | Rake $0.00
Seat 1: Player#4935 (big blind) folded before the flop
Seat 2: Player#7105 folded before the flop
Seat 3: warioman
Seat 4: Player#4478 folded before the flop
Seat 5: Player#3808 (button) folded before the flop
Seat 6: Player#7073 (small blind) folded before the flop

PokerStars Hand #3a9177d9-79a3-44e6-b7a7-9e53f495cd48:  Hold'em No Limit ($0.1/$0.20 USD) - 2021/11/20 10:51:00 ET
Table 'Bel Air' 6-max Seat #2 is the button
Seat 1: Player#1154 ($8.92 in chips)
Seat 2: Player#1607 ($16.08 in chips)
Seat 3: warioman ($26.25 in chips)
Seat 4: Player#9480 ($14.04 in chips)
Seat 5: Player#7556 ($27.55 in chips)
warioman: posts small blind $0.10
Player#9480: posts big blind $0.20
*** HOLE CARDS ***
Dealt to warioman [7h 3d]
Player#7556: folds
Player#1154: folds
Player#1607: folds
warioman: folds
Player#9480 collected $0.20 from pot
*** SUMMARY ***
Total Pot $0.20 | Rake $0.00
Seat 1: Player#1154 folded before the flop
Seat 2: Player#1607 (button) folded before the flop
Seat 3: warioman (small blind) folded before the flop
Seat 4: Player#9480 shows [] and won ($0.20) with 
Seat 5: Player#7556 folded before the flop

PokerStars Hand #e7b79694-8aee-4d74-b404-dd600c6e2fc1:  Hold'em No Limit ($0.05/$0.10 USD) - 2021/11/20 10:50:00 ET
Table 'Aberdeen' 6-max Seat #3 is the button
Seat 1: Player#4754 ($9.90 in chips)
Seat 2: warioman ($19.70 in chips)
Seat 3: Player#1574 ($11.79 in chips)
Seat 4: Player#3902 ($9.54 in chips)
Seat 5: Player#8686 ($6.26 in chips)
Player#3902: posts small blind $0.05
Player#8686: posts big blind $0.10
*** HOLE CARDS ***
Dealt to warioman [7h 5d]
Player#4754: folds
warioman: folds
Player#1574: folds
Player#3902: calls $0.05
Player#8686: checks
*** FLOP *** [6h 4d Td]
Player#3902: checks
Player#8686: checks
*** TURN *** [6h 4d Td] [2h]
Player#3902: checks
Player#8686: checks
*** RIVER *** [6h 4d Td] [2h] [Ah]
Player#3902: checks
Player#8686: checks
*** SHOW DOWN *** 
Player#3902 collected $0.19 from pot
*** SUMMARY ***
Total Pot $0.20 | Rake $0.01
Board [6h 4d Td 2h Ah]
Seat 1: Player#4754 folded before the flop
Seat 2: warioman folded before the flop
Seat 3: Player#1574 (button) folded before the flop
Seat 4: Player#3902 shows [Kc 5s] and won ($0.19) with 
Seat 5: Player#8686 (big blind) mucked

PokerStars Hand #22b4e630-ac77-4867-a078-50218be4c092:  Hold'em No Limit ($0.1/$0.20 USD) - 2021/11/20 10:50:00 ET
Table 'Bethlehem' 6-max Seat #3 is the button
Seat 1: Player#0668 ($29.00 in chips)
Seat 2: Player#8069 ($20.22 in chips)
Seat 3: Player#4675 ($33.65 in chips)
Seat 4: Player#9001 ($30.53 in chips)
Seat 5: Player#7460 ($60.66 in chips)
Seat 6: warioman ($19.10 in chips)
Player#9001: posts small blind $0.10
Player#7460: posts big blind $0.20
*** HOLE CARDS ***
Dealt to warioman [5h 3s]
warioman: folds
Player#0668: folds
Player#8069: folds
Player#4675: calls $0.20
Player#9001: folds
Player#7460: raises $0.20 to $0.7
Player#4675: calls $0.50
*** FLOP *** [Jh 3h 2h]
Player#7460: checks
Player#4675: bets $0.75
Player#7460: folds
Player#4675: doesn't show hand
Uncalled bet ($0.75) returned to Player#4675
Player#4675 collected $1.43 from pot
*** SUMMARY ***
Total Pot $1.50 | Rake $0.08
Board [Jh 3h 2h]
Seat 1: Player#0668 folded before the flop
Seat 2: Player#8069 folded before the flop
Seat 3: Player#4675 shows [] and won ($1.43) with 
Seat 4: Player#9001 (small blind) folded before the flop
Seat 5: Player#7460 (big blind) folded on the flop
Seat 6: warioman folded before the flop

PokerStars Hand #198f268d-03d5-4e80-997e-fcbfdd3f6322:  Hold'em No Limit ($0.1/$0.20 USD) - 2021/11/20 10:50:00 ET
Table 'Bel Air' 6-max Seat #1 is the button
Seat 1: Player#0407 ($8.82 in chips)
Seat 2: Player#2422 ($16.28 in chips)
Seat 3: warioman ($26.15 in chips)
Seat 4: Player#7177 ($14.24 in chips)
Seat 5: Player#3648 ($27.55 in chips)
Player#2422: posts small blind $0.10
warioman: posts big blind $0.20
*** HOLE CARDS ***
Dealt to warioman [Ac Ks]
Player#7177: calls $0.20
Player#3648: folds
Player#0407: calls $0.20
Player#2422: calls $0.10
warioman: raises $0.20 to $1.8
Player#7177: folds
Player#0407: calls $1.60
Player#2422: folds
*** FLOP *** [8c 6c 7h]
warioman: checks
Player#0407: checks
*** TURN *** [8c 6c 7h] [9c]
warioman: checks
Player#0407: checks
*** RIVER *** [8c 6c 7h] [9c] [Tc]
warioman: checks
Player#0407: checks
*** SHOW DOWN *** 
warioman collected $3.80 from pot
*** SUMMARY ***
Total Pot $4.00 | Rake $0.20
Board [8c 6c 7h 9c Tc]
Seat 1: Player#0407 (button) mucked
Seat 2: Player#2422 (small blind) folded before the flop
Seat 3: warioman (big blind)
Seat 4: Player#7177 folded before the flop
Seat 5: Player#3648 folded before the flop

PokerStars Hand #260fc41c-f8cf-434d-a83c-f50654d71649:  Hold'em No Limit ($0.05/$0.10 USD) - 2021/11/20 10:50:00 ET
Table 'Aberdeen' 6-max Seat #3 is the button
Seat 1: Player#7373 ($10.00 in chips)
Seat 2: Player#5870 ($3.88 in chips)
Seat 3: warioman ($19.70 in chips)
Seat 4: Player#4242 ($11.84 in chips)
Seat 5: Player#8967 ($9.40 in chips)
Seat 6: Player#9749 ($6.26 in chips)
Player#4242: posts small blind $0.05
Player#8967: posts big blind $0.10
*** HOLE CARDS ***
Dealt to warioman [Kd 3s]
Player#9749: folds
Player#7373: folds
Player#5870: calls $0.10
warioman: folds
Player#4242: folds
Player#8967: checks
*** FLOP *** [5c As 9c]
Player#8967: bets $0.30
Player#5870: folds
Player#8967: doesn't show hand
Uncalled bet ($0.30) returned to Player#8967
Player#8967 collected $0.24 from pot
*** SUMMARY ***
Total Pot $0.25 | Rake $0.01
Board [5c As 9c]
Seat 1: Player#7373 folded before the flop
Seat 2: Player#5870 folded on the flop
Seat 3: warioman (button) folded before the flop
Seat 4: Player#4242 (small blind) folded before the flop
Seat 5: Player#8967 shows [] and won ($0.24) with 
Seat 6: Player#9749 folded before the flop

PokerStars Hand #78097a8e-3b0d-45ce-bf6f-a87787e3b03c:  Hold'em No Limit ($0.1/$0.20 USD) - 2021/11/20 10:49:00 ET
Table 'Bethlehem' 6-max Seat #2 is the button
Seat 1: Player#1991 ($29.00 in chips)
Seat 2: Player#6100 ($20.22 in chips)
Seat 3: Player#8610 ($31.79 in chips)
Seat 4: Player#6048 ($30.73 in chips)
Seat 5: Player#6867 ($61.46 in chips)
Seat 6: warioman ($19.10 in chips)
Player#8610: posts small blind $0.10
Player#6048: posts big blind $0.20
*** HOLE CARDS ***
Dealt to warioman [5h Kc]
System Bonus Pot Event 1
Player#6867: calls $0.20
warioman: folds
Player#1991: folds
Player#6100: folds
Player#8610: raises $0.20 to $0.8
Player#6048: folds
Player#6867: calls $0.60
*** FLOP *** [8d 8c 4h]
Player#8610: bets $2.10
Player#6867: folds
Player#8610: doesn't show hand
Uncalled bet ($2.10) returned to Player#8610
Player#8610 collected $1.71 from pot
*** SUMMARY ***
Total Pot $1.80 | Rake $0.09
Board [8d 8c 4h]
Seat 1: Player#1991 folded before the flop
Seat 2: Player#6100 (button) folded before the flop
Seat 3: Player#8610 shows [] and won ($1.71) with 
Seat 4: Player#6048 (big blind) folded before the flop
Seat 5: Player#6867 folded on the flop
Seat 6: warioman folded before the flop

PokerStars Hand #2dcbd91c-396e-4663-91d7-d4300babc3c7:  Hold'em No Limit ($0.1/$0.20 USD) - 2021/11/20 10:49:00 ET
Table 'Bel Air' 6-max Seat #6 is the button
Seat 1: Player#1012 ($8.92 in chips)
Seat 2: Player#3743 ($17.83 in chips)
Seat 3: warioman ($26.15 in chips)
Seat 4: Player#8287 ($15.14 in chips)
Seat 5: Player#6178 ($24.53 in chips)
Player#1012: posts small blind $0.10
Player#3743: posts big blind $0.20
*** HOLE CARDS ***
Dealt to warioman [6h 2d]
warioman: folds
Player#8287: calls $0.20
Player#6178: raises $0.20 to $0.9
Player#1012: folds
Player#3743: calls $0.70
Player#8287: calls $0.70
*** FLOP *** [Ac 6c Th]
Player#3743: checks
Player#8287: checks
Player#6178: checks
*** TURN *** [Ac 6c Th] [2c]
Player#3743: bets $1.40
Player#8287: folds
Player#6178: calls $1.40
*** RIVER *** [Ac 6c Th] [2c] [Jc]
Player#3743: checks
Player#6178: checks
*** SHOW DOWN *** 
Player#6178 collected $5.32 from pot
*** SUMMARY ***
Total Pot $5.60 | Rake $0.28
Board [Ac 6c Th 2c Jc]
Seat 1: Player#1012 (small blind) folded before the flop
Seat 2: Player#3743 (big blind) mucked
Seat 3: warioman folded before the flop
Seat 4: Player#8287 folded on the turn
Seat 5: Player#6178 shows [As 2s] and won ($5.32) with 

PokerStars Hand #3d44a6b9-b672-4d47-be5d-60a4e3400a5e:  Hold'em No Limit ($0.1/$0.20 USD) - 2021/11/20 10:48:00 ET
Table 'Bethlehem' 6-max Seat #1 is the button
Seat 1: Player#7096 ($29.60 in chips)
Seat 2: Player#5028 ($20.32 in chips)
Seat 3: Player#6105 ($31.99 in chips)
Seat 4: Player#2636 ($35.98 in chips)
Seat 5: Player#0014 ($54.93 in chips)
Seat 6: warioman ($19.10 in chips)
Player#5028: posts small blind $0.10
Player#6105: posts big blind $0.20
*** HOLE CARDS ***
Dealt to warioman [Td 3h]
System Bonus Pot Event 1
Player#2636: raises $0.20 to $0.6
Player#0014: calls $0.60
warioman: folds
Player#7096: calls $0.60
Player#5028: folds
Player#6105: folds
*** FLOP *** [2h 7s 7h]
Player#2636: checks
Player#0014: bets $1.55
Player#7096: folds
Player#2636: calls $1.55
*** TURN *** [2h 7s 7h] [Ah]
Player#2636: checks
Player#0014: bets $3.10
Player#2636: calls $3.10
*** RIVER *** [2h 7s 7h] [Ah] [6h]
Player#2636: checks
Player#0014: checks
*** SHOW DOWN *** 
Player#0014 collected $10.83 from pot
*** SUMMARY ***
Total Pot $11.40 | Rake $0.57
Board [2h 7s 7h Ah 6h]
Seat 1: Player#7096 (button) folded on the flop
Seat 2: Player#5028 (small blind) folded before the flop
Seat 3: Player#6105 (big blind) folded before the flop
Seat 4: Player#2636 mucked
Seat 5: Player#0014 shows [4c 7c] and won ($10.83) with 
Seat 6: warioman folded before the flop

PokerStars Hand #6696aa83-c228-4b4f-9f07-bce1bdae02f6:  Hold'em No Limit ($0.05/$0.10 USD) - 2021/11/20 10:48:00 ET
Table 'Aberdeen' 6-max Seat #2 is the button
Seat 1: Player#7872 ($9.85 in chips)
Seat 2: Player#8634 ($9.70 in chips)
Seat 3: warioman ($14.27 in chips)
Seat 4: Player#7243 ($11.94 in chips)
Seat 5: Player#4761 ($9.40 in chips)
Seat 6: Player#5373 ($6.36 in chips)
warioman: posts small blind $0.05
Player#7243: posts big blind $0.10
*** HOLE CARDS ***
Dealt to warioman [Th Qh]
Player#4761: folds
Player#5373: calls $0.10
Player#7872: folds
Player#8634: raises $0.10 to $0.4
warioman: raises $0.40 to $1.5
Player#7243: folds
Player#5373: folds
Player#8634: calls $1.10
*** FLOP *** [9d 3s 7c]
warioman: bets $1.36
Player#8634: calls $1.36
*** TURN *** [9d 3s 7c] [Tc]
warioman: checks
Player#8634: bets $2.96
warioman: calls $2.96
*** RIVER *** [9d 3s 7c] [Tc] [2c]
warioman: checks
Player#8634: checks
*** SHOW DOWN *** 
warioman collected $11.25 from pot
*** SUMMARY ***
Total Pot $11.84 | Rake $0.59
Board [9d 3s 7c Tc 2c]
Seat 1: Player#7872 folded before the flop
Seat 2: Player#8634 (button) mucked
Seat 3: warioman (small blind)
Seat 4: Player#7243 (big blind) folded before the flop
Seat 5: Player#4761 folded before the flop
Seat 6: Player#5373 folded before the flop

PokerStars Hand #3a2509ba-2ad5-4b47-a5a0-a35a525844e2:  Hold'em No Limit ($0.1/$0.20 USD) - 2021/11/20 10:48:00 ET
Table 'Bel Air' 6-max Seat #4 is the button
Seat 1: Player#6731 ($9.12 in chips)
Seat 2: Player#8150 ($19.48 in chips)
Seat 3: warioman ($26.15 in chips)
Seat 4: Player#4330 ($13.37 in chips)
Seat 5: Player#3922 ($24.63 in chips)
Player#3922: posts small blind $0.10
Player#6731: posts big blind $0.20
*** HOLE CARDS ***
Dealt to warioman [Ks Td]
Player#8150: raises $0.20 to $0.4
warioman: folds
Player#4330: calls $0.40
Player#3922: folds
Player#6731: folds
*** FLOP *** [9c 8h 4s]
Player#8150: checks
Player#4330: bets $0.35
Player#8150: calls $0.35
*** TURN *** [9c 8h 4s] [4d]
Player#8150: checks
Player#4330: bets $0.90
Player#8150: calls $0.90
*** RIVER *** [9c 8h 4s] [4d] [3d]
Player#8150: checks
Player#4330: checks
*** SHOW DOWN *** 
Player#4330 collected $3.42 from pot
*** SUMMARY ***
Total Pot $3.60 | Rake $0.18
Board [9c 8h 4s 4d 3d]
Seat 1: Player#6731 (big blind) folded before the flop
Seat 2: Player#8150 mucked
Seat 3: warioman folded before the flop
Seat 4: Player#4330 shows [2h As] and won ($3.42) with 
Seat 5: Player#3922 (small blind) folded before the flop

PokerStars Hand #43aeb1c3-dcf9-463a-821c-df012e2dc4f3:  Hold'em No Limit ($0.1/$0.20 USD) - 2021/11/20 10:48:00 ET
Table 'Bel Air' 6-max Seat #3 is the button
Seat 1: Player#6731 ($9.12 in chips)
Seat 2: Player#5640 ($19.20 in chips)
Seat 3: warioman ($26.15 in chips)
Seat 4: Player#9863 ($13.47 in chips)
Seat 5: Player#0869 ($24.83 in chips)
Player#9863: posts small blind $0.10
Player#0869: posts big blind $0.20
*** HOLE CARDS ***
Dealt to warioman [6c 2c]
Player#6731: folds
Player#5640: calls $0.20
warioman: folds
Player#9863: folds
Player#0869: checks
*** FLOP *** [8s 3c Js]
Player#0869: checks
Player#5640: bets $0.20
Player#0869: folds
Player#5640: doesn't show hand
Uncalled bet ($0.20) returned to Player#5640
Player#5640 collected $0.47 from pot
*** SUMMARY ***
Total Pot $0.50 | Rake $0.02
Board [8s 3c Js]
Seat 1: Player#6731 folded before the flop
Seat 2: Player#5640 shows [] and won ($0.47) with 
Seat 3: warioman (button) folded before the flop
Seat 4: Player#9863 (small blind) folded before the flop
Seat 5: Player#0869 (big blind) folded on the flop

PokerStars Hand #57f62761-46f0-42ab-ad02-5ddebeca394b:  Hold'em No Limit ($0.05/$0.10 USD) - 2021/11/20 10:48:00 ET
Table 'Aberdeen' 6-max Seat #1 is the button
Seat 1: Player#0935 ($9.85 in chips)
Seat 2: Player#3456 ($9.75 in chips)
Seat 3: warioman ($14.37 in chips)
Seat 4: Player#7834 ($11.94 in chips)
Seat 5: Player#6206 ($9.40 in chips)
Seat 6: Player#6395 ($6.22 in chips)
Player#3456: posts small blind $0.05
warioman: posts big blind $0.10
*** HOLE CARDS ***
Dealt to warioman [5c 9c]
Player#7834: folds
Player#6206: folds
Player#6395: calls $0.10
Player#0935: folds
Player#3456: folds
warioman: checks
*** FLOP *** [Th 7h 5d]
warioman: checks
Player#6395: bets $0.20
warioman: folds
Player#6395: doesn't show hand
Uncalled bet ($0.20) returned to Player#6395
Player#6395 collected $0.24 from pot
*** SUMMARY ***
Total Pot $0.25 | Rake $0.01
Board [Th 7h 5d]
Seat 1: Player#0935 (button) folded before the flop
Seat 2: Player#3456 (small blind) folded before the flop
Seat 3: warioman (big blind) folded on the flop
Seat 4: Player#7834 folded before the flop
Seat 5: Player#6206 folded before the flop
Seat 6: Player#6395 shows [] and won ($0.24) with 

PokerStars Hand #b2bb6cf6-e1b1-4b25-804c-da138366128d:  Hold'em No Limit ($0.1/$0.20 USD) - 2021/11/20 10:47:00 ET
Table 'Bel Air' 6-max Seat #2 is the button
Seat 1: Player#6817 ($9.12 in chips)
Seat 2: Player#8585 ($20.80 in chips)
Seat 3: warioman ($24.52 in chips)
Seat 4: Player#4742 ($13.67 in chips)
Seat 5: Player#6949 ($24.83 in chips)
warioman: posts small blind $0.10
Player#4742: posts big blind $0.20
*** HOLE CARDS ***
Dealt to warioman [Ac Kc]
Player#6949: folds
Player#6817: folds
Player#8585: raises $0.20 to $0.4
warioman: raises $0.40 to $1.6
Player#4742: folds
Player#8585: calls $1.20
*** FLOP *** [7h 5d Qs]
warioman: bets $1.42
Player#8585: folds
warioman: doesn't show hand
Uncalled bet ($1.42) returned to warioman
warioman collected $3.23 from pot
*** SUMMARY ***
Total Pot $3.40 | Rake $0.17
Board [7h 5d Qs]
Seat 1: Player#6817 folded before the flop
Seat 2: Player#8585 (button) folded on the flop
Seat 3: warioman (small blind)
Seat 4: Player#4742 (big blind) folded before the flop
Seat 5: Player#6949 folded before the flop

PokerStars Hand #886bfa10-f6bc-4f43-8021-38b911be9abd:  Hold'em No Limit ($0.1/$0.20 USD) - 2021/11/20 10:47:00 ET
Table 'Bethlehem' 6-max Seat #6 is the button
Seat 1: Player#8425 ($29.70 in chips)
Seat 2: Player#4717 ($21.22 in chips)
Seat 3: Player#5422 ($31.99 in chips)
Seat 4: Player#7522 ($35.98 in chips)
Seat 5: Player#3934 ($53.17 in chips)
Seat 6: warioman ($20.00 in chips)
Player#8425: posts small blind $0.10
Player#4717: posts big blind $0.20
*** HOLE CARDS ***
Dealt to warioman [Qd Tc]
Player#5422: folds
Player#7522: folds
Player#3934: calls $0.20
warioman: raises $0.20 to $0.9
Player#8425: folds
Player#4717: calls $0.70
Player#3934: calls $0.70
*** FLOP *** [3c 7h 6c]
Player#4717: checks
Player#3934: checks
warioman: checks
*** TURN *** [3c 7h 6c] [7d]
Player#4717: checks
Player#3934: bets $1.20
warioman: folds
Player#4717: folds
Player#8425: doesn't show hand
Player#4717: doesn't show hand
Player#5422: doesn't show hand
Player#7522: doesn't show hand
Player#3934: doesn't show hand
warioman: doesn't show hand
Uncalled bet ($1.20) returned to Player#3934
Player#3934 collected $2.66 from pot
*** SUMMARY ***
Total Pot $2.80 | Rake $0.14
Board [3c 7h 6c 7d]
Seat 1: Player#8425 (small blind) folded before the flop
Seat 2: Player#4717 (big blind) folded on the turn
Seat 3: Player#5422 folded before the flop
Seat 4: Player#7522 folded before the flop
Seat 5: Player#3934 shows [] and won ($2.66) with 
Seat 6: warioman (button) folded on the turn

PokerStars Hand #264e748e-ae0b-445a-a039-e671b9783704:  Hold'em No Limit ($0.05/$0.10 USD) - 2021/11/20 10:47:00 ET
Table 'Aberdeen' 6-max Seat #6 is the button
Seat 1: Player#3985 ($9.90 in chips)
Seat 2: Player#1132 ($9.85 in chips)
Seat 3: warioman ($13.95 in chips)
Seat 4: Player#7655 ($11.94 in chips)
Seat 5: Player#7940 ($9.70 in chips)
Seat 6: Player#9753 ($6.22 in chips)
Player#3985: posts small blind $0.05
Player#1132: posts big blind $0.10
*** HOLE CARDS ***
Dealt to warioman [Ad Kc]
warioman: raises $0.10 to $0.3
Player#7655: folds
Player#7940: calls $0.30
Player#9753: folds
Player#3985: folds
Player#1132: folds
*** FLOP *** [Ks Td 2s]
warioman: bets $0.22
Player#7940: folds
warioman: doesn't show hand
Uncalled bet ($0.22) returned to warioman
warioman collected $0.71 from pot
*** SUMMARY ***
Total Pot $0.75 | Rake $0.04
Board [Ks Td 2s]
Seat 1: Player#3985 (small blind) folded before the flop
Seat 2: Player#1132 (big blind) folded before the flop
Seat 3: warioman
Seat 4: Player#7655 folded before the flop
Seat 5: Player#7940 folded on the flop
Seat 6: Player#9753 (button) folded before the flop

PokerStars Hand #e23fb2b2-6cfe-4a05-af1d-400fa56f41f0:  Hold'em No Limit ($0.1/$0.20 USD) - 2021/11/20 10:47:00 ET
Table 'Bethlehem' 6-max Seat #5 is the button
Seat 1: Player#9104 ($29.90 in chips)
Seat 2: Player#3742 ($21.22 in chips)
Seat 3: Player#4012 ($31.99 in chips)
Seat 4: Player#3484 ($35.68 in chips)
Seat 5: Player#4709 ($53.17 in chips)
Seat 6: warioman ($19.00 in chips)
warioman: posts small blind $0.10
Player#9104: posts big blind $0.20
*** HOLE CARDS ***
Dealt to warioman [Ts Ah]
Player#3742: folds
Player#4012: folds
Player#3484: raises $0.20 to $0.6
Player#4709: folds
warioman: folds
Player#9104: folds
Player#9104: doesn't show hand
Player#3742: doesn't show hand
Player#4012: doesn't show hand
Player#3484: doesn't show hand
Player#4709: doesn't show hand
warioman: doesn't show hand
Uncalled bet ($0.60) returned to Player#3484
Player#3484 collected $0.30 from pot
*** SUMMARY ***
Total Pot $0.30 | Rake $0.00
Seat 1: Player#9104 (big blind) folded before the flop
Seat 2: Player#3742 folded before the flop
Seat 3: Player#4012 folded before the flop
Seat 4: Player#3484 shows [] and won ($0.30) with 
Seat 5: Player#4709 (button) folded before the flop
Seat 6: warioman (small blind) folded before the flop

PokerStars Hand #16437917-069a-4d57-8e4f-1489d23883cb:  Hold'em No Limit ($0.05/$0.10 USD) - 2021/11/20 10:47:00 ET
Table 'Aberdeen' 6-max Seat #5 is the button
Seat 1: Player#0859 ($10.00 in chips)
Seat 2: Player#0903 ($9.85 in chips)
Seat 3: warioman ($13.95 in chips)
Seat 4: Player#8960 ($12.24 in chips)
Seat 5: Player#2564 ($9.70 in chips)
Seat 6: Player#3850 ($5.85 in chips)
Player#3850: posts small blind $0.05
Player#0859: posts big blind $0.10
*** HOLE CARDS ***
Dealt to warioman [7h Ts]
Player#0903: folds
warioman: folds
Player#8960: raises $0.10 to $0.3
Player#2564: folds
Player#3850: calls $0.25
Player#0859: folds
*** FLOP *** [9c Kd Th]
Player#3850: checks
Player#8960: checks
*** TURN *** [9c Kd Th] [4d]
Player#3850: bets $0.30
Player#8960: folds
Player#3850: doesn't show hand
Uncalled bet ($0.30) returned to Player#3850
Player#3850 collected $0.66 from pot
*** SUMMARY ***
Total Pot $0.70 | Rake $0.03
Board [9c Kd Th 4d]
Seat 1: Player#0859 (big blind) folded before the flop
Seat 2: Player#0903 folded before the flop
Seat 3: warioman folded before the flop
Seat 4: Player#8960 folded on the turn
Seat 5: Player#2564 (button) folded before the flop
Seat 6: Player#3850 shows [] and won ($0.66) with 

PokerStars Hand #af4f895d-5fd1-4aef-b7dc-7ca3a27b0667:  Hold'em No Limit ($0.1/$0.20 USD) - 2021/11/20 10:46:00 ET
Table 'Bel Air' 6-max Seat #1 is the button
Seat 1: Player#5624 ($8.29 in chips)
Seat 2: Player#2017 ($20.90 in chips)
Seat 3: warioman ($24.72 in chips)
Seat 4: Player#2210 ($13.67 in chips)
Seat 5: Player#4551 ($14.68 in chips)
Seat 6: Player#9799 ($24.83 in chips)
Player#2017: posts small blind $0.10
warioman: posts big blind $0.20
*** HOLE CARDS ***
Dealt to warioman [9d 4c]
Player#2210: folds
Player#4551: raises $0.20 to $0.4
Player#9799: folds
Player#5624: calls $0.40
Player#2017: folds
warioman: folds
*** FLOP *** [9c 9s Kc]
Player#4551: bets $0.20
Player#5624: raises $0.20 to $1.7
Player#4551: folds
Player#5624: doesn't show hand
Uncalled bet ($1.70) returned to Player#5624
Player#5624 collected $1.24 from pot
*** SUMMARY ***
Total Pot $1.30 | Rake $0.07
Board [9c 9s Kc]
Seat 1: Player#5624 shows [] and won ($1.24) with 
Seat 2: Player#2017 (small blind) folded before the flop
Seat 3: warioman (big blind) folded before the flop
Seat 4: Player#2210 folded before the flop
Seat 5: Player#4551 folded on the flop
Seat 6: Player#9799 folded before the flop

PokerStars Hand #eeaad0f2-06a1-4115-8c95-16a696554ad2:  Hold'em No Limit ($0.1/$0.20 USD) - 2021/11/20 10:46:00 ET
Table 'Bethlehem' 6-max Seat #4 is the button
Seat 1: Player#8221 ($29.90 in chips)
Seat 2: Player#4921 ($21.22 in chips)
Seat 3: Player#5082 ($31.26 in chips)
Seat 4: Player#8993 ($35.68 in chips)
Seat 5: Player#9855 ($53.77 in chips)
Seat 6: warioman ($19.20 in chips)
Player#9855: posts small blind $0.10
warioman: posts big blind $0.20
*** HOLE CARDS ***
Dealt to warioman [Qs 7c]
Player#5082 Entry Bet 0.2
Player#8221: folds
Player#4921: folds
Player#5082: checks
Player#8993: folds
Player#9855: calls $0.10
warioman: checks
*** FLOP *** [6d 6c 4d]
Player#9855: bets $0.40
warioman: folds
Player#5082: calls $0.40
*** TURN *** [6d 6c 4d] [6h]
Player#9855: checks
Player#5082: bets $0.80
Player#9855: folds
Player#5082: doesn't show hand
Uncalled bet ($0.80) returned to Player#5082
Player#5082 collected $1.14 from pot
*** SUMMARY ***
Total Pot $1.20 | Rake $0.06
Board [6d 6c 4d 6h]
Seat 1: Player#8221 folded before the flop
Seat 2: Player#4921 folded before the flop
Seat 3: Player#5082 shows [] and won ($1.14) with 
Seat 4: Player#8993 (button) folded before the flop
Seat 5: Player#9855 (small blind) folded on the turn
Seat 6: warioman (big blind) folded on the flop

PokerStars Hand #ecb1f2fd-e78b-4c80-a575-bacb817c2e7e:  Hold'em No Limit ($0.1/$0.20 USD) - 2021/11/20 10:46:00 ET
Table 'Bethlehem' 6-max Seat #3 is the button
Seat 1: Player#8249 ($29.90 in chips)
Seat 2: Player#3625 ($21.22 in chips)
Seat 3: Player#5847 ($31.26 in chips)
Seat 4: Player#6448 ($35.78 in chips)
Seat 5: Player#7005 ($53.67 in chips)
Seat 6: warioman ($19.20 in chips)
Player#6448: posts small blind $0.10
Player#7005: posts big blind $0.20
*** HOLE CARDS ***
Dealt to warioman [9s Kc]
warioman: folds
Player#8249: folds
Player#3625: folds
Player#6448: folds
Player#7005 collected $0.20 from pot
*** SUMMARY ***
Total Pot $0.20 | Rake $0.00
Seat 1: Player#8249 folded before the flop
Seat 2: Player#3625 folded before the flop
Seat 3: Player#5847 (button) mucked
Seat 4: Player#6448 (small blind) folded before the flop
Seat 5: Player#7005 shows [] and won ($0.20) with 
Seat 6: warioman folded before the flop

PokerStars Hand #0fea2eae-d792-441b-bf9c-dd5140d7a974:  Hold'em No Limit ($0.05/$0.10 USD) - 2021/11/20 10:46:00 ET
Table 'Aberdeen' 6-max Seat #4 is the button
Seat 1: Player#9178 ($10.00 in chips)
Seat 2: Player#2600 ($9.85 in chips)
Seat 3: warioman ($13.95 in chips)
Seat 4: Player#4971 ($12.54 in chips)
Seat 5: Player#1563 ($9.14 in chips)
Seat 6: Player#6738 ($6.15 in chips)
Player#1563: posts small blind $0.05
Player#6738: posts big blind $0.10
*** HOLE CARDS ***
Dealt to warioman [9h As]
Player#9178: folds
Player#2600: folds
warioman: folds
Player#4971: raises $0.10 to $0.3
Player#1563: calls $0.25
Player#6738: calls $0.20
*** FLOP *** [Ts 2h 7s]
Player#1563: checks
Player#6738: checks
Player#4971: checks
*** TURN *** [Ts 2h 7s] [Ks]
Player#1563: bets $0.40
Player#6738: folds
Player#4971: folds
Player#1563: doesn't show hand
Uncalled bet ($0.40) returned to Player#1563
Player#1563 collected $0.85 from pot
*** SUMMARY ***
Total Pot $0.90 | Rake $0.05
Board [Ts 2h 7s Ks]
Seat 1: Player#9178 folded before the flop
Seat 2: Player#2600 folded before the flop
Seat 3: warioman folded before the flop
Seat 4: Player#4971 (button) folded on the turn
Seat 5: Player#1563 shows [] and won ($0.85) with 
Seat 6: Player#6738 (big blind) folded on the turn

PokerStars Hand #33104a5b-9eac-4dd5-8283-3efd4d4a2bdb:  Hold'em No Limit ($0.05/$0.10 USD) - 2021/11/20 10:46:00 ET
Table 'Aberdeen' 6-max Seat #3 is the button
Seat 1: Player#3895 ($10.00 in chips)
Seat 2: Player#9199 ($9.85 in chips)
Seat 3: warioman ($13.95 in chips)
Seat 4: Player#5277 ($12.59 in chips)
Seat 5: Player#7814 ($9.09 in chips)
Seat 6: Player#8315 ($6.15 in chips)
Player#5277: posts small blind $0.05
Player#7814: posts big blind $0.10
*** HOLE CARDS ***
Dealt to warioman [9c Js]
Player#8315: folds
Player#3895: folds
Player#9199: folds
warioman: folds
Player#5277: folds
Player#7814 collected $0.10 from pot
*** SUMMARY ***
Total Pot $0.10 | Rake $0.00
Seat 1: Player#3895 folded before the flop
Seat 2: Player#9199 folded before the flop
Seat 3: warioman (button) folded before the flop
Seat 4: Player#5277 (small blind) folded before the flop
Seat 5: Player#7814 shows [] and won ($0.10) with 
Seat 6: Player#8315 folded before the flop

PokerStars Hand #725f0657-7d4b-487b-a79e-2cf754e55798:  Hold'em No Limit ($0.1/$0.20 USD) - 2021/11/20 10:45:00 ET
Table 'Bel Air' 6-max Seat #6 is the button
Seat 1: Player#5194 ($9.29 in chips)
Seat 2: Player#5342 ($20.00 in chips)
Seat 3: warioman ($24.72 in chips)
Seat 4: Player#8845 ($13.67 in chips)
Seat 5: Player#2211 ($14.68 in chips)
Seat 6: Player#0690 ($24.83 in chips)
Player#5194: posts small blind $0.10
Player#5342: posts big blind $0.20
*** HOLE CARDS ***
Dealt to warioman [2s Ac]
warioman: folds
Player#8845: folds
Player#2211: folds
Player#0690: folds
Player#5194: calls $0.10
Player#5342: raises $0.20 to $0.6
Player#5194: calls $0.40
*** FLOP *** [5s Jd 7d]
Player#5194: checks
Player#5342: checks
*** TURN *** [5s Jd 7d] [6c]
Player#5194: bets $0.40
Player#5342: calls $0.40
*** RIVER *** [5s Jd 7d] [6c] [5c]
Player#5194: checks
Player#5342: checks
*** SHOW DOWN *** 
Player#5342 collected $1.90 from pot
*** SUMMARY ***
Total Pot $2.00 | Rake $0.10
Board [5s Jd 7d 6c 5c]
Seat 1: Player#5194 (small blind) mucked
Seat 2: Player#5342 shows [Kh 6h] and won ($1.90) with 
Seat 3: warioman folded before the flop
Seat 4: Player#8845 folded before the flop
Seat 5: Player#2211 folded before the flop
Seat 6: Player#0690 (button) folded before the flop

PokerStars Hand #16b045b4-fe1c-4941-acdc-a5913a57e6a1:  Hold'em No Limit ($0.05/$0.10 USD) - 2021/11/20 10:45:00 ET
Table 'Aberdeen' 6-max Seat #2 is the button
Seat 1: Player#4914 ($7.26 in chips)
Seat 2: Player#2206 ($9.85 in chips)
Seat 3: warioman ($14.00 in chips)
Seat 4: Player#1832 ($12.54 in chips)
Seat 5: Player#9947 ($9.09 in chips)
Seat 6: Player#1967 ($6.15 in chips)
warioman: posts small blind $0.05
Player#1832: posts big blind $0.10
*** HOLE CARDS ***
Dealt to warioman [9h 2d]
Player#9947: folds
Player#1967: folds
Player#4914: folds
Player#2206: folds
warioman: folds
Player#1832 collected $0.10 from pot
*** SUMMARY ***
Total Pot $0.10 | Rake $0.00
Seat 1: Player#4914 folded before the flop
Seat 2: Player#2206 (button) folded before the flop
Seat 3: warioman (small blind) folded before the flop
Seat 4: Player#1832 shows [] and won ($0.10) with 
Seat 5: Player#9947 folded before the flop
Seat 6: Player#1967 folded before the flop

PokerStars Hand #e680f4b2-3386-40ba-829c-cb7a701bd42d:  Hold'em No Limit ($0.1/$0.20 USD) - 2021/11/20 10:45:00 ET
Table 'Bethlehem' 6-max Seat #1 is the button
Seat 1: Player#4970 ($30.80 in chips)
Seat 2: Player#5390 ($21.32 in chips)
Seat 3: Player#2994 ($35.98 in chips)
Seat 4: Player#8569 ($52.57 in chips)
Seat 5: warioman ($19.20 in chips)
Player#5390: posts small blind $0.10
Player#2994: posts big blind $0.20
*** HOLE CARDS ***
Dealt to warioman [Jd Qs]
Player#8569: calls $0.20
warioman: folds
Player#4970: raises $0.20 to $0.9
Player#5390: folds
Player#2994: folds
Player#8569: calls $0.70
*** FLOP *** [7h Kc Qd]
Player#8569: checks
Player#4970: checks
*** TURN *** [7h Kc Qd] [Ts]
Player#8569: checks
Player#4970: checks
*** RIVER *** [7h Kc Qd] [Ts] [Ks]
Player#8569: checks
Player#4970: checks
*** SHOW DOWN *** 
Player#8569 collected $1.99 from pot
*** SUMMARY ***
Total Pot $2.10 | Rake $0.10
Board [7h Kc Qd Ts Ks]
Seat 1: Player#4970 (button) mucked
Seat 2: Player#5390 (small blind) folded before the flop
Seat 3: Player#2994 (big blind) folded before the flop
Seat 4: Player#8569 shows [8c 8s] and won ($1.99) with 
Seat 5: warioman folded before the flop

PokerStars Hand #9dc7d7b4-41a3-411e-8342-9a6b7dfd72e9:  Hold'em No Limit ($0.1/$0.20 USD) - 2021/11/20 10:45:00 ET
Table 'Bel Air' 6-max Seat #5 is the button
Seat 1: Player#5187 ($9.49 in chips)
Seat 2: Player#1577 ($20.00 in chips)
Seat 3: warioman ($23.43 in chips)
Seat 4: Player#9417 ($13.67 in chips)
Seat 5: Player#4268 ($15.58 in chips)
Seat 6: Player#9864 ($24.93 in chips)
Player#9864: posts small blind $0.10
Player#5187: posts big blind $0.20
*** HOLE CARDS ***
Dealt to warioman [Ks Qc]
Player#1577: calls $0.20
warioman: raises $0.20 to $0.9
Player#9417: folds
Player#4268: calls $0.90
Player#9864: folds
Player#5187: folds
Player#1577: folds
*** FLOP *** [Js Qh Qd]
warioman: bets $0.69
Player#4268: folds
warioman: doesn't show hand
Uncalled bet ($0.69) returned to warioman
warioman collected $2.19 from pot
*** SUMMARY ***
Total Pot $2.30 | Rake $0.12
Board [Js Qh Qd]
Seat 1: Player#5187 (big blind) folded before the flop
Seat 2: Player#1577 folded before the flop
Seat 3: warioman
Seat 4: Player#9417 folded before the flop
Seat 5: Player#4268 (button) folded on the flop
Seat 6: Player#9864 (small blind) folded before the flop

PokerStars Hand #b9f54d2f-de5b-44ed-a8b4-77c0997a7392:  Hold'em No Limit ($0.05/$0.10 USD) - 2021/11/20 10:44:00 ET
Table 'Aberdeen' 6-max Seat #1 is the button
Seat 1: Player#9373 ($10.27 in chips)
Seat 2: Player#9694 ($9.90 in chips)
Seat 3: warioman ($14.10 in chips)
Seat 4: Player#5458 ($12.84 in chips)
Seat 5: Player#0670 ($9.09 in chips)
Seat 6: Player#2893 ($3.01 in chips)
Player#9694: posts small blind $0.05
warioman: posts big blind $0.10
*** HOLE CARDS ***
Dealt to warioman [3d Ah]
Player#5458: raises $0.10 to $0.3
Player#0670: folds
Player#2893: calls $0.30
Player#9373: calls $0.30
Player#9694: folds
warioman: folds
*** FLOP *** [Kc Td 8s]
Player#5458: checks
Player#2893: checks
Player#9373: bets $0.79
Player#5458: folds
Player#2893: calls $0.79
*** TURN *** [Kc Td 8s] [Qd]
Player#2893: checks
Player#9373: bets $1.92
Player#2893: calls $1.92
Player#2893 Showing Pocket Cards TT
Player#9373 Showing Pocket Cards KQ
*** RIVER *** [Kc Td 8s] [Qd] [4c]
Player#2893 collected $6.15 from pot
*** SUMMARY ***
Total Pot $6.47 | Rake $0.32
Board [Kc Td 8s Qd 4c]
Seat 1: Player#9373 (button) mucked
Seat 2: Player#9694 (small blind) folded before the flop
Seat 3: warioman (big blind) folded before the flop
Seat 4: Player#5458 folded on the flop
Seat 5: Player#0670 folded before the flop
Seat 6: Player#2893 shows [Th Ts] and won ($6.15) with 

PokerStars Hand #773eab26-2bb7-4a0d-8211-0cb913a46fe2:  Hold'em No Limit ($0.1/$0.20 USD) - 2021/11/20 10:44:00 ET
Table 'Bethlehem' 6-max Seat #6 is the button
Seat 1: Player#6266 ($30.90 in chips)
Seat 2: Player#7188 ($20.59 in chips)
Seat 3: Player#4188 ($35.98 in chips)
Seat 4: Player#0053 ($53.27 in chips)
Seat 5: warioman ($19.20 in chips)
Player#6266: posts small blind $0.10
Player#7188: posts big blind $0.20
*** HOLE CARDS ***
Dealt to warioman [3s Kd]
Player#4188: folds
Player#0053: raises $0.20 to $0.7
warioman: folds
Player#6266: folds
Player#7188: calls $0.50
*** FLOP *** [6c Kc 5c]
Player#7188: checks
Player#0053: checks
*** TURN *** [6c Kc 5c] [Tc]
Player#7188: checks
Player#0053: checks
*** RIVER *** [6c Kc 5c] [Tc] [8c]
Player#7188: checks
Player#0053: checks
*** SHOW DOWN *** 
Player#7188 collected $1.43 from pot
*** SUMMARY ***
Total Pot $1.50 | Rake $0.08
Board [6c Kc 5c Tc 8c]
Seat 1: Player#6266 (small blind) folded before the flop
Seat 2: Player#7188 shows [2d 2h] and won ($1.43) with 
Seat 3: Player#4188 folded before the flop
Seat 4: Player#0053 mucked
Seat 5: warioman folded before the flop

PokerStars Hand #e1e29e6b-f0c8-4db2-bc23-2c46240c9e01:  Hold'em No Limit ($0.05/$0.10 USD) - 2021/11/20 10:44:00 ET
Table 'Aberdeen' 6-max Seat #6 is the button
Seat 1: Player#6724 ($10.32 in chips)
Seat 2: Player#7501 ($10.00 in chips)
Seat 3: warioman ($14.10 in chips)
Seat 4: Player#9747 ($12.84 in chips)
Seat 5: Player#1059 ($8.94 in chips)
Seat 6: Player#3183 ($3.01 in chips)
Player#6724: posts small blind $0.05
Player#7501: posts big blind $0.10
*** HOLE CARDS ***
Dealt to warioman [Td 8c]
Player#1059 Entry Bet 0.1
warioman: folds
Player#9747: folds
Player#1059: raises $0.10 to $0.4
Player#3183: folds
Player#6724: folds
Player#7501: folds
Player#1059: doesn't show hand
Uncalled bet ($0.40) returned to Player#1059
Player#1059 collected $0.15 from pot
*** SUMMARY ***
Total Pot $0.15 | Rake $0.00
Seat 1: Player#6724 (small blind) folded before the flop
Seat 2: Player#7501 (big blind) folded before the flop
Seat 3: warioman folded before the flop
Seat 4: Player#9747 folded before the flop
Seat 5: Player#1059 shows [] and won ($0.15) with 
Seat 6: Player#3183 (button) folded before the flop

PokerStars Hand #2d0c0e3a-82fa-46ed-bc9b-4de556ad61ec:  Hold'em No Limit ($0.1/$0.20 USD) - 2021/11/20 10:43:00 ET
Table 'Bel Air' 6-max Seat #4 is the button
Seat 1: Player#2187 ($10.99 in chips)
Seat 2: Player#0744 ($16.70 in chips)
Seat 3: warioman ($23.43 in chips)
Seat 4: Player#3840 ($13.67 in chips)
Seat 5: Player#8503 ($15.68 in chips)
Seat 6: Player#1230 ($25.13 in chips)
Player#8503: posts small blind $0.10
Player#1230: posts big blind $0.20
*** HOLE CARDS ***
Dealt to warioman [Qs 7h]
Player#2187: calls $0.20
Player#0744: calls $0.20
warioman: folds
Player#3840: folds
Player#8503: folds
Player#1230: checks
*** FLOP *** [As 9d 8c]
Player#1230: checks
Player#2187: checks
Player#0744: bets $0.70
Player#1230: folds
Player#2187: calls $0.70
*** TURN *** [As 9d 8c] [Tc]
Player#2187: checks
Player#0744: bets $0.60
Player#2187: calls $0.60
*** RIVER *** [As 9d 8c] [Tc] [7c]
Player#2187: checks
Player#0744: checks
*** SHOW DOWN *** 
Player#0744 collected $3.13 from pot
*** SUMMARY ***
Total Pot $3.30 | Rake $0.17
Board [As 9d 8c Tc 7c]
Seat 1: Player#2187 mucked
Seat 2: Player#0744 shows [6s Ac] and won ($3.13) with 
Seat 3: warioman folded before the flop
Seat 4: Player#3840 (button) folded before the flop
Seat 5: Player#8503 (small blind) folded before the flop
Seat 6: Player#1230 (big blind) folded on the flop

PokerStars Hand #2ac0b2ad-0930-4fe8-91b7-827721f475e7:  Hold'em No Limit ($0.05/$0.10 USD) - 2021/11/20 10:43:00 ET
Table 'Aberdeen' 6-max Seat #1 is the button
Seat 1: Player#4896 ($11.22 in chips)
Seat 2: Player#2717 ($10.00 in chips)
Seat 3: warioman ($14.10 in chips)
Seat 4: Player#9251 ($11.98 in chips)
Seat 5: Player#9459 ($3.06 in chips)
Player#2717: posts small blind $0.05
Player#9459: posts big blind $0.10
*** HOLE CARDS ***
Dealt to warioman [Qd 4h]
Player#2717 Waiting
warioman: folds
Player#9251: raises $0.10 to $0.3
Player#9459: folds
Player#4896: calls $0.20
*** FLOP *** [4d Kh 7c]
Player#4896: checks
Player#9251: bets $0.16
Player#4896: calls $0.16
*** TURN *** [4d Kh 7c] [2d]
Player#4896: checks
Player#9251: checks
*** RIVER *** [4d Kh 7c] [2d] [8d]
Player#4896: checks
Player#9251: bets $0.44
Player#4896: calls $0.44
*** SHOW DOWN *** 
Player#4896: doesn't show hand
Player#9251 collected $1.76 from pot
*** SUMMARY ***
Total Pot $1.85 | Rake $0.09
Board [4d Kh 7c 2d 8d]
Seat 1: Player#4896 (button) mucked
Seat 2: Player#2717 (small blind) mucked
Seat 3: warioman folded before the flop
Seat 4: Player#9251 shows [9s 9d] and won ($1.76) with 
Seat 5: Player#9459 (big blind) folded before the flop

PokerStars Hand #3c58989f-82a7-46b1-84ff-c497f26bb1ff:  Hold'em No Limit ($0.1/$0.20 USD) - 2021/11/20 10:43:00 ET
Table 'Bethlehem' 6-max Seat #4 is the button
Seat 1: Player#7527 ($29.69 in chips)
Seat 2: Player#3000 ($20.59 in chips)
Seat 3: Player#2343 ($36.58 in chips)
Seat 4: Player#5434 ($53.87 in chips)
Seat 5: warioman ($19.30 in chips)
warioman: posts small blind $0.10
Player#7527: posts big blind $0.20
*** HOLE CARDS ***
Dealt to warioman [6c 2s]
Player#3000: folds
Player#2343: raises $0.20 to $0.6
Player#5434: calls $0.60
warioman: folds
Player#7527: calls $0.40
*** FLOP *** [Jd 5c Kc]
Player#7527: checks
Player#2343: checks
Player#5434: checks
*** TURN *** [Jd 5c Kc] [Jh]
Player#7527: checks
Player#2343: checks
Player#5434: checks
*** RIVER *** [Jd 5c Kc] [Jh] [Ah]
Player#7527: checks
Player#2343: checks
Player#5434: checks
*** SHOW DOWN *** 
Player#7527 collected $1.81 from pot
*** SUMMARY ***
Total Pot $1.90 | Rake $0.10
Board [Jd 5c Kc Jh Ah]
Seat 1: Player#7527 shows [Ad 9d] and won ($1.81) with 
Seat 2: Player#3000 folded before the flop
Seat 3: Player#2343 mucked
Seat 4: Player#5434 (button) mucked
Seat 5: warioman (small blind) folded before the flop

PokerStars Hand #ca51f451-b827-4e32-a130-60e3bcf5a107:  Hold'em No Limit ($0.05/$0.10 USD) - 2021/11/20 10:43:00 ET
Table 'Aberdeen' 6-max Seat #1 is the button
Seat 1: Player#5164 ($11.22 in chips)
Seat 2: Player#2238 ($10.00 in chips)
Seat 3: warioman ($14.10 in chips)
Seat 4: Player#8234 ($12.03 in chips)
Seat 5: Player#4546 ($3.01 in chips)
Player#2238: posts small blind $0.05
Player#8234: posts big blind $0.10
*** HOLE CARDS ***
Dealt to warioman [Kd 7h]
Player#2238 Waiting
Player#5164: folds
warioman: folds
Player#8234: folds
Player#4546 collected $0.10 from pot
*** SUMMARY ***
Total Pot $0.10 | Rake $0.00
Seat 1: Player#5164 (button) folded before the flop
Seat 2: Player#2238 (small blind) mucked
Seat 3: warioman folded before the flop
Seat 4: Player#8234 (big blind) folded before the flop
Seat 5: Player#4546 shows [] and won ($0.10) with 

PokerStars Hand #74bb6ccf-310b-4eea-ac42-34687da85be7:  Hold'em No Limit ($0.05/$0.10 USD) - 2021/11/20 10:43:00 ET
Table 'Aberdeen' 6-max Seat #2 is the button
Seat 1: Player#6173 ($11.22 in chips)
Seat 2: Player#7802 ($10.00 in chips)
Seat 3: warioman ($14.15 in chips)
Seat 4: Player#4238 ($11.98 in chips)
Seat 5: Player#6023 ($3.01 in chips)
warioman: posts small blind $0.05
Player#4238: posts big blind $0.10
*** HOLE CARDS ***
Dealt to warioman [4h Qs]
Player#6023: folds
Player#6173: folds
warioman: folds
Player#4238 collected $0.10 from pot
*** SUMMARY ***
Total Pot $0.10 | Rake $0.00
Seat 1: Player#6173 folded before the flop
Seat 2: Player#7802 (button) mucked
Seat 3: warioman (small blind) folded before the flop
Seat 4: Player#4238 shows [] and won ($0.10) with 
Seat 5: Player#6023 folded before the flop

PokerStars Hand #f7f760a0-9817-4af5-83ed-8ed7b6b5d530:  Hold'em No Limit ($0.1/$0.20 USD) - 2021/11/20 10:43:00 ET
Table 'Bel Air' 6-max Seat #3 is the button
Seat 1: Player#0202 ($11.19 in chips)
Seat 2: Player#2028 ($20.00 in chips)
Seat 3: warioman ($19.98 in chips)
Seat 4: Player#1681 ($13.77 in chips)
Seat 5: Player#1954 ($15.88 in chips)
Seat 6: Player#0568 ($25.13 in chips)
Player#1681: posts small blind $0.10
Player#1954: posts big blind $0.20
*** HOLE CARDS ***
Dealt to warioman [Kh Jh]
Player#2028 Entry Bet 0.2
Player#0568: folds
Player#0202: calls $0.20
Player#2028: raises0.20 to $1
warioman: raises $1.00 to $3.3
Player#1681: folds
Player#1954: folds
Player#0202: folds
Player#2028: calls $2.30
*** FLOP *** [2d Jc Ah]
Player#2028: checks
warioman: bets $2.13
Player#2028: folds
warioman: doesn't show hand
Uncalled bet ($2.13) returned to warioman
warioman collected $6.75 from pot
*** SUMMARY ***
Total Pot $7.10 | Rake $0.36
Board [2d Jc Ah]
Seat 1: Player#0202 folded before the flop
Seat 2: Player#2028 folded on the flop
Seat 3: warioman (button)
Seat 4: Player#1681 (small blind) folded before the flop
Seat 5: Player#1954 (big blind) folded before the flop
Seat 6: Player#0568 folded before the flop

PokerStars Hand #0c98570e-033e-46c2-b495-894a434c5feb:  Hold'em No Limit ($0.1/$0.20 USD) - 2021/11/20 10:43:00 ET
Table 'Bethlehem' 6-max Seat #4 is the button
Seat 1: Player#2421 ($29.69 in chips)
Seat 2: Player#3567 ($20.59 in chips)
Seat 3: Player#1695 ($10.40 in chips)
Seat 4: Player#1509 ($36.58 in chips)
Seat 5: Player#4542 ($53.67 in chips)
Seat 6: warioman ($19.50 in chips)
Player#4542: posts small blind $0.10
warioman: posts big blind $0.20
*** HOLE CARDS ***
Dealt to warioman [Js 9c]
Player#2421: folds
Player#3567: folds
Player#1695: folds
Player#1509: folds
Player#4542: raises $0.20 to $0.6
warioman: folds
Player#2421: doesn't show hand
Player#3567: doesn't show hand
Player#1695: doesn't show hand
Player#1509: doesn't show hand
Player#4542: doesn't show hand
warioman: doesn't show hand
Uncalled bet ($0.60) returned to Player#4542
Player#4542 collected $0.20 from pot
*** SUMMARY ***
Total Pot $0.20 | Rake $0.00
Seat 1: Player#2421 folded before the flop
Seat 2: Player#3567 folded before the flop
Seat 3: Player#1695 folded before the flop
Seat 4: Player#1509 (button) folded before the flop
Seat 5: Player#4542 shows [] and won ($0.20) with 
Seat 6: warioman (big blind) folded before the flop

PokerStars Hand #10a6ba4f-80b4-47d5-8790-5909d1be159a:  Hold'em No Limit ($0.05/$0.10 USD) - 2021/11/20 10:42:00 ET
Table 'Aberdeen' 6-max Seat #6 is the button
Seat 1: Player#2210 ($10.48 in chips)
Seat 2: warioman ($14.55 in chips)
Seat 3: Player#0172 ($11.98 in chips)
Seat 4: Player#0035 ($6.55 in chips)
Seat 5: Player#1240 ($3.41 in chips)
Player#2210: posts small blind $0.05
warioman: posts big blind $0.10
*** HOLE CARDS ***
Dealt to warioman [5h 5s]
Player#0172: folds
Player#0035: folds
Player#1240: calls $0.10
Player#2210: raises $0.10 to $0.4
warioman: calls $0.30
Player#1240: calls $0.30
*** FLOP *** [2c Qh 6c]
Player#2210: bets $0.60
warioman: folds
Player#1240: folds
Player#2210: doesn't show hand
Uncalled bet ($0.60) returned to Player#2210
Player#2210 collected $1.14 from pot
*** SUMMARY ***
Total Pot $1.20 | Rake $0.06
Board [2c Qh 6c]
Seat 1: Player#2210 shows [] and won ($1.14) with 
Seat 2: warioman (big blind) folded on the flop
Seat 3: Player#0172 folded before the flop
Seat 4: Player#0035 folded before the flop
Seat 5: Player#1240 folded on the flop

PokerStars Hand #67ba6662-d486-4e23-b15b-8564baf8c783:  Hold'em No Limit ($0.1/$0.20 USD) - 2021/11/20 10:42:00 ET
Table 'Bethlehem' 6-max Seat #3 is the button
Seat 1: Player#8087 ($28.96 in chips)
Seat 2: Player#0109 ($20.59 in chips)
Seat 3: Player#4356 ($10.40 in chips)
Seat 4: Player#2142 ($36.68 in chips)
Seat 5: Player#0622 ($54.37 in chips)
Seat 6: warioman ($19.50 in chips)
Player#2142: posts small blind $0.10
Player#0622: posts big blind $0.20
*** HOLE CARDS ***
Dealt to warioman [8s 2c]
warioman: folds
Player#8087: raises $0.20 to $0.7
Player#0109: folds
Player#4356: folds
Player#2142: folds
Player#0622: calls $0.50
*** FLOP *** [8h Js 3d]
Player#0622: checks
Player#8087: bets $0.75
Player#0622: folds
Player#8087: doesn't show hand
Uncalled bet ($0.75) returned to Player#8087
Player#8087 collected $1.43 from pot
*** SUMMARY ***
Total Pot $1.50 | Rake $0.08
Board [8h Js 3d]
Seat 1: Player#8087 shows [] and won ($1.43) with 
Seat 2: Player#0109 folded before the flop
Seat 3: Player#4356 (button) folded before the flop
Seat 4: Player#2142 (small blind) folded before the flop
Seat 5: Player#0622 (big blind) folded on the flop
Seat 6: warioman folded before the flop

PokerStars Hand #2594bb9c-2a42-40db-a1bf-3bb5a27093e6:  Hold'em No Limit ($0.1/$0.20 USD) - 2021/11/20 10:42:00 ET
Table 'Bel Air' 6-max Seat #2 is the button
Seat 1: Player#3468 ($11.99 in chips)
Seat 2: Player#3712 ($20.00 in chips)
Seat 3: warioman ($20.08 in chips)
Seat 4: Player#1030 ($14.17 in chips)
Seat 5: Player#7390 ($14.68 in chips)
Seat 6: Player#4637 ($25.13 in chips)
warioman: posts small blind $0.10
Player#1030: posts big blind $0.20
*** HOLE CARDS ***
Dealt to warioman [Td 8h]
Player#7390: raises $0.20 to $0.4
Player#4637: folds
Player#3468: calls $0.40
warioman: folds
Player#1030: calls $0.20
*** FLOP *** [Qs 9d Ah]
Player#1030: checks
Player#7390: bets $0.40
Player#3468: calls $0.40
Player#1030: folds
*** TURN *** [Qs 9d Ah] [8d]
Player#7390: checks
Player#3468: checks
*** RIVER *** [Qs 9d Ah] [8d] [4d]
Player#7390: checks
Player#3468: checks
*** SHOW DOWN *** 
Player#7390 collected $2.00 from pot
*** SUMMARY ***
Total Pot $2.10 | Rake $0.11
Board [Qs 9d Ah 8d 4d]
Seat 1: Player#3468 mucked
Seat 2: Player#3712 (button) mucked
Seat 3: warioman (small blind) folded before the flop
Seat 4: Player#1030 (big blind) folded on the flop
Seat 5: Player#7390 shows [Jd Qc] and won ($2.00) with 
Seat 6: Player#4637 folded before the flop

PokerStars Hand #b711c62f-ff9c-4043-ad18-2e3ab467209a:  Hold'em No Limit ($0.05/$0.10 USD) - 2021/11/20 10:42:00 ET
Table 'Aberdeen' 6-max Seat #4 is the button
Seat 1: Player#0768 ($10.58 in chips)
Seat 2: warioman ($14.55 in chips)
Seat 3: Player#6386 ($12.28 in chips)
Seat 4: Player#3639 ($6.10 in chips)
Seat 5: Player#6261 ($3.46 in chips)
Player#6261: posts small blind $0.05
Player#0768: posts big blind $0.10
*** HOLE CARDS ***
Dealt to warioman [2c Qd]
warioman: folds
Player#6386: raises $0.10 to $0.3
Player#3639: raises $0.30 to $1.05
Player#6261: folds
Player#0768: folds
Player#6386: folds
Player#3639: doesn't show hand
Uncalled bet ($1.05) returned to Player#3639
Player#3639 collected $0.45 from pot
*** SUMMARY ***
Total Pot $0.45 | Rake $0.00
Seat 1: Player#0768 (big blind) folded before the flop
Seat 2: warioman folded before the flop
Seat 3: Player#6386 folded before the flop
Seat 4: Player#3639 shows [] and won ($0.45) with 
Seat 5: Player#6261 (small blind) folded before the flop

PokerStars Hand #32250289-3327-43e7-89d3-16959aac900e:  Hold'em No Limit ($0.1/$0.20 USD) - 2021/11/20 10:42:00 ET
Table 'Bethlehem' 6-max Seat #2 is the button
Seat 1: Player#3928 ($28.96 in chips)
Seat 2: Player#0571 ($20.59 in chips)
Seat 3: Player#6826 ($10.50 in chips)
Seat 4: Player#6518 ($36.88 in chips)
Seat 5: Player#8357 ($54.37 in chips)
Seat 6: warioman ($19.20 in chips)
Player#6826: posts small blind $0.10
Player#6518: posts big blind $0.20
*** HOLE CARDS ***
Dealt to warioman [Ah Ac]
Player#8357: folds
warioman: raises $0.20 to $0.5
Player#3928: folds
Player#0571: folds
Player#6826: folds
Player#6518: folds
warioman: doesn't show hand
Uncalled bet ($0.50) returned to warioman
warioman collected $0.30 from pot
*** SUMMARY ***
Total Pot $0.30 | Rake $0.00
Seat 1: Player#3928 folded before the flop
Seat 2: Player#0571 (button) folded before the flop
Seat 3: Player#6826 (small blind) folded before the flop
Seat 4: Player#6518 (big blind) folded before the flop
Seat 5: Player#8357 folded before the flop
Seat 6: warioman

PokerStars Hand #8f94805f-f84a-4ff0-89bf-7d9ef787b54a:  Hold'em No Limit ($0.05/$0.10 USD) - 2021/11/20 10:41:00 ET
Table 'Aberdeen' 6-max Seat #3 is the button
Seat 1: Player#4849 ($10.58 in chips)
Seat 2: warioman ($14.55 in chips)
Seat 3: Player#3198 ($12.28 in chips)
Seat 4: Player#0422 ($5.83 in chips)
Seat 5: Player#3831 ($3.76 in chips)
Player#0422: posts small blind $0.05
Player#3831: posts big blind $0.10
*** HOLE CARDS ***
Dealt to warioman [Ah 2c]
Player#4849: folds
warioman: folds
Player#3198: folds
Player#0422: calls $0.05
Player#3831: raises $0.10 to $0.3
Player#0422: calls $0.20
*** FLOP *** [Qd Qs Qc]
Player#0422: checks
Player#3831: checks
*** TURN *** [Qd Qs Qc] [Kd]
Player#0422: bets $0.30
Player#3831: folds
Player#0422: doesn't show hand
Uncalled bet ($0.30) returned to Player#0422
Player#0422 collected $0.57 from pot
*** SUMMARY ***
Total Pot $0.60 | Rake $0.03
Board [Qd Qs Qc Kd]
Seat 1: Player#4849 folded before the flop
Seat 2: warioman folded before the flop
Seat 3: Player#3198 (button) folded before the flop
Seat 4: Player#0422 shows [] and won ($0.57) with 
Seat 5: Player#3831 (big blind) folded on the turn

PokerStars Hand #dd4ba1a6-68c4-4f6f-83be-71f1fa126929:  Hold'em No Limit ($0.05/$0.10 USD) - 2021/11/20 10:41:00 ET
Table 'Aberdeen' 6-max Seat #2 is the button
Seat 1: Player#6242 ($10.58 in chips)
Seat 2: warioman ($14.55 in chips)
Seat 3: Player#4446 ($12.33 in chips)
Seat 4: Player#4360 ($5.78 in chips)
Seat 5: Player#5649 ($3.76 in chips)
Player#4446: posts small blind $0.05
Player#4360: posts big blind $0.10
*** HOLE CARDS ***
Dealt to warioman [7c 4s]
Player#5649: folds
Player#6242: folds
warioman: folds
Player#4446: folds
Player#4360 collected $0.10 from pot
*** SUMMARY ***
Total Pot $0.10 | Rake $0.00
Seat 1: Player#6242 folded before the flop
Seat 2: warioman (button) folded before the flop
Seat 3: Player#4446 (small blind) folded before the flop
Seat 4: Player#4360 shows [] and won ($0.10) with 
Seat 5: Player#5649 folded before the flop

PokerStars Hand #7e007995-1920-4b11-825e-cd316f070187:  Hold'em No Limit ($0.1/$0.20 USD) - 2021/11/20 10:41:00 ET
Table 'Bel Air' 6-max Seat #6 is the button
Seat 1: Player#1245 ($12.19 in chips)
Seat 2: warioman ($19.90 in chips)
Seat 3: Player#7277 ($14.17 in chips)
Seat 4: Player#6735 ($14.68 in chips)
Seat 5: Player#0928 ($25.13 in chips)
Player#1245: posts small blind $0.10
warioman: posts big blind $0.20
*** HOLE CARDS ***
Dealt to warioman [5c Qh]
Player#7277: folds
Player#6735: folds
Player#0928: folds
Player#1245: calls $0.10
warioman: checks
*** FLOP *** [Th 6d Kc]
Player#1245: checks
warioman: checks
*** TURN *** [Th 6d Kc] [5d]
Player#1245: checks
warioman: checks
*** RIVER *** [Th 6d Kc] [5d] [9d]
Player#1245: checks
warioman: checks
*** SHOW DOWN *** 
warioman collected $0.38 from pot
*** SUMMARY ***
Total Pot $0.40 | Rake $0.02
Board [Th 6d Kc 5d 9d]
Seat 1: Player#1245 (small blind) mucked
Seat 2: warioman (big blind)
Seat 3: Player#7277 folded before the flop
Seat 4: Player#6735 folded before the flop
Seat 5: Player#0928 folded before the flop

PokerStars Hand #ce5843f7-2515-43ed-a8d9-525fd746bf5f:  Hold'em No Limit ($0.1/$0.20 USD) - 2021/11/20 10:41:00 ET
Table 'Bethlehem' 6-max Seat #1 is the button
Seat 1: Player#4778 ($28.96 in chips)
Seat 2: Player#4428 ($20.69 in chips)
Seat 3: Player#5049 ($8.69 in chips)
Seat 4: Player#1912 ($38.78 in chips)
Seat 5: Player#9936 ($54.37 in chips)
Seat 6: warioman ($19.20 in chips)
Player#4428: posts small blind $0.10
Player#5049: posts big blind $0.20
*** HOLE CARDS ***
Dealt to warioman [Qh 3h]
Player#1912: raises $0.20 to $0.6
Player#9936: folds
warioman: folds
Player#4778: folds
Player#4428: folds
Player#5049: calls $0.40
*** FLOP *** [6h Kh 7s]
Player#5049: checks
Player#1912: checks
*** TURN *** [6h Kh 7s] [7d]
Player#5049: bets $1.30
Player#1912: calls $1.30
*** RIVER *** [6h Kh 7s] [7d] [8d]
Player#5049: bets $3.90
Player#1912: folds
Player#5049: doesn't show hand
Uncalled bet ($3.90) returned to Player#5049
Player#5049 collected $3.71 from pot
*** SUMMARY ***
Total Pot $3.90 | Rake $0.20
Board [6h Kh 7s 7d 8d]
Seat 1: Player#4778 (button) folded before the flop
Seat 2: Player#4428 (small blind) folded before the flop
Seat 3: Player#5049 shows [] and won ($3.71) with 
Seat 4: Player#1912 folded on the river
Seat 5: Player#9936 folded before the flop
Seat 6: warioman folded before the flop

PokerStars Hand #bcb86991-9226-4d14-b4c1-df4db63b58db:  Hold'em No Limit ($0.1/$0.20 USD) - 2021/11/20 10:40:00 ET
Table 'Bethlehem' 6-max Seat #6 is the button
Seat 1: Player#1144 ($28.26 in chips)
Seat 2: Player#7654 ($20.89 in chips)
Seat 3: Player#8889 ($38.78 in chips)
Seat 4: Player#5191 ($54.37 in chips)
Seat 5: warioman ($19.70 in chips)
Player#1144: posts small blind $0.10
Player#7654: posts big blind $0.20
*** HOLE CARDS ***
Dealt to warioman [2h Ah]
Player#8889: folds
Player#5191: folds
warioman: raises $0.20 to $0.5
Player#1144: raises $0.50 to $1.9
Player#7654: folds
warioman: folds
Player#1144: doesn't show hand
Uncalled bet ($1.90) returned to Player#1144
Player#1144 collected $0.70 from pot
*** SUMMARY ***
Total Pot $0.70 | Rake $0.00
Seat 1: Player#1144 shows [] and won ($0.70) with 
Seat 2: Player#7654 (big blind) folded before the flop
Seat 3: Player#8889 folded before the flop
Seat 4: Player#5191 folded before the flop
Seat 5: warioman folded before the flop

PokerStars Hand #dc9c55dd-a951-49c6-9cfc-e0c950aeaab7:  Hold'em No Limit ($0.05/$0.10 USD) - 2021/11/20 10:40:00 ET
Table 'Aberdeen' 6-max Seat #2 is the button
Seat 1: Player#7952 ($10.58 in chips)
Seat 2: Player#4980 ($9.09 in chips)
Seat 3: warioman ($14.60 in chips)
Seat 4: Player#4064 ($12.43 in chips)
Seat 5: Player#2299 ($5.00 in chips)
Seat 6: Player#9796 ($3.76 in chips)
warioman: posts small blind $0.05
Player#4064: posts big blind $0.10
*** HOLE CARDS ***
Dealt to warioman [9c 3h]
Player#2299: raises $0.10 to $0.35
Player#9796: folds
Player#7952: folds
Player#4980: raises $0.35 to $0.7
warioman: folds
Player#4064: folds
Player#2299: calls $0.35
*** FLOP *** [5c Kh 6c]
Player#2299: checks
Player#4980: checks
*** TURN *** [5c Kh 6c] [Qs]
Player#2299: bets $1.07
Player#4980: folds
Player#2299: doesn't show hand
Uncalled bet ($1.07) returned to Player#2299
Player#2299 collected $1.47 from pot
*** SUMMARY ***
Total Pot $1.55 | Rake $0.08
Board [5c Kh 6c Qs]
Seat 1: Player#7952 folded before the flop
Seat 2: Player#4980 (button) folded on the turn
Seat 3: warioman (small blind) folded before the flop
Seat 4: Player#4064 (big blind) folded before the flop
Seat 5: Player#2299 shows [] and won ($1.47) with 
Seat 6: Player#9796 folded before the flop

PokerStars Hand #d2935efe-1860-4df8-923c-de679a999a7a:  Hold'em No Limit ($0.1/$0.20 USD) - 2021/11/20 10:40:00 ET
Table 'Bethlehem' 6-max Seat #4 is the button
Seat 1: Player#7353 ($27.98 in chips)
Seat 2: Player#7003 ($20.89 in chips)
Seat 3: Player#0217 ($38.78 in chips)
Seat 4: Player#2568 ($54.57 in chips)
Seat 5: warioman ($19.80 in chips)
warioman: posts small blind $0.10
Player#7353: posts big blind $0.20
*** HOLE CARDS ***
Dealt to warioman [2s Qc]
Player#7003: folds
Player#0217: folds
Player#2568: calls $0.20
warioman: folds
Player#7353: checks
*** FLOP *** [Ad 3h Kh]
Player#7353: checks
Player#2568: checks
*** TURN *** [Ad 3h Kh] [8d]
Player#7353: bets $27.78
Player#2568: folds
Player#7353: doesn't show hand
Uncalled bet ($27.78) returned to Player#7353
Player#7353 collected $0.47 from pot
*** SUMMARY ***
Total Pot $0.50 | Rake $0.03
Board [Ad 3h Kh 8d]
Seat 1: Player#7353 shows [] and won ($0.47) with 
Seat 2: Player#7003 folded before the flop
Seat 3: Player#0217 folded before the flop
Seat 4: Player#2568 (button) folded on the turn
Seat 5: warioman (small blind) folded before the flop

PokerStars Hand #3fdaf4b9-137e-4c69-805d-b1e9ce7766a5:  Hold'em No Limit ($0.05/$0.10 USD) - 2021/11/20 10:40:00 ET
Table 'Aberdeen' 6-max Seat #1 is the button
Seat 1: Player#7563 ($10.58 in chips)
Seat 2: Player#8629 ($9.14 in chips)
Seat 3: warioman ($14.70 in chips)
Seat 4: Player#8329 ($12.43 in chips)
Seat 5: Player#5864 ($5.10 in chips)
Seat 6: Player#2399 ($3.52 in chips)
Player#8629: posts small blind $0.05
warioman: posts big blind $0.10
*** HOLE CARDS ***
Dealt to warioman [9s Ts]
Player#8329: folds
Player#5864: calls $0.10
Player#2399: calls $0.10
Player#7563: folds
Player#8629: folds
warioman: checks
*** FLOP *** [Kh Kd 3s]
warioman: checks
Player#5864: checks
Player#2399: checks
*** TURN *** [Kh Kd 3s] [Ac]
warioman: checks
Player#5864: checks
Player#2399: bets $0.20
warioman: folds
Player#5864: folds
Player#2399: doesn't show hand
Uncalled bet ($0.20) returned to Player#2399
Player#2399 collected $0.33 from pot
*** SUMMARY ***
Total Pot $0.35 | Rake $0.02
Board [Kh Kd 3s Ac]
Seat 1: Player#7563 (button) folded before the flop
Seat 2: Player#8629 (small blind) folded before the flop
Seat 3: warioman (big blind) folded on the turn
Seat 4: Player#8329 folded before the flop
Seat 5: Player#5864 folded on the turn
Seat 6: Player#2399 shows [] and won ($0.33) with 

PokerStars Hand #e9f62195-e949-4711-be8f-5fcb0f5ac405:  Hold'em No Limit ($0.1/$0.20 USD) - 2021/11/20 10:40:00 ET
Table 'Bethlehem' 6-max Seat #3 is the button
Seat 1: Player#8175 ($27.98 in chips)
Seat 2: Player#5928 ($20.89 in chips)
Seat 3: Player#0119 ($38.78 in chips)
Seat 4: Player#2028 ($54.39 in chips)
Seat 5: warioman ($20.00 in chips)
Player#2028: posts small blind $0.10
warioman: posts big blind $0.20
*** HOLE CARDS ***
Dealt to warioman [Qd 6c]
Player#8175: folds
Player#5928: folds
Player#0119: folds
Player#2028: calls $0.10
warioman: checks
*** FLOP *** [Jd 3s Kh]
Player#2028: bets $0.20
warioman: folds
Player#2028: doesn't show hand
Uncalled bet ($0.20) returned to Player#2028
Player#2028 collected $0.38 from pot
*** SUMMARY ***
Total Pot $0.40 | Rake $0.02
Board [Jd 3s Kh]
Seat 1: Player#8175 folded before the flop
Seat 2: Player#5928 folded before the flop
Seat 3: Player#0119 (button) folded before the flop
Seat 4: Player#2028 shows [] and won ($0.38) with 
Seat 5: warioman (big blind) folded on the flop

PokerStars Hand #e73e7cca-9c4f-4e4f-aa5c-3cf365e01b05:  Hold'em No Limit ($0.1/$0.20 USD) - 2021/11/20 10:39:00 ET
Table 'Bethlehem' 6-max Seat #4 is the button
Seat 1: Player#6447 ($27.98 in chips)
Seat 2: Player#7153 ($20.89 in chips)
Seat 3: Player#2352 ($38.88 in chips)
Seat 4: Player#8379 ($54.29 in chips)
Seat 5: warioman ($20.00 in chips)
warioman: posts small blind $0.10
Player#2352: posts big blind $0.20
*** HOLE CARDS ***
Dealt to warioman []
warioman Waiting
Player#6447: folds
Player#7153: folds
Player#2352: folds
Player#8379 collected $0.20 from pot
*** SUMMARY ***
Total Pot $0.20 | Rake $0.00
Seat 1: Player#6447 folded before the flop
Seat 2: Player#7153 folded before the flop
Seat 3: Player#2352 (big blind) folded before the flop
Seat 4: Player#8379 shows [] and won ($0.20) with 
Seat 5: warioman (small blind)

PokerStars Hand #2abd3282-79c5-44c8-8a3c-d1892c7c293f:  Hold'em No Limit ($0.05/$0.10 USD) - 2021/11/20 10:39:00 ET
Table 'Aberdeen' 6-max Seat #6 is the button
Seat 1: Player#8706 ($10.63 in chips)
Seat 2: Player#5256 ($9.24 in chips)
Seat 3: warioman ($14.55 in chips)
Seat 4: Player#1661 ($12.43 in chips)
Seat 5: Player#2942 ($5.10 in chips)
Seat 6: Player#9565 ($3.52 in chips)
Player#8706: posts small blind $0.05
Player#5256: posts big blind $0.10
*** HOLE CARDS ***
Dealt to warioman [Ks Kh]
warioman: raises $0.10 to $0.3
Player#1661: folds
Player#2942: folds
Player#9565: folds
Player#8706: folds
Player#5256: folds
warioman: doesn't show hand
Uncalled bet ($0.30) returned to warioman
warioman collected $0.15 from pot
*** SUMMARY ***
Total Pot $0.15 | Rake $0.00
Seat 1: Player#8706 (small blind) folded before the flop
Seat 2: Player#5256 (big blind) folded before the flop
Seat 3: warioman
Seat 4: Player#1661 folded before the flop
Seat 5: Player#2942 folded before the flop
Seat 6: Player#9565 (button) folded before the flop

PokerStars Hand #1faad94b-84f5-4003-bf9e-7850da2b1bf0:  Hold'em No Limit ($0.1/$0.20 USD) - 2021/11/20 10:39:00 ET
Table 'Bel Air' 6-max Seat #4 is the button
Seat 1: Player#7603 ($12.39 in chips)
Seat 2: warioman ($19.90 in chips)
Seat 3: Player#5637 ($14.17 in chips)
Seat 4: Player#1146 ($17.68 in chips)
Seat 5: Player#9617 ($22.24 in chips)
Player#9617: posts small blind $0.10
Player#7603: posts big blind $0.20
*** HOLE CARDS ***
Dealt to warioman [Jc Qh]
warioman: folds
Player#5637: folds
Player#1146: calls $0.20
Player#9617: calls $0.10
Player#7603: checks
*** FLOP *** [3s 9h 5h]
Player#9617: checks
Player#7603: checks
Player#1146: bets $0.20
Player#9617: calls $0.20
Player#7603: folds
*** TURN *** [3s 9h 5h] [Ts]
Player#9617: checks
Player#1146: bets $0.60
Player#9617: raises $0.60 to $2.6
Player#1146: calls $2.00
*** RIVER *** [3s 9h 5h] [Ts] [6s]
Player#9617: bets $4.65
Player#1146: folds
Player#9617: doesn't show hand
Uncalled bet ($4.65) returned to Player#9617
Player#9617 collected $5.89 from pot
*** SUMMARY ***
Total Pot $6.20 | Rake $0.31
Board [3s 9h 5h Ts 6s]
Seat 1: Player#7603 (big blind) folded on the flop
Seat 2: warioman folded before the flop
Seat 3: Player#5637 folded before the flop
Seat 4: Player#1146 (button) folded on the river
Seat 5: Player#9617 shows [] and won ($5.89) with 

PokerStars Hand #e000cf19-eb96-4eac-b6e0-9b2e89ca02ed:  Hold'em No Limit ($0.05/$0.10 USD) - 2021/11/20 10:39:00 ET
Table 'Aberdeen' 6-max Seat #5 is the button
Seat 1: Player#1877 ($10.73 in chips)
Seat 2: Player#1311 ($9.24 in chips)
Seat 3: warioman ($14.55 in chips)
Seat 4: Player#5266 ($12.06 in chips)
Seat 5: Player#0781 ($5.10 in chips)
Seat 6: Player#7927 ($3.82 in chips)
Player#7927: posts small blind $0.05
Player#1877: posts big blind $0.10
*** HOLE CARDS ***
Dealt to warioman [Qc 2s]
Player#1311: folds
warioman: folds
Player#5266: raises $0.10 to $0.3
Player#0781: folds
Player#7927: calls $0.25
Player#1877: folds
*** FLOP *** [2c Qs 8c]
Player#7927: checks
Player#5266: bets $0.17
Player#7927: folds
Player#5266: doesn't show hand
Uncalled bet ($0.17) returned to Player#5266
Player#5266 collected $0.66 from pot
*** SUMMARY ***
Total Pot $0.70 | Rake $0.03
Board [2c Qs 8c]
Seat 1: Player#1877 (big blind) folded before the flop
Seat 2: Player#1311 folded before the flop
Seat 3: warioman folded before the flop
Seat 4: Player#5266 shows [] and won ($0.66) with 
Seat 5: Player#0781 (button) folded before the flop
Seat 6: Player#7927 (small blind) folded on the flop

PokerStars Hand #ef149d35-1b77-421a-8488-f30b89f9dc8d:  Hold'em No Limit ($0.1/$0.20 USD) - 2021/11/20 10:38:00 ET
Table 'Bel Air' 6-max Seat #4 is the button
Seat 1: Player#7125 ($12.39 in chips)
Seat 2: Player#3121 ($31.23 in chips)
Seat 3: warioman ($19.90 in chips)
Seat 4: Player#5517 ($14.17 in chips)
Seat 5: Player#0645 ($16.60 in chips)
Seat 6: Player#5989 ($23.44 in chips)
Player#0645: posts small blind $0.10
Player#5989: posts big blind $0.20
*** HOLE CARDS ***
Dealt to warioman [Kd 2d]
Player#7125: folds
Player#3121: folds
warioman: folds
Player#5517: folds
Player#0645: raises $0.20 to $0.4
Player#5989: raises $0.40 to $1.2
Player#0645: calls $0.80
*** FLOP *** [5c 5d Tc]
Player#0645: checks
Player#5989: checks
*** TURN *** [5c 5d Tc] [Jh]
Player#0645: bets $1.20
Player#5989: folds
Player#0645: doesn't show hand
Uncalled bet ($1.20) returned to Player#0645
Player#0645 collected $2.28 from pot
*** SUMMARY ***
Total Pot $2.40 | Rake $0.12
Board [5c 5d Tc Jh]
Seat 1: Player#7125 folded before the flop
Seat 2: Player#3121 folded before the flop
Seat 3: warioman folded before the flop
Seat 4: Player#5517 (button) folded before the flop
Seat 5: Player#0645 shows [] and won ($2.28) with 
Seat 6: Player#5989 (big blind) folded on the turn

PokerStars Hand #bc6b811f-6cbd-4ec9-b19c-320f061a940d:  Hold'em No Limit ($0.1/$0.20 USD) - 2021/11/20 10:38:00 ET
Table 'Bel Air' 6-max Seat #3 is the button
Seat 1: Player#3972 ($12.39 in chips)
Seat 2: Player#0656 ($31.23 in chips)
Seat 3: warioman ($19.90 in chips)
Seat 4: Player#8115 ($14.27 in chips)
Seat 5: Player#8097 ($16.50 in chips)
Seat 6: Player#1154 ($23.44 in chips)
Player#8115: posts small blind $0.10
Player#8097: posts big blind $0.20
*** HOLE CARDS ***
Dealt to warioman [Jc 6d]
Player#1154: folds
Player#3972: folds
Player#0656: folds
warioman: folds
Player#8115: folds
Player#8097 collected $0.20 from pot
*** SUMMARY ***
Total Pot $0.20 | Rake $0.00
Seat 1: Player#3972 folded before the flop
Seat 2: Player#0656 folded before the flop
Seat 3: warioman (button) folded before the flop
Seat 4: Player#8115 (small blind) folded before the flop
Seat 5: Player#8097 shows [] and won ($0.20) with 
Seat 6: Player#1154 folded before the flop

PokerStars Hand #666afe94-b574-4f67-8d2b-415ec145870d:  Hold'em No Limit ($0.05/$0.10 USD) - 2021/11/20 10:38:00 ET
Table 'Aberdeen' 6-max Seat #4 is the button
Seat 1: Player#1352 ($10.73 in chips)
Seat 2: Player#0442 ($9.41 in chips)
Seat 3: warioman ($14.55 in chips)
Seat 4: Player#5606 ($12.06 in chips)
Seat 5: Player#4952 ($5.15 in chips)
Seat 6: Player#3595 ($4.00 in chips)
Player#4952: posts small blind $0.05
Player#3595: posts big blind $0.10
*** HOLE CARDS ***
Dealt to warioman [6h Qh]
Player#1352: folds
Player#0442: raises $0.10 to $0.3
warioman: folds
Player#5606: folds
Player#4952: folds
Player#3595: calls $0.20
*** FLOP *** [Ah 7h 9s]
Player#3595: checks
Player#0442: bets $0.33
Player#3595: calls $0.33
*** TURN *** [Ah 7h 9s] [4d]
Player#3595: checks
Player#0442: bets $0.66
Player#3595: raises $0.66 to $1.65
Player#0442: calls $0.99
*** RIVER *** [Ah 7h 9s] [4d] [5d]
Player#3595: bets $1.72
Player#0442: calls $1.72
*** SHOW DOWN *** 
Player#1352: doesn't show hand
Player#0442: doesn't show hand
warioman: doesn't show hand
Player#5606: doesn't show hand
Player#4952: doesn't show hand
Player#3595: doesn't show hand
 *** SUMMARY ***
Total Pot $8.05 | Rake $0.40
Board [Ah 7h 9s 4d 5d]
Seat 1: Player#1352 folded before the flop
Seat 2: Player#0442 mucked
Seat 3: warioman folded before the flop
Seat 4: Player#5606 (button) folded before the flop
Seat 5: Player#4952 (small blind) folded before the flop
Seat 6: Player#3595 (big blind) mucked

PokerStars Hand #9b4e5dfd-4785-4a47-b999-2465d77e4fcb:  Hold'em No Limit ($0.1/$0.20 USD) - 2021/11/20 10:37:00 ET
Table 'Bel Air' 6-max Seat #2 is the button
Seat 1: Player#8564 ($12.39 in chips)
Seat 2: Player#5865 ($31.23 in chips)
Seat 3: warioman ($20.00 in chips)
Seat 4: Player#0805 ($14.47 in chips)
Seat 5: Player#3222 ($20.00 in chips)
Seat 6: Player#2527 ($20.00 in chips)
warioman: posts small blind $0.10
Player#0805: posts big blind $0.20
*** HOLE CARDS ***
Dealt to warioman [7s 9d]
Player#3222 BB + Dead Small 0.3
Player#3222: checks
Player#2527: raises0.20 to $1
Player#8564: folds
Player#5865: folds
warioman: folds
Player#0805: folds
Player#3222: calls $0.80
*** FLOP *** [Jh As 3s]
Player#3222: checks
Player#2527: checks
*** TURN *** [Jh As 3s] [Ks]
Player#3222: bets $0.60
Player#2527: calls $0.60
*** RIVER *** [Jh As 3s] [Ks] [5s]
Player#3222: bets $1.80
Player#2527: calls $1.80
*** SHOW DOWN *** 
Player#2527 collected $6.56 from pot
*** SUMMARY ***
Total Pot $6.90 | Rake $0.35
Board [Jh As 3s Ks 5s]
Seat 1: Player#8564 folded before the flop
Seat 2: Player#5865 (button) folded before the flop
Seat 3: warioman (small blind) folded before the flop
Seat 4: Player#0805 (big blind) folded before the flop
Seat 5: Player#3222 mucked
Seat 6: Player#2527 shows [Jd Kh] and won ($6.56) with 

PokerStars Hand #ee211b0d-0718-4190-87fd-f0c619127cec:  Hold'em No Limit ($0.05/$0.10 USD) - 2021/11/20 10:37:00 ET
Table 'Aberdeen' 6-max Seat #3 is the button
Seat 1: Player#9245 ($10.73 in chips)
Seat 2: Player#1535 ($9.41 in chips)
Seat 3: warioman ($16.57 in chips)
Seat 4: Player#1328 ($10.14 in chips)
Seat 5: Player#1953 ($5.25 in chips)
Seat 6: Player#1714 ($4.00 in chips)
Player#1328: posts small blind $0.05
Player#1953: posts big blind $0.10
*** HOLE CARDS ***
Dealt to warioman [As 4d]
Player#1714: folds
Player#9245: folds
Player#1535: folds
warioman: raises $0.10 to $0.3
Player#1328: raises $0.30 to $1.2
Player#1953: folds
warioman: calls $0.90
*** FLOP *** [8h Qh Ad]
Player#1328: bets $0.82
warioman: calls $0.82
*** TURN *** [8h Qh Ad] [Jd]
Player#1328: bets $1.74
warioman: folds
Player#1328: doesn't show hand
Uncalled bet ($1.74) returned to Player#1328
Player#1328 collected $3.93 from pot
*** SUMMARY ***
Total Pot $4.14 | Rake $0.21
Board [8h Qh Ad Jd]
Seat 1: Player#9245 folded before the flop
Seat 2: Player#1535 folded before the flop
Seat 3: warioman (button) folded on the turn
Seat 4: Player#1328 shows [] and won ($3.93) with 
Seat 5: Player#1953 (big blind) folded before the flop
Seat 6: Player#1714 folded before the flop

PokerStars Hand #2b82f18e-f48d-4d79-bc08-12baf2f042be:  Hold'em No Limit ($0.05/$0.10 USD) - 2021/11/20 10:36:00 ET
Table 'Aberdeen' 6-max Seat #2 is the button
Seat 1: Player#8801 ($10.73 in chips)
Seat 2: Player#7756 ($9.41 in chips)
Seat 3: warioman ($16.62 in chips)
Seat 4: Player#2056 ($10.00 in chips)
Seat 5: Player#3863 ($5.35 in chips)
Seat 6: Player#0082 ($4.00 in chips)
warioman: posts small blind $0.05
Player#2056: posts big blind $0.10
*** HOLE CARDS ***
Dealt to warioman [5h 2d]
Player#3863: calls $0.10
Player#0082: folds
Player#8801: folds
Player#7756: folds
warioman: folds
Player#2056: checks
*** FLOP *** [7s Th 6c]
Player#2056: checks
Player#3863: checks
*** TURN *** [7s Th 6c] [3d]
Player#2056: checks
Player#3863: checks
*** RIVER *** [7s Th 6c] [3d] [9d]
Player#2056: checks
Player#3863: checks
*** SHOW DOWN *** 
Player#2056 collected $0.24 from pot
*** SUMMARY ***
Total Pot $0.25 | Rake $0.01
Board [7s Th 6c 3d 9d]
Seat 1: Player#8801 folded before the flop
Seat 2: Player#7756 (button) folded before the flop
Seat 3: warioman (small blind) folded before the flop
Seat 4: Player#2056 shows [6s Kc] and won ($0.24) with 
Seat 5: Player#3863 mucked
Seat 6: Player#0082 folded before the flop

PokerStars Hand #75dd8717-b211-46d6-927a-112abd35a5b7:  Hold'em No Limit ($0.1/$0.20 USD) - 2021/11/20 10:36:00 ET
Table 'Bel Air' 6-max Seat #1 is the button
Seat 1: Player#6841 ($12.39 in chips)
Seat 2: Player#4012 ($24.03 in chips)
Seat 3: warioman ($24.60 in chips)
Seat 4: Player#1648 ($14.47 in chips)
Seat 5: Player#4834 ($20.00 in chips)
Player#4012: posts small blind $0.10
warioman: posts big blind $0.20
*** HOLE CARDS ***
Dealt to warioman [Kd Ah]
Player#1648: folds
Player#4834: folds
Player#6841: folds
Player#4012: raises $0.20 to $0.6
warioman: raises $0.60 to $1.8
Player#4012: calls $1.20
*** FLOP *** [8s 3s 9h]
Player#4012: bets $2.00
warioman: raises $2.00 to $6.2
Player#4012: raises $ 26.20 to $22.23
warioman: folds
Player#4012: doesn't show hand
Uncalled bet ($22.23) returned to Player#4012
Player#4012 collected $9.31 from pot
*** SUMMARY ***
Total Pot $9.80 | Rake $0.49
Board [8s 3s 9h]
Seat 1: Player#6841 (button) folded before the flop
Seat 2: Player#4012 shows [] and won ($9.31) with 
Seat 3: warioman (big blind) folded on the flop
Seat 4: Player#1648 folded before the flop
Seat 5: Player#4834 folded before the flop

PokerStars Hand #755083c6-be63-4cc9-9d42-adcebe5fd350:  Hold'em No Limit ($0.05/$0.10 USD) - 2021/11/20 10:35:00 ET
Table 'Aberdeen' 6-max Seat #3 is the button
Seat 1: Player#8916 ($10.73 in chips)
Seat 2: Player#1812 ($9.46 in chips)
Seat 3: warioman ($16.72 in chips)
Seat 4: Player#5874 ($10.00 in chips)
Seat 5: Player#6947 ($5.21 in chips)
Seat 6: Player#2973 ($4.00 in chips)
Player#5874: posts small blind $0.05
Player#1812: posts big blind $0.10
*** HOLE CARDS ***
Dealt to warioman [9h 6s]
Player#5874 Waiting
Player#6947: calls $0.10
Player#2973: folds
Player#8916: folds
Player#1812: folds
warioman: checks
*** FLOP *** [Js 8h Qd]
warioman: checks
Player#6947: bets $0.25
warioman: folds
Player#6947: doesn't show hand
Uncalled bet ($0.25) returned to Player#6947
Player#6947 collected $0.24 from pot
*** SUMMARY ***
Total Pot $0.25 | Rake $0.01
Board [Js 8h Qd]
Seat 1: Player#8916 folded before the flop
Seat 2: Player#1812 (big blind) folded before the flop
Seat 3: warioman (button) folded on the flop
Seat 4: Player#5874 (small blind) mucked
Seat 5: Player#6947 shows [] and won ($0.24) with 
Seat 6: Player#2973 folded before the flop

PokerStars Hand #df92eab4-c42c-4ea1-9d0e-0968c88fd28f:  Hold'em No Limit ($0.1/$0.20 USD) - 2021/11/20 10:35:00 ET
Table 'Bel Air' 6-max Seat #6 is the button
Seat 1: Player#7986 ($12.59 in chips)
Seat 2: Player#7579 ($23.85 in chips)
Seat 3: warioman ($24.60 in chips)
Seat 4: Player#9426 ($14.47 in chips)
Seat 5: Player#3863 ($20.00 in chips)
Player#7986: posts small blind $0.10
Player#7579: posts big blind $0.20
*** HOLE CARDS ***
Dealt to warioman [Jh 4d]
warioman: folds
Player#9426: folds
Player#3863: folds
Player#7986: calls $0.10
Player#7579: checks
*** FLOP *** [As Th 9h]
Player#7986: checks
Player#7579: checks
*** TURN *** [As Th 9h] [2h]
Player#7986: checks
Player#7579: checks
*** RIVER *** [As Th 9h] [2h] [7h]
Player#7986: checks
Player#7579: checks
*** SHOW DOWN *** 
Player#7579 collected $0.38 from pot
*** SUMMARY ***
Total Pot $0.40 | Rake $0.02
Board [As Th 9h 2h 7h]
Seat 1: Player#7986 (small blind) mucked
Seat 2: Player#7579 shows [Td 3d] and won ($0.38) with 
Seat 3: warioman folded before the flop
Seat 4: Player#9426 folded before the flop
Seat 5: Player#3863 folded before the flop

PokerStars Hand #e2987469-92c9-4042-8e31-3cd10526f7fc:  Hold'em No Limit ($0.05/$0.10 USD) - 2021/11/20 10:35:00 ET
Table 'Aberdeen' 6-max Seat #3 is the button
Seat 1: Player#8012 ($10.78 in chips)
Seat 2: Player#5839 ($9.41 in chips)
Seat 3: warioman ($16.72 in chips)
Seat 4: Player#6896 ($10.00 in chips)
Seat 5: Player#4792 ($5.21 in chips)
Player#6896: posts small blind $0.05
Player#8012: posts big blind $0.10
*** HOLE CARDS ***
Dealt to warioman [Ac 4d]
Player#6896 Waiting
warioman: folds
Player#4792: folds
Player#8012: folds
Player#5839 collected $0.10 from pot
*** SUMMARY ***
Total Pot $0.10 | Rake $0.00
Seat 1: Player#8012 (big blind) folded before the flop
Seat 2: Player#5839 shows [] and won ($0.10) with 
Seat 3: warioman (button) folded before the flop
Seat 4: Player#6896 (small blind) mucked
Seat 5: Player#4792 folded before the flop

PokerStars Hand #a40b3104-8f61-4aab-b5c2-3c5d9a8293cb:  Hold'em No Limit ($0.1/$0.20 USD) - 2021/11/20 10:34:00 ET
Table 'Bel Air' 6-max Seat #4 is the button
Seat 1: Player#2184 ($12.79 in chips)
Seat 2: Player#5662 ($24.05 in chips)
Seat 3: warioman ($24.60 in chips)
Seat 4: Player#8290 ($11.93 in chips)
Seat 5: Player#3968 ($21.35 in chips)
Player#3968: posts small blind $0.10
Player#2184: posts big blind $0.20
*** HOLE CARDS ***
Dealt to warioman [7c 4s]
Player#5662: calls $0.20
warioman: folds
Player#8290: raises $0.20 to $0.6
Player#3968: raises $0.60 to $2.4
Player#2184: folds
Player#5662: folds
Player#8290: calls $1.80
*** FLOP *** [6c 3s Qd]
Player#3968: checks
Player#8290: checks
*** TURN *** [6c 3s Qd] [Qs]
Player#3968: checks
Player#8290: bets $5.20
Player#3968: folds
Player#8290: doesn't show hand
Uncalled bet ($5.20) returned to Player#8290
Player#8290 collected $4.94 from pot
*** SUMMARY ***
Total Pot $5.20 | Rake $0.26
Board [6c 3s Qd Qs]
Seat 1: Player#2184 (big blind) folded before the flop
Seat 2: Player#5662 folded before the flop
Seat 3: warioman folded before the flop
Seat 4: Player#8290 shows [] and won ($4.94) with 
Seat 5: Player#3968 (small blind) folded on the turn

PokerStars Hand #4e084d86-c324-4ae3-bd62-dd9ac4838e26:  Hold'em No Limit ($0.05/$0.10 USD) - 2021/11/20 10:34:00 ET
Table 'Aberdeen' 6-max Seat #4 is the button
Seat 1: Player#5443 ($10.88 in chips)
Seat 2: Player#6193 ($9.41 in chips)
Seat 3: warioman ($10.91 in chips)
Seat 4: Player#7665 ($5.51 in chips)
Seat 5: Player#0663 ($6.03 in chips)
Player#0663: posts small blind $0.05
Player#5443: posts big blind $0.10
*** HOLE CARDS ***
Dealt to warioman [Ah As]
Player#6193: folds
warioman: raises $0.10 to $0.3
Player#7665: calls $0.30
Player#0663: raises $0.30 to $1.3
Player#5443: folds
warioman: raises1.30 to $3
Player#7665: folds
Player#0663: calls $1.70
*** FLOP *** [Ac 6d 9c]
Player#0663: checks
warioman: checks
*** TURN *** [Ac 6d 9c] [2s]
Player#0663: checks
warioman: checks
*** RIVER *** [Ac 6d 9c] [2s] [4s]
Player#0663: bets $3.03
warioman: calls $3.03
*** SHOW DOWN *** 
warioman collected $11.84 from pot
*** SUMMARY ***
Total Pot $12.46 | Rake $0.62
Board [Ac 6d 9c 2s 4s]
Seat 1: Player#5443 (big blind) folded before the flop
Seat 2: Player#6193 folded before the flop
Seat 3: warioman
Seat 4: Player#7665 (button) folded before the flop
Seat 5: Player#0663 (small blind) mucked

PokerStars Hand #42bf83ff-e1ac-439e-aa1f-867eee921206:  Hold'em No Limit ($0.1/$0.20 USD) - 2021/11/20 10:34:00 ET
Table 'Bel Air' 6-max Seat #3 is the button
Seat 1: Player#7822 ($13.79 in chips)
Seat 2: Player#4322 ($24.05 in chips)
Seat 3: warioman ($24.60 in chips)
Seat 4: Player#7679 ($12.93 in chips)
Seat 5: Player#5087 ($19.50 in chips)
Player#7679: posts small blind $0.10
Player#5087: posts big blind $0.20
*** HOLE CARDS ***
Dealt to warioman [5c 8s]
Player#7822: calls $0.20
Player#4322: folds
warioman: folds
Player#7679: calls $0.10
Player#5087: raises0.20 to $1
Player#7822: calls $0.80
Player#7679: calls $0.80
*** FLOP *** [Ad 7s 8d]
Player#7679: checks
Player#5087: bets $1.50
Player#7822: folds
Player#7679: folds
Player#5087: doesn't show hand
Uncalled bet ($1.50) returned to Player#5087
Player#5087 collected $2.85 from pot
*** SUMMARY ***
Total Pot $3.00 | Rake $0.15
Board [Ad 7s 8d]
Seat 1: Player#7822 folded on the flop
Seat 2: Player#4322 folded before the flop
Seat 3: warioman (button) folded before the flop
Seat 4: Player#7679 (small blind) folded on the flop
Seat 5: Player#5087 shows [] and won ($2.85) with 

PokerStars Hand #a9035a65-01bb-4e1a-8823-16210320407e:  Hold'em No Limit ($0.1/$0.20 USD) - 2021/11/20 10:33:00 ET
Table 'Bel Air' 6-max Seat #2 is the button
Seat 1: Player#9525 ($12.96 in chips)
Seat 2: Player#3947 ($24.65 in chips)
Seat 3: warioman ($24.70 in chips)
Seat 4: Player#1255 ($13.13 in chips)
Seat 5: Player#6809 ($20.00 in chips)
Seat 6: Player#3309 ($19.50 in chips)
warioman: posts small blind $0.10
Player#1255: posts big blind $0.20
*** HOLE CARDS ***
Dealt to warioman [4c Ad]
Player#6809: folds
Player#3309: folds
Player#9525: calls $0.20
Player#3947: raises $0.20 to $0.6
warioman: folds
Player#1255: folds
Player#9525: calls $0.40
*** FLOP *** [5h Qs Kd]
Player#9525: bets $1.50
Player#3947: folds
Player#9525: doesn't show hand
Uncalled bet ($1.50) returned to Player#9525
Player#9525 collected $1.43 from pot
*** SUMMARY ***
Total Pot $1.50 | Rake $0.08
Board [5h Qs Kd]
Seat 1: Player#9525 shows [] and won ($1.43) with 
Seat 2: Player#3947 (button) folded on the flop
Seat 3: warioman (small blind) folded before the flop
Seat 4: Player#1255 (big blind) folded before the flop
Seat 5: Player#6809 folded before the flop
Seat 6: Player#3309 folded before the flop

PokerStars Hand #11a88c1e-3363-4572-b47d-6e2bfe35490e:  Hold'em No Limit ($0.05/$0.10 USD) - 2021/11/20 10:33:00 ET
Table 'Aberdeen' 6-max Seat #3 is the button
Seat 1: Player#3063 ($11.18 in chips)
Seat 2: Player#4623 ($9.41 in chips)
Seat 3: warioman ($10.91 in chips)
Seat 4: Player#4051 ($5.56 in chips)
Seat 5: Player#3194 ($5.71 in chips)
Player#4051: posts small blind $0.05
Player#3194: posts big blind $0.10
*** HOLE CARDS ***
Dealt to warioman [Ad Ts]
Player#3063: raises $0.10 to $0.3
Player#4623: folds
warioman: folds
Player#4051: folds
Player#3194: calls $0.20
*** FLOP *** [Qc 4h 4s]
Player#3194: checks
Player#3063: checks
*** TURN *** [Qc 4h 4s] [7h]
Player#3194: bets $0.30
Player#3063: folds
Player#3194: doesn't show hand
Uncalled bet ($0.30) returned to Player#3194
Player#3194 collected $0.62 from pot
*** SUMMARY ***
Total Pot $0.65 | Rake $0.03
Board [Qc 4h 4s 7h]
Seat 1: Player#3063 folded on the turn
Seat 2: Player#4623 folded before the flop
Seat 3: warioman (button) folded before the flop
Seat 4: Player#4051 (small blind) folded before the flop
Seat 5: Player#3194 shows [] and won ($0.62) with 

PokerStars Hand #b172ee37-eff4-40f5-9be7-bb646b6111a3:  Hold'em No Limit ($0.1/$0.20 USD) - 2021/11/20 10:33:00 ET
Table 'Bel Air' 6-max Seat #1 is the button
Seat 1: Player#1462 ($11.96 in chips)
Seat 2: Player#0941 ($24.75 in chips)
Seat 3: warioman ($25.70 in chips)
Seat 4: Player#2111 ($13.13 in chips)
Seat 5: Player#0666 ($17.19 in chips)
Seat 6: Player#9164 ($19.50 in chips)
Player#0941: posts small blind $0.10
warioman: posts big blind $0.20
*** HOLE CARDS ***
Dealt to warioman [7d Qs]
Player#2111: folds
Player#0666: folds
Player#9164: folds
Player#1462: calls $0.20
Player#0941: folds
warioman: checks
*** FLOP *** [3s Th Qc]
warioman: checks
Player#1462: bets $0.40
warioman: calls $0.40
*** TURN *** [3s Th Qc] [4h]
warioman: checks
Player#1462: bets $0.40
warioman: calls $0.40
*** RIVER *** [3s Th Qc] [4h] [9h]
warioman: checks
Player#1462: bets $2.10
warioman: folds
Player#1462: doesn't show hand
Uncalled bet ($2.10) returned to Player#1462
Player#1462 collected $2.00 from pot
*** SUMMARY ***
Total Pot $2.10 | Rake $0.11
Board [3s Th Qc 4h 9h]
Seat 1: Player#1462 shows [] and won ($2.00) with 
Seat 2: Player#0941 (small blind) folded before the flop
Seat 3: warioman (big blind) folded on the river
Seat 4: Player#2111 folded before the flop
Seat 5: Player#0666 folded before the flop
Seat 6: Player#9164 folded before the flop

PokerStars Hand #7cb414e6-5b53-4242-84ef-ed85c24422f6:  Hold'em No Limit ($0.05/$0.10 USD) - 2021/11/20 10:33:00 ET
Table 'Aberdeen' 6-max Seat #3 is the button
Seat 1: Player#3731 ($11.18 in chips)
Seat 2: Player#9806 ($9.41 in chips)
Seat 3: warioman ($10.91 in chips)
Seat 4: Player#5794 ($5.66 in chips)
Seat 5: Player#5576 ($5.62 in chips)
Player#5794: posts small blind $0.05
Player#9806: posts big blind $0.10
*** HOLE CARDS ***
Dealt to warioman [3c 4h]
Player#5576: calls $0.10
Player#3731: folds
Player#9806: folds
warioman: folds
Player#5794: checks
*** FLOP *** [5s 6d 4s]
Player#5794: checks
Player#5576: bets $0.20
Player#5794: folds
Player#5576: doesn't show hand
Uncalled bet ($0.20) returned to Player#5576
Player#5576 collected $0.19 from pot
*** SUMMARY ***
Total Pot $0.20 | Rake $0.01
Board [5s 6d 4s]
Seat 1: Player#3731 folded before the flop
Seat 2: Player#9806 (big blind) folded before the flop
Seat 3: warioman (button) folded before the flop
Seat 4: Player#5794 (small blind) folded on the flop
Seat 5: Player#5576 shows [] and won ($0.19) with 

PokerStars Hand #70c919f4-2999-45ba-aa3c-96be144aeb8f:  Hold'em No Limit ($0.1/$0.20 USD) - 2021/11/20 10:32:00 ET
Table 'Bel Air' 6-max Seat #6 is the button
Seat 1: Player#8328 ($12.06 in chips)
Seat 2: Player#5451 ($23.68 in chips)
Seat 3: warioman ($25.70 in chips)
Seat 4: Player#0498 ($13.13 in chips)
Seat 5: Player#8833 ($18.27 in chips)
Seat 6: Player#0613 ($19.50 in chips)
Player#8328: posts small blind $0.10
Player#5451: posts big blind $0.20
*** HOLE CARDS ***
Dealt to warioman [8d 9c]
warioman: folds
Player#0498: folds
Player#8833: raises $0.20 to $0.4
Player#0613: folds
Player#8328: folds
Player#5451: calls $0.20
*** FLOP *** [Ah Ad 8h]
Player#5451: checks
Player#8833: checks
*** TURN *** [Ah Ad 8h] [3s]
Player#5451: checks
Player#8833: bets $0.68
Player#5451: calls $0.68
*** RIVER *** [Ah Ad 8h] [3s] [9s]
Player#5451: checks
Player#8833: checks
*** SHOW DOWN *** 
Player#5451 collected $2.15 from pot
*** SUMMARY ***
Total Pot $2.26 | Rake $0.11
Board [Ah Ad 8h 3s 9s]
Seat 1: Player#8328 (small blind) folded before the flop
Seat 2: Player#5451 shows [5h Ac] and won ($2.15) with 
Seat 3: warioman folded before the flop
Seat 4: Player#0498 folded before the flop
Seat 5: Player#8833 mucked
Seat 6: Player#0613 (button) folded before the flop

PokerStars Hand #6193e296-814c-4466-8c14-9044fc663d20:  Hold'em No Limit ($0.05/$0.10 USD) - 2021/11/20 10:32:00 ET
Table 'Aberdeen' 6-max Seat #2 is the button
Seat 1: Player#8037 ($11.18 in chips)
Seat 2: Player#6407 ($9.41 in chips)
Seat 3: warioman ($10.96 in chips)
Seat 4: Player#7500 ($1.85 in chips)
Seat 5: Player#0440 ($5.66 in chips)
Seat 6: Player#2324 ($3.90 in chips)
warioman: posts small blind $0.05
Player#7500: posts big blind $0.10
*** HOLE CARDS ***
Dealt to warioman [9s Kh]
Player#0440: folds
Player#2324: calls $0.10
Player#8037: folds
Player#6407: folds
warioman: folds
Player#7500: raises $0.10 to $1.85
Player#2324: calls $1.75
Player#7500 Showing Pocket Cards J4
Player#2324 Showing Pocket Cards 4A
*** FLOP *** [8c Qs 6c]
*** TURN *** [8c Qs 6c] [Kc]
*** RIVER *** [8c Qs 6c] [Kc] [9c]
Player#2324 collected $3.56 from pot
*** SUMMARY ***
Total Pot $3.75 | Rake $0.19
Board [8c Qs 6c Kc 9c]
Seat 1: Player#8037 folded before the flop
Seat 2: Player#6407 (button) folded before the flop
Seat 3: warioman (small blind) folded before the flop
Seat 4: Player#7500 (big blind) mucked
Seat 5: Player#0440 folded before the flop
Seat 6: Player#2324 shows [4c As] and won ($3.56) with 

PokerStars Hand #c3c08c2b-cf13-49d2-90b0-ae634c8a61af:  Hold'em No Limit ($0.05/$0.10 USD) - 2021/11/20 10:31:00 ET
Table 'Aberdeen' 6-max Seat #1 is the button
Seat 1: Player#9246 ($11.18 in chips)
Seat 2: Player#8923 ($9.46 in chips)
Seat 3: warioman ($11.06 in chips)
Seat 4: Player#7816 ($4.70 in chips)
Seat 5: Player#3661 ($2.85 in chips)
Seat 6: Player#5312 ($4.00 in chips)
Player#8923: posts small blind $0.05
warioman: posts big blind $0.10
*** HOLE CARDS ***
Dealt to warioman [3d 3h]
Player#5312 Entry Bet 0.1
Player#7816: raises0.10 to $1
Player#3661: calls $1.00
Player#5312: folds
Player#9246: folds
Player#8923: folds
warioman: folds
*** FLOP *** [Td 8h 4s]
Player#7816: bets $1.00
Player#3661: calls $1.00
*** TURN *** [Td 8h 4s] [9d]
Player#7816: bets $0.90
Player#3661: calls $0.85
Player#7816 Showing Pocket Cards 66
Player#3661 Showing Pocket Cards 77
*** RIVER *** [Td 8h 4s] [9d] [Kh]
Player#3661 collected $5.61 from pot
*** SUMMARY ***
Total Pot $5.90 | Rake $0.30
Board [Td 8h 4s 9d Kh]
Seat 1: Player#9246 (button) folded before the flop
Seat 2: Player#8923 (small blind) folded before the flop
Seat 3: warioman (big blind) folded before the flop
Seat 4: Player#7816 mucked
Seat 5: Player#3661 shows [7s 7h] and won ($5.61) with 
Seat 6: Player#5312 folded before the flop

PokerStars Hand #a4b5e448-c113-4a7e-a547-802bb4e988f9:  Hold'em No Limit ($0.1/$0.20 USD) - 2021/11/20 10:31:00 ET
Table 'Bel Air' 6-max Seat #5 is the button
Seat 1: Player#3808 ($12.26 in chips)
Seat 2: Player#2071 ($23.68 in chips)
Seat 3: warioman ($25.70 in chips)
Seat 4: Player#9504 ($12.48 in chips)
Seat 5: Player#5950 ($18.67 in chips)
Seat 6: Player#3968 ($19.60 in chips)
Player#3968: posts small blind $0.10
Player#3808: posts big blind $0.20
*** HOLE CARDS ***
Dealt to warioman [As 7h]
Player#2071: folds
warioman: folds
Player#9504: calls $0.20
Player#5950: raises $0.20 to $0.4
Player#3968: folds
Player#3808: folds
Player#9504: calls $0.20
*** FLOP *** [4c 7s Jd]
Player#9504: checks
Player#5950: checks
*** TURN *** [4c 7s Jd] [Qd]
Player#9504: checks
Player#5950: checks
*** RIVER *** [4c 7s Jd] [Qd] [2d]
Player#9504: checks
Player#5950: checks
*** SHOW DOWN *** 
Player#9504 collected $1.05 from pot
*** SUMMARY ***
Total Pot $1.10 | Rake $0.06
Board [4c 7s Jd Qd 2d]
Seat 1: Player#3808 (big blind) folded before the flop
Seat 2: Player#2071 folded before the flop
Seat 3: warioman folded before the flop
Seat 4: Player#9504 shows [2d Kd] and won ($1.05) with 
Seat 5: Player#5950 (button) mucked
Seat 6: Player#3968 (small blind) folded before the flop

PokerStars Hand #cf99b51f-16c6-4e2f-ae21-969dc345f75f:  Hold'em No Limit ($0.05/$0.10 USD) - 2021/11/20 10:31:00 ET
Table 'Aberdeen' 6-max Seat #6 is the button
Seat 1: Player#7965 ($11.23 in chips)
Seat 2: Player#3871 ($9.56 in chips)
Seat 3: warioman ($11.06 in chips)
Seat 4: Player#9930 ($4.19 in chips)
Seat 5: Player#1458 ($3.25 in chips)
Player#7965: posts small blind $0.05
Player#3871: posts big blind $0.10
*** HOLE CARDS ***
Dealt to warioman [4d 4h]
warioman: folds
Player#9930: raises $0.10 to $0.4
Player#1458: calls $0.40
Player#7965: folds
Player#3871: folds
*** FLOP *** [6d 2s Qc]
Player#9930: bets $1.00
Player#1458: folds
Player#9930: doesn't show hand
Uncalled bet ($1.00) returned to Player#9930
Player#9930 collected $0.90 from pot
*** SUMMARY ***
Total Pot $0.95 | Rake $0.05
Board [6d 2s Qc]
Seat 1: Player#7965 (small blind) folded before the flop
Seat 2: Player#3871 (big blind) folded before the flop
Seat 3: warioman folded before the flop
Seat 4: Player#9930 shows [] and won ($0.90) with 
Seat 5: Player#1458 folded on the flop

PokerStars Hand #52a098db-606d-4bb9-9ee9-ba0ec30e0dcd:  Hold'em No Limit ($0.1/$0.20 USD) - 2021/11/20 10:30:00 ET
Table 'Bel Air' 6-max Seat #4 is the button
Seat 1: Player#2486 ($12.26 in chips)
Seat 2: Player#7353 ($23.68 in chips)
Seat 3: warioman ($25.70 in chips)
Seat 4: Player#5807 ($12.48 in chips)
Seat 5: Player#8406 ($18.31 in chips)
Seat 6: Player#5818 ($20.00 in chips)
Player#8406: posts small blind $0.10
Player#5818: posts big blind $0.20
*** HOLE CARDS ***
Dealt to warioman [5h 6c]
Player#2486: folds
Player#7353: folds
warioman: folds
Player#5807: folds
Player#8406: raises $0.20 to $0.4
Player#5818: calls $0.20
*** FLOP *** [Ad Td 3c]
Player#8406: checks
Player#5818: checks
*** TURN *** [Ad Td 3c] [7d]
Player#8406: bets $0.20
Player#5818: folds
Player#8406: doesn't show hand
Uncalled bet ($0.20) returned to Player#8406
Player#8406 collected $0.76 from pot
*** SUMMARY ***
Total Pot $0.80 | Rake $0.04
Board [Ad Td 3c 7d]
Seat 1: Player#2486 folded before the flop
Seat 2: Player#7353 folded before the flop
Seat 3: warioman folded before the flop
Seat 4: Player#5807 (button) folded before the flop
Seat 5: Player#8406 shows [] and won ($0.76) with 
Seat 6: Player#5818 (big blind) folded on the turn

PokerStars Hand #855b3b06-fd95-4914-bcaa-233306a33ae8:  Hold'em No Limit ($0.05/$0.10 USD) - 2021/11/20 10:30:00 ET
Table 'Aberdeen' 6-max Seat #4 is the button
Seat 1: Player#4692 ($11.33 in chips)
Seat 2: Player#6271 ($9.14 in chips)
Seat 3: warioman ($11.06 in chips)
Seat 4: Player#1634 ($4.49 in chips)
Seat 5: Player#5556 ($3.30 in chips)
Player#5556: posts small blind $0.05
Player#4692: posts big blind $0.10
*** HOLE CARDS ***
Dealt to warioman [5d Kd]
Player#6271: raises $0.10 to $0.3
warioman: folds
Player#1634: calls $0.30
Player#5556: folds
Player#4692: folds
*** FLOP *** [Qh 3d Js]
Player#6271: checks
Player#1634: checks
*** TURN *** [Qh 3d Js] [2s]
Player#6271: checks
Player#1634: checks
*** RIVER *** [Qh 3d Js] [2s] [6s]
Player#6271: checks
Player#1634: checks
*** SHOW DOWN *** 
Player#6271 collected $0.71 from pot
*** SUMMARY ***
Total Pot $0.75 | Rake $0.04
Board [Qh 3d Js 2s 6s]
Seat 1: Player#4692 (big blind) folded before the flop
Seat 2: Player#6271 shows [Ks 9h] and won ($0.71) with 
Seat 3: warioman folded before the flop
Seat 4: Player#1634 (button) mucked
Seat 5: Player#5556 (small blind) folded before the flop

PokerStars Hand #22501b12-6b6e-4839-a5d6-e17fbd9521b6:  Hold'em No Limit ($0.1/$0.20 USD) - 2021/11/20 10:29:00 ET
Table 'Bel Air' 6-max Seat #3 is the button
Seat 1: Player#0504 ($12.26 in chips)
Seat 2: Player#6791 ($23.68 in chips)
Seat 3: warioman ($25.70 in chips)
Seat 4: Player#6648 ($11.94 in chips)
Seat 5: Player#5986 ($18.91 in chips)
Player#6648: posts small blind $0.10
Player#5986: posts big blind $0.20
*** HOLE CARDS ***
Dealt to warioman [9d 7s]
Player#0504: folds
Player#6791: folds
warioman: folds
Player#6648: raises $0.20 to $0.6
Player#5986: calls $0.40
*** FLOP *** [8h Ah 5s]
Player#6648: bets $0.40
Player#5986: folds
Player#6648: doesn't show hand
Uncalled bet ($0.40) returned to Player#6648
Player#6648 collected $1.14 from pot
*** SUMMARY ***
Total Pot $1.20 | Rake $0.06
Board [8h Ah 5s]
Seat 1: Player#0504 folded before the flop
Seat 2: Player#6791 folded before the flop
Seat 3: warioman (button) folded before the flop
Seat 4: Player#6648 shows [] and won ($1.14) with 
Seat 5: Player#5986 (big blind) folded on the flop

PokerStars Hand #5ca88785-7b19-444e-877e-ca843ceb4523:  Hold'em No Limit ($0.05/$0.10 USD) - 2021/11/20 10:29:00 ET
Table 'Aberdeen' 6-max Seat #3 is the button
Seat 1: Player#3740 ($10.41 in chips)
Seat 2: Player#8389 ($10.00 in chips)
Seat 3: warioman ($11.06 in chips)
Seat 4: Player#3808 ($4.54 in chips)
Seat 5: Player#5601 ($3.40 in chips)
Seat 6: Player#7434 ($5.88 in chips)
Player#3808: posts small blind $0.05
Player#5601: posts big blind $0.10
*** HOLE CARDS ***
Dealt to warioman [7h Td]
Player#7434: folds
Player#3740: raises $0.10 to $0.3
Player#8389: calls $0.30
warioman: folds
Player#3808: folds
Player#5601: folds
*** FLOP *** [7c 5d 3c]
Player#3740: bets $0.56
Player#8389: calls $0.56
*** TURN *** [7c 5d 3c] [6d]
Player#3740: checks
Player#8389: checks
*** RIVER *** [7c 5d 3c] [6d] [3d]
Player#3740: bets $1.40
Player#8389: folds
Player#3740: doesn't show hand
Uncalled bet ($1.40) returned to Player#3740
Player#3740 collected $1.78 from pot
*** SUMMARY ***
Total Pot $1.87 | Rake $0.09
Board [7c 5d 3c 6d 3d]
Seat 1: Player#3740 shows [] and won ($1.78) with 
Seat 2: Player#8389 folded on the river
Seat 3: warioman (button) folded before the flop
Seat 4: Player#3808 (small blind) folded before the flop
Seat 5: Player#5601 (big blind) folded before the flop
Seat 6: Player#7434 folded before the flop

PokerStars Hand #37b6387d-010f-4c21-ac3d-95fb9b2e15c4:  Hold'em No Limit ($0.05/$0.10 USD) - 2021/11/20 10:29:00 ET
Table 'Aberdeen' 6-max Seat #2 is the button
Seat 1: Player#8588 ($10.41 in chips)
Seat 2: Player#9546 ($10.00 in chips)
Seat 3: warioman ($10.79 in chips)
Seat 4: Player#8900 ($4.84 in chips)
Seat 5: Player#6868 ($3.40 in chips)
Seat 6: Player#9523 ($5.88 in chips)
warioman: posts small blind $0.05
Player#8900: posts big blind $0.10
*** HOLE CARDS ***
Dealt to warioman [Ac 2h]
Player#6868: folds
Player#9523: folds
Player#8588: folds
Player#9546: folds
warioman: raises $0.10 to $0.3
Player#8900: calls $0.20
*** FLOP *** [Qc 4d Kc]
warioman: bets $0.45
Player#8900: folds
warioman: doesn't show hand
Uncalled bet ($0.45) returned to warioman
warioman collected $0.57 from pot
*** SUMMARY ***
Total Pot $0.60 | Rake $0.03
Board [Qc 4d Kc]
Seat 1: Player#8588 folded before the flop
Seat 2: Player#9546 (button) folded before the flop
Seat 3: warioman (small blind)
Seat 4: Player#8900 (big blind) folded on the flop
Seat 5: Player#6868 folded before the flop
Seat 6: Player#9523 folded before the flop

PokerStars Hand #19d4af1b-9c44-4eb1-b64b-12ef1d1fd6a2:  Hold'em No Limit ($0.05/$0.10 USD) - 2021/11/20 10:28:00 ET
Table 'Aberdeen' 6-max Seat #1 is the button
Seat 1: Player#5950 ($10.41 in chips)
Seat 2: Player#7983 ($10.05 in chips)
Seat 3: warioman ($10.00 in chips)
Seat 4: Player#9162 ($5.24 in chips)
Seat 5: Player#4217 ($3.80 in chips)
Seat 6: Player#2013 ($5.88 in chips)
Player#7983: posts small blind $0.05
warioman: posts big blind $0.10
*** HOLE CARDS ***
Dealt to warioman [3h Jc]
Player#9162: calls $0.10
Player#4217: calls $0.10
Player#2013: folds
Player#5950: folds
Player#7983: folds
warioman: checks
*** FLOP *** [2d 3c 5d]
warioman: checks
Player#9162: bets $0.10
Player#4217: calls $0.10
warioman: calls $0.10
*** TURN *** [2d 3c 5d] [7s]
warioman: checks
Player#9162: bets $0.10
Player#4217: calls $0.10
warioman: calls $0.10
*** RIVER *** [2d 3c 5d] [7s] [3s]
warioman: checks
Player#9162: bets $0.10
Player#4217: calls $0.10
warioman: calls $0.10
*** SHOW DOWN *** 
Player#4217: doesn't show hand
warioman collected $1.19 from pot
*** SUMMARY ***
Total Pot $1.25 | Rake $0.06
Board [2d 3c 5d 7s 3s]
Seat 1: Player#5950 (button) folded before the flop
Seat 2: Player#7983 (small blind) folded before the flop
Seat 3: warioman (big blind)
Seat 4: Player#9162 mucked
Seat 5: Player#4217 mucked
Seat 6: Player#2013 folded before the flop

PokerStars Hand #a97f6e1e-64e1-46fd-93f8-c3c134ba2fa6:  Hold'em No Limit ($0.1/$0.20 USD) - 2021/11/20 10:28:00 ET
Table 'Bel Air' 6-max Seat #2 is the button
Seat 1: Player#3330 ($12.46 in chips)
Seat 2: Player#7840 ($21.00 in chips)
Seat 3: warioman ($25.80 in chips)
Seat 4: Player#9158 ($12.14 in chips)
Seat 5: Player#2847 ($21.36 in chips)
warioman: posts small blind $0.10
Player#9158: posts big blind $0.20
*** HOLE CARDS ***
Dealt to warioman [4s Ad]
Player#2847: calls $0.20
Player#3330: calls $0.20
Player#7840: raises0.20 to $1
warioman: folds
Player#9158: folds
Player#2847: calls $0.80
Player#3330: folds
*** FLOP *** [2c 5s 2h]
Player#2847: checks
Player#7840: bets $1.45
Player#2847: calls $1.45
*** TURN *** [2c 5s 2h] [7s]
Player#2847: checks
Player#7840: bets $2.70
Player#2847: folds
Player#7840: doesn't show hand
Uncalled bet ($2.70) returned to Player#7840
Player#7840 collected $5.13 from pot
*** SUMMARY ***
Total Pot $5.40 | Rake $0.27
Board [2c 5s 2h 7s]
Seat 1: Player#3330 folded before the flop
Seat 2: Player#7840 shows [] and won ($5.13) with 
Seat 3: warioman (small blind) folded before the flop
Seat 4: Player#9158 (big blind) folded before the flop
Seat 5: Player#2847 folded on the turn

PokerStars Hand #d5c787db-f5a7-4e4d-95df-6f11aad50443:  Hold'em No Limit ($0.05/$0.10 USD) - 2021/11/20 10:28:00 ET
Table 'Aberdeen' 6-max Seat #6 is the button
Seat 1: Player#4170 ($10.46 in chips)
Seat 2: Player#7034 ($10.00 in chips)
Seat 3: warioman ($10.00 in chips)
Seat 4: Player#6183 ($5.24 in chips)
Seat 5: Player#6964 ($3.80 in chips)
Seat 6: Player#8616 ($5.88 in chips)
Player#4170: posts small blind $0.05
Player#7034: posts big blind $0.10
*** HOLE CARDS ***
Dealt to warioman [7d Ks]
warioman: folds
Player#6183: folds
Player#6964: folds
Player#8616: folds
Player#4170: folds
Player#7034 collected $0.10 from pot
*** SUMMARY ***
Total Pot $0.10 | Rake $0.00
Seat 1: Player#4170 (small blind) folded before the flop
Seat 2: Player#7034 shows [] and won ($0.10) with 
Seat 3: warioman folded before the flop
Seat 4: Player#6183 folded before the flop
Seat 5: Player#6964 folded before the flop
Seat 6: Player#8616 (button) folded before the flop

PokerStars Hand #4d8fd597-603c-41ec-a3c6-95c679b93f26:  Hold'em No Limit ($0.05/$0.10 USD) - 2021/11/20 10:27:00 ET
Table 'Aberdeen' 6-max Seat #1 is the button
Seat 1: Player#5907 ($10.00 in chips)
Seat 2: Player#4986 ($10.00 in chips)
Seat 3: warioman ($10.00 in chips)
Seat 4: Player#9974 ($5.64 in chips)
Seat 5: Player#4958 ($3.80 in chips)
Seat 6: Player#1662 ($5.98 in chips)
Player#4986: posts small blind $0.05
Player#1662: posts big blind $0.10
*** HOLE CARDS ***
Dealt to warioman [Ah 7c]
Player#4986 Waiting
warioman: folds
Player#9974: calls $0.10
Player#4958: folds
Player#1662: calls $0.05
Player#5907: raises $0.10 to $0.4
Player#9974: calls $0.30
Player#1662: folds
*** FLOP *** [7s Qh 8d]
Player#5907: bets $0.68
Player#9974: folds
Player#5907: doesn't show hand
Uncalled bet ($0.68) returned to Player#5907
Player#5907 collected $0.85 from pot
*** SUMMARY ***
Total Pot $0.90 | Rake $0.05
Board [7s Qh 8d]
Seat 1: Player#5907 shows [] and won ($0.85) with 
Seat 2: Player#4986 (small blind) mucked
Seat 3: warioman folded before the flop
Seat 4: Player#9974 folded on the flop
Seat 5: Player#4958 folded before the flop
Seat 6: Player#1662 (big blind) folded before the flop

PokerStars Hand #8624d8c0-31bf-4377-bc1f-cfaf5adbd04c:  Hold'em No Limit ($0.1/$0.20 USD) - 2021/11/20 10:27:00 ET
Table 'Bel Air' 6-max Seat #1 is the button
Seat 1: Player#7474 ($12.46 in chips)
Seat 2: Player#1210 ($21.40 in chips)
Seat 3: warioman ($26.20 in chips)
Seat 4: Player#8149 ($12.14 in chips)
Seat 5: Player#4371 ($20.62 in chips)
Player#1210: posts small blind $0.10
warioman: posts big blind $0.20
*** HOLE CARDS ***
Dealt to warioman [Ad 8c]
Player#8149: folds
Player#4371: raises $0.20 to $0.4
Player#7474: folds
Player#1210: calls $0.30
warioman: calls $0.20
*** FLOP *** [Kd 2h Qs]
Player#1210: checks
warioman: checks
Player#4371: bets $1.00
Player#1210: folds
warioman: folds
Player#4371: doesn't show hand
Uncalled bet ($1.00) returned to Player#4371
Player#4371 collected $1.14 from pot
*** SUMMARY ***
Total Pot $1.20 | Rake $0.06
Board [Kd 2h Qs]
Seat 1: Player#7474 (button) folded before the flop
Seat 2: Player#1210 (small blind) folded on the flop
Seat 3: warioman (big blind) folded on the flop
Seat 4: Player#8149 folded before the flop
Seat 5: Player#4371 shows [] and won ($1.14) with 

PokerStars Hand #c0eeaccd-cf68-439f-8291-39ad6247cf9b:  Hold'em No Limit ($0.05/$0.10 USD) - 2021/11/20 10:26:00 ET
Table 'Aberdeen' 6-max Seat #1 is the button
Seat 1: Player#9528 ($10.00 in chips)
Seat 2: Player#2150 ($10.00 in chips)
Seat 3: warioman ($10.00 in chips)
Seat 4: Player#1630 ($4.64 in chips)
Seat 5: Player#4827 ($3.90 in chips)
Seat 6: Player#6430 ($6.98 in chips)
Player#2150: posts small blind $0.05
Player#4827: posts big blind $0.10
*** HOLE CARDS ***
Dealt to warioman [Kc 2d]
Player#2150 Waiting
Player#9528: folds
warioman: folds
Player#1630: calls $0.10
Player#4827: calls $0.05
Player#6430: checks
*** FLOP *** [Qc Ts 4d]
Player#4827: folds
Player#6430: bets $0.20
Player#1630: calls $0.20
*** TURN *** [Qc Ts 4d] [5h]
Player#6430: bets $0.30
Player#1630: calls $0.30
*** RIVER *** [Qc Ts 4d] [5h] [Kh]
Player#6430: bets $0.40
Player#1630: calls $0.40
*** SHOW DOWN *** 
Player#1630 collected $2.00 from pot
*** SUMMARY ***
Total Pot $2.10 | Rake $0.11
Board [Qc Ts 4d 5h Kh]
Seat 1: Player#9528 (button) folded before the flop
Seat 2: Player#2150 (small blind) mucked
Seat 3: warioman folded before the flop
Seat 4: Player#1630 shows [Qd 9c] and won ($2.00) with 
Seat 5: Player#4827 (big blind) folded on the flop
Seat 6: Player#6430 mucked

PokerStars Hand #85445bf4-7b9d-46e0-b8ef-199d93dedd88:  Hold'em No Limit ($0.05/$0.10 USD) - 2021/11/20 10:26:00 ET
Table 'Aberdeen' 6-max Seat #1 is the button
Seat 1: Player#3804 ($10.00 in chips)
Seat 2: Player#7091 ($10.00 in chips)
Seat 3: warioman ($10.00 in chips)
Seat 4: Player#2615 ($4.45 in chips)
Seat 5: Player#8657 ($4.00 in chips)
Seat 6: Player#4260 ($7.08 in chips)
Player#7091: posts small blind $0.05
Player#2615: posts big blind $0.10
*** HOLE CARDS ***
Dealt to warioman [9h Ks]
Player#7091 Waiting
Player#4260: calls $0.10
Player#3804: folds
warioman: folds
Player#2615: calls $0.05
Player#8657: checks
*** FLOP *** [3d Jc As]
Player#2615: bets $0.10
Player#8657: folds
Player#4260: folds
Player#2615: doesn't show hand
Uncalled bet ($0.10) returned to Player#2615
Player#2615 collected $0.29 from pot
*** SUMMARY ***
Total Pot $0.30 | Rake $0.02
Board [3d Jc As]
Seat 1: Player#3804 (button) folded before the flop
Seat 2: Player#7091 (small blind) mucked
Seat 3: warioman folded before the flop
Seat 4: Player#2615 shows [] and won ($0.29) with 
Seat 5: Player#8657 folded on the flop
Seat 6: Player#4260 folded on the flop

PokerStars Hand #cb139b73-0bb0-48b7-b9ba-8af58eed0cc6:  Hold'em No Limit ($0.1/$0.20 USD) - 2021/11/20 10:25:00 ET
Table 'Bel Air' 6-max Seat #6 is the button
Seat 1: Player#9881 ($12.56 in chips)
Seat 2: Player#0458 ($21.90 in chips)
Seat 3: warioman ($26.70 in chips)
Seat 4: Player#6602 ($12.14 in chips)
Seat 5: Player#0168 ($19.60 in chips)
Player#9881: posts small blind $0.10
Player#0458: posts big blind $0.20
*** HOLE CARDS ***
Dealt to warioman [8d 8s]
warioman: raises $0.20 to $0.5
Player#6602: folds
Player#0168: calls $0.50
Player#9881: folds
Player#0458: calls $0.30
*** FLOP *** [Kc Ah 6d]
Player#0458: checks
warioman: checks
Player#0168: checks
*** TURN *** [Kc Ah 6d] [3c]
Player#0458: checks
warioman: checks
Player#0168: bets $0.40
Player#0458: folds
warioman: folds
Player#0168: doesn't show hand
Uncalled bet ($0.40) returned to Player#0168
Player#0168 collected $1.52 from pot
*** SUMMARY ***
Total Pot $1.60 | Rake $0.08
Board [Kc Ah 6d 3c]
Seat 1: Player#9881 (small blind) folded before the flop
Seat 2: Player#0458 (big blind) folded on the turn
Seat 3: warioman folded on the turn
Seat 4: Player#6602 folded before the flop
Seat 5: Player#0168 shows [] and won ($1.52) with 

PokerStars Hand #ca0c634b-7232-49e7-9114-d9aee258cc10:  Hold'em No Limit ($0.05/$0.10 USD) - 2021/11/20 10:25:00 ET
Table 'Aberdeen' 6-max Seat #3 is the button
Seat 1: Player#9445 ($10.00 in chips)
Seat 2: warioman ($9.90 in chips)
Seat 3: Player#8568 ($3.81 in chips)
Seat 4: Player#1217 ($4.00 in chips)
Seat 5: Player#4617 ($7.18 in chips)
Player#1217: posts small blind $0.05
warioman: posts big blind $0.10
*** HOLE CARDS ***
Dealt to warioman [Ts Jh]
Player#1217 Waiting
Player#4617: calls $0.10
Player#9445: folds
warioman: calls $0.05
Player#8568: raises $0.10 to $0.3
Player#4617: folds
warioman: calls $0.20
*** FLOP *** [9c 6d 8d]
warioman: checks
Player#8568: bets $0.30
warioman: calls $0.30
*** TURN *** [9c 6d 8d] [8c]
warioman: checks
Player#8568: bets $0.40
warioman: folds
Player#8568: doesn't show hand
Uncalled bet ($0.40) returned to Player#8568
Player#8568 collected $1.24 from pot
*** SUMMARY ***
Total Pot $1.30 | Rake $0.07
Board [9c 6d 8d 8c]
Seat 1: Player#9445 folded before the flop
Seat 2: warioman (big blind) folded on the turn
Seat 3: Player#8568 shows [] and won ($1.24) with 
Seat 4: Player#1217 (small blind) mucked
Seat 5: Player#4617 folded before the flop

PokerStars Hand #302fb5f1-b926-4e55-8be1-6af0ac45a548:  Hold'em No Limit ($0.1/$0.20 USD) - 2021/11/20 10:24:00 ET
Table 'Bel Air' 6-max Seat #4 is the button
Seat 1: Player#1976 ($12.20 in chips)
Seat 2: Player#9350 ($21.90 in chips)
Seat 3: warioman ($26.70 in chips)
Seat 4: Player#4528 ($12.14 in chips)
Seat 5: Player#8224 ($20.00 in chips)
Seat 6: Player#5960 ($19.60 in chips)
Player#8224: posts small blind $0.10
Player#1976: posts big blind $0.20
*** HOLE CARDS ***
Dealt to warioman [3c Ah]
Player#5960 Decline Entry Bet
Player#9350: folds
warioman: folds
Player#4528: folds
Player#8224: raises $0.20 to $0.4
Player#1976: calls $0.20
*** FLOP *** [7h 9d 9c]
Player#8224: checks
Player#1976: checks
*** TURN *** [7h 9d 9c] [4d]
Player#8224: checks
Player#1976: bets $0.60
Player#8224: folds
Player#1976: doesn't show hand
Uncalled bet ($0.60) returned to Player#1976
Player#1976 collected $0.76 from pot
*** SUMMARY ***
Total Pot $0.80 | Rake $0.04
Board [7h 9d 9c 4d]
Seat 1: Player#1976 shows [] and won ($0.76) with 
Seat 2: Player#9350 folded before the flop
Seat 3: warioman folded before the flop
Seat 4: Player#4528 (button) folded before the flop
Seat 5: Player#8224 (small blind) folded on the turn
Seat 6: Player#5960 mucked

PokerStars Hand #5a8d651b-f74c-496d-bfa7-b005ceb24e65:  Hold'em No Limit ($0.05/$0.10 USD) - 2021/11/20 10:24:00 ET
Table 'Aberdeen' 6-max Seat #6 is the button
Seat 1: Player#5312 ($9.90 in chips)
Seat 2: warioman ($10.00 in chips)
Seat 3: Player#2479 ($4.71 in chips)
Seat 4: Player#5006 ($6.22 in chips)
Player#5312: posts small blind $0.05
warioman: posts big blind $0.10
*** HOLE CARDS ***
Dealt to warioman [4c Qd]
Player#2479: calls $0.10
Player#5006: calls $0.10
Player#5312: folds
warioman: checks
*** FLOP *** [Td 3s Jd]
warioman: checks
Player#2479: bets $0.10
Player#5006: raises $0.10 to $0.3
warioman: folds
Player#2479: calls $0.20
*** TURN *** [Td 3s Jd] [Kc]
Player#2479: bets $0.10
Player#5006: raises $0.10 to $0.4
Player#2479: calls $0.30
*** RIVER *** [Td 3s Jd] [Kc] [Kc]
Player#2479: bets $0.10
Player#5006: calls $0.10
*** SHOW DOWN *** 
Player#5006 collected $1.85 from pot
*** SUMMARY ***
Total Pot $1.95 | Rake $0.10
Board [Td 3s Jd Kc Kc]
Seat 1: Player#5312 (small blind) folded before the flop
Seat 2: warioman (big blind) folded on the flop
Seat 3: Player#2479 mucked
Seat 4: Player#5006 shows [Jh 6s] and won ($1.85) with 

PokerStars Hand #c1e99cee-8b94-490b-9e1c-cb6a80909f15:  Hold'em No Limit ($0.05/$0.10 USD) - 2021/11/20 10:24:00 ET
Table 'Aberdeen' 6-max Seat #1 is the button
Seat 1: Player#2652 ($10.00 in chips)
Seat 2: warioman ($10.00 in chips)
Seat 3: Player#7609 ($4.71 in chips)
Seat 4: Player#0336 ($6.13 in chips)
warioman: posts small blind $0.05
Player#0336: posts big blind $0.10
*** HOLE CARDS ***
Dealt to warioman []
warioman Waiting
Player#7609: folds
Player#0336: calls $0.05
Player#2652: checks
*** FLOP *** [Qh Jc 3s]
Player#0336: bets $0.10
Player#2652: folds
Player#0336: doesn't show hand
Uncalled bet ($0.10) returned to Player#0336
Player#0336 collected $0.19 from pot
*** SUMMARY ***
Total Pot $0.20 | Rake $0.01
Board [Qh Jc 3s]
Seat 1: Player#2652 (button) folded on the flop
Seat 2: warioman (small blind)
Seat 3: Player#7609 folded before the flop
Seat 4: Player#0336 shows [] and won ($0.19) with 

PokerStars Hand #373fdac1-d3a7-4f77-bc75-0c6a552508a6:  Hold'em No Limit ($0.05/$0.10 USD) - 2021/11/20 10:23:00 ET
Table 'Tempe' 6-max Seat #1 is the button
Seat 1: warioman ($13.20 in chips)
Seat 2: Player#2932 ($15.80 in chips)
Player#2932: posts small blind $0.05
warioman: posts big blind $0.10
*** HOLE CARDS ***
Dealt to warioman [5s Qc]
Player#2932: raises $0.10 to $0.3
warioman: folds
Player#2932: doesn't show hand
Uncalled bet ($0.30) returned to Player#2932
Player#2932 collected $0.10 from pot
*** SUMMARY ***
Total Pot $0.10 | Rake $0.00
Seat 1: warioman (big blind) folded before the flop
Seat 2: Player#2932 shows [] and won ($0.10) with 

PokerStars Hand #ccb2bcf1-4c1e-42fb-89a5-63d92bf2facd:  Hold'em No Limit ($0.1/$0.20 USD) - 2021/11/20 10:23:00 ET
Table 'Bel Air' 6-max Seat #3 is the button
Seat 1: Player#5011 ($12.20 in chips)
Seat 2: Player#9213 ($22.10 in chips)
Seat 3: warioman ($26.70 in chips)
Seat 4: Player#2361 ($12.54 in chips)
Seat 5: Player#7919 ($17.02 in chips)
Seat 6: Player#7826 ($19.60 in chips)
Player#2361: posts small blind $0.10
Player#7919: posts big blind $0.20
*** HOLE CARDS ***
Dealt to warioman [9s Ad]
Player#7826: folds
Player#5011: folds
Player#9213: calls $0.20
warioman: folds
Player#2361: calls $0.10
Player#7919: checks
*** FLOP *** [4c 2d 8h]
Player#2361: checks
Player#7919: checks
Player#9213: checks
*** TURN *** [4c 2d 8h] [7d]
Player#2361: checks
Player#7919: checks
Player#9213: checks
*** RIVER *** [4c 2d 8h] [7d] [Qd]
Player#2361: checks
Player#7919: bets $0.20
Player#9213: folds
Player#2361: calls $0.20
*** SHOW DOWN *** 
Player#2361: doesn't show hand
Player#7919 collected $0.95 from pot
*** SUMMARY ***
Total Pot $1.00 | Rake $0.05
Board [4c 2d 8h 7d Qd]
Seat 1: Player#5011 folded before the flop
Seat 2: Player#9213 folded on the river
Seat 3: warioman (button) folded before the flop
Seat 4: Player#2361 (small blind) mucked
Seat 5: Player#7919 shows [5h Qs] and won ($0.95) with 
Seat 6: Player#7826 folded before the flop

PokerStars Hand #aa779b80-a74f-4997-aea9-4bbfdcffab9b:  Hold'em No Limit ($0.1/$0.20 USD) - 2021/11/20 10:23:00 ET
Table 'Bel Air' 6-max Seat #2 is the button
Seat 1: Player#5235 ($12.20 in chips)
Seat 2: Player#6266 ($22.70 in chips)
Seat 3: warioman ($25.90 in chips)
Seat 4: Player#2891 ($12.74 in chips)
Seat 5: Player#0104 ($17.02 in chips)
Seat 6: Player#2510 ($19.60 in chips)
warioman: posts small blind $0.10
Player#2891: posts big blind $0.20
*** HOLE CARDS ***
Dealt to warioman [Ts Qs]
Player#0104: folds
Player#2510: folds
Player#5235: folds
Player#6266: raises $0.20 to $0.6
warioman: raises $0.60 to $2.4
Player#2891: folds
Player#6266: folds
warioman: doesn't show hand
Uncalled bet ($2.40) returned to warioman
warioman collected $0.80 from pot
*** SUMMARY ***
Total Pot $0.80 | Rake $0.00
Seat 1: Player#5235 folded before the flop
Seat 2: Player#6266 (button) folded before the flop
Seat 3: warioman (small blind)
Seat 4: Player#2891 (big blind) folded before the flop
Seat 5: Player#0104 folded before the flop
Seat 6: Player#2510 folded before the flop

PokerStars Hand #d50ddbe7-5f8a-410c-8131-dfdd95e06bc8:  Hold'em No Limit ($0.05/$0.10 USD) - 2021/11/20 10:23:00 ET
Table 'Tempe' 6-max Seat #1 is the button
Seat 1: Player#2154 ($10.14 in chips)
Seat 2: warioman ($13.11 in chips)
Seat 3: Player#2888 ($15.90 in chips)
warioman: posts small blind $0.05
Player#2888: posts big blind $0.10
*** HOLE CARDS ***
Dealt to warioman [4d 6d]
Player#2154: folds
warioman: calls $0.05
Player#2888: checks
*** FLOP *** [9h 7s 3h]
warioman: checks
Player#2888: checks
*** TURN *** [9h 7s 3h] [8s]
warioman: bets $0.10
Player#2888: folds
warioman: doesn't show hand
Uncalled bet ($0.10) returned to warioman
warioman collected $0.19 from pot
*** SUMMARY ***
Total Pot $0.20 | Rake $0.01
Board [9h 7s 3h 8s]
Seat 1: Player#2154 (button) folded before the flop
Seat 2: warioman (small blind)
Seat 3: Player#2888 (big blind) folded on the turn

PokerStars Hand #79798f06-9c18-448a-bea8-0d65d82b60e1:  Hold'em No Limit ($0.05/$0.10 USD) - 2021/11/20 10:22:00 ET
Table 'Tempe' 6-max Seat #6 is the button
Seat 1: Player#1792 ($10.05 in chips)
Seat 2: warioman ($13.21 in chips)
Seat 3: Player#5571 ($15.90 in chips)
Player#1792: posts small blind $0.05
warioman: posts big blind $0.10
*** HOLE CARDS ***
Dealt to warioman [4c 3d]
Player#5571: folds
Player#1792: calls $0.05
warioman: checks
*** FLOP *** [As 4s Jh]
Player#1792: bets $0.10
warioman: folds
Player#1792: doesn't show hand
warioman: doesn't show hand
Player#5571: doesn't show hand
Uncalled bet ($0.10) returned to Player#1792
Player#1792 collected $0.19 from pot
*** SUMMARY ***
Total Pot $0.20 | Rake $0.01
Board [As 4s Jh]
Seat 1: Player#1792 shows [] and won ($0.19) with 
Seat 2: warioman (big blind) folded on the flop
Seat 3: Player#5571 folded before the flop

PokerStars Hand #bb17a7b8-e179-47dd-a0dd-839390bc2b10:  Hold'em No Limit ($0.05/$0.10 USD) - 2021/11/20 10:22:00 ET
Table 'Tempe' 6-max Seat #6 is the button
Seat 1: Player#5235 ($35.93 in chips)
Seat 2: Player#9098 ($10.00 in chips)
Seat 3: warioman ($13.21 in chips)
Seat 4: Player#3395 ($15.90 in chips)
Player#5235: posts small blind $0.05
Player#9098: posts big blind $0.10
*** HOLE CARDS ***
Dealt to warioman [9h 2d]
warioman: folds
Player#3395: folds
Player#5235: folds
Player#9098 collected $0.10 from pot
*** SUMMARY ***
Total Pot $0.10 | Rake $0.00
Seat 1: Player#5235 (small blind) folded before the flop
Seat 2: Player#9098 shows [] and won ($0.10) with 
Seat 3: warioman folded before the flop
Seat 4: Player#3395 folded before the flop

PokerStars Hand #9d8c51aa-c47f-46c6-b4df-e93ed7a260de:  Hold'em No Limit ($0.05/$0.10 USD) - 2021/11/20 10:22:00 ET
Table 'Tempe' 6-max Seat #3 is the button
Seat 1: Player#7949 ($35.88 in chips)
Seat 2: Player#0452 ($10.00 in chips)
Seat 3: warioman ($13.21 in chips)
Seat 4: Player#2797 ($15.95 in chips)
Player#2797: posts small blind $0.05
Player#7949: posts big blind $0.10
*** HOLE CARDS ***
Dealt to warioman [8d 2c]
Player#0452: folds
warioman: folds
Player#2797: folds
Player#7949 collected $0.10 from pot
*** SUMMARY ***
Total Pot $0.10 | Rake $0.00
Seat 1: Player#7949 shows [] and won ($0.10) with 
Seat 2: Player#0452 folded before the flop
Seat 3: warioman (button) folded before the flop
Seat 4: Player#2797 (small blind) folded before the flop

PokerStars Hand #ebeb97b0-e9ca-4216-a6ed-a0bc009e8580:  Hold'em No Limit ($0.1/$0.20 USD) - 2021/11/20 10:21:00 ET
Table 'Bel Air' 6-max Seat #1 is the button
Seat 1: Player#9399 ($12.20 in chips)
Seat 2: Player#2823 ($23.30 in chips)
Seat 3: warioman ($22.36 in chips)
Seat 4: Player#9606 ($12.74 in chips)
Seat 5: Player#3285 ($20.32 in chips)
Seat 6: Player#9871 ($19.60 in chips)
Player#2823: posts small blind $0.10
warioman: posts big blind $0.20
*** HOLE CARDS ***
Dealt to warioman [Ts Qh]
Player#9606: folds
Player#3285: raises $0.20 to $0.4
Player#9871: folds
Player#9399: folds
Player#2823: calls $0.30
warioman: calls $0.20
*** FLOP *** [9d 8s Ad]
Player#2823: checks
warioman: checks
Player#3285: bets $0.20
Player#2823: calls $0.20
warioman: calls $0.20
*** TURN *** [9d 8s Ad] [Jc]
Player#2823: checks
warioman: bets $1.35
Player#3285: calls $1.35
Player#2823: folds
*** RIVER *** [9d 8s Ad] [Jc] [8c]
warioman: bets $1.35
Player#3285: calls $1.35
*** SHOW DOWN *** 
Player#9399: doesn't show hand
Player#2823: doesn't show hand
warioman: doesn't show hand
Player#9606: doesn't show hand
Player#3285: doesn't show hand
Player#9871: doesn't show hand
warioman collected $6.84 from pot
*** SUMMARY ***
Total Pot $7.20 | Rake $0.36
Board [9d 8s Ad Jc 8c]
Seat 1: Player#9399 (button) folded before the flop
Seat 2: Player#2823 (small blind) folded on the turn
Seat 3: warioman (big blind)
Seat 4: Player#9606 folded before the flop
Seat 5: Player#3285 mucked
Seat 6: Player#9871 folded before the flop

PokerStars Hand #f8adaf42-ae0c-4182-984d-1da432686149:  Hold'em No Limit ($0.05/$0.10 USD) - 2021/11/20 10:21:00 ET
Table 'Tempe' 6-max Seat #2 is the button
Seat 1: Player#1418 ($11.03 in chips)
Seat 2: Player#8200 ($10.00 in chips)
Seat 3: warioman ($13.26 in chips)
Seat 4: Player#9412 ($16.05 in chips)
warioman: posts small blind $0.05
Player#9412: posts big blind $0.10
*** HOLE CARDS ***
Dealt to warioman [8h As]
Player#1418: raises $0.10 to $0.3
Player#8200: raises $0.30 to $1.05
warioman: folds
Player#9412: folds
Player#1418: calls $0.75
*** FLOP *** [9c Ks 4c]
Player#1418: bets $1.13
Player#8200: calls $1.13
*** TURN *** [9c Ks 4c] [5c]
Player#1418: checks
Player#8200: checks
*** RIVER *** [9c Ks 4c] [5c] [6c]
Player#1418: bets $2.25
Player#8200: calls $2.25
*** SHOW DOWN *** 
Player#8200: doesn't show hand
Player#1418 collected $8.56 from pot
*** SUMMARY ***
Total Pot $9.01 | Rake $0.45
Board [9c Ks 4c 5c 6c]
Seat 1: Player#1418 shows [2c Tc] and won ($8.56) with 
Seat 2: Player#8200 (button) mucked
Seat 3: warioman (small blind) folded before the flop
Seat 4: Player#9412 (big blind) folded before the flop

PokerStars Hand #563763f4-b906-41d6-9762-a673da335cc0:  Hold'em No Limit ($0.1/$0.20 USD) - 2021/11/20 10:21:00 ET
Table 'Bel Air' 6-max Seat #6 is the button
Seat 1: Player#0555 ($12.30 in chips)
Seat 2: Player#0605 ($23.70 in chips)
Seat 3: warioman ($22.36 in chips)
Seat 4: Player#2927 ($12.74 in chips)
Seat 5: Player#5847 ($19.86 in chips)
Seat 6: Player#5835 ($19.60 in chips)
Player#0555: posts small blind $0.10
Player#0605: posts big blind $0.20
*** HOLE CARDS ***
Dealt to warioman [9c Ad]
warioman: folds
Player#2927: folds
Player#5847: raises $0.20 to $0.4
Player#5835: folds
Player#0555: folds
Player#0605: calls $0.20
*** FLOP *** [7h Th Jh]
Player#0605: checks
Player#5847: bets $0.20
Player#0605: folds
Player#5847: doesn't show hand
Uncalled bet ($0.20) returned to Player#5847
Player#5847 collected $0.86 from pot
*** SUMMARY ***
Total Pot $0.90 | Rake $0.05
Board [7h Th Jh]
Seat 1: Player#0555 (small blind) folded before the flop
Seat 2: Player#0605 (big blind) folded on the flop
Seat 3: warioman folded before the flop
Seat 4: Player#2927 folded before the flop
Seat 5: Player#5847 shows [] and won ($0.86) with 
Seat 6: Player#5835 (button) folded before the flop

PokerStars Hand #a3630010-30af-45ff-901c-7244bf456d4b:  Hold'em No Limit ($0.05/$0.10 USD) - 2021/11/20 10:20:00 ET
Table 'Tempe' 6-max Seat #2 is the button
Seat 1: Player#6319 ($10.88 in chips)
Seat 2: Player#3151 ($35.88 in chips)
Seat 3: Player#5745 ($9.90 in chips)
Seat 4: warioman ($13.36 in chips)
Seat 5: Player#8351 ($16.05 in chips)
Player#5745: posts small blind $0.05
warioman: posts big blind $0.10
*** HOLE CARDS ***
Dealt to warioman [5h Ts]
Player#8351: folds
Player#6319: raises $0.10 to $0.3
Player#3151: folds
Player#5745: folds
warioman: folds
Player#6319: doesn't show hand
Uncalled bet ($0.30) returned to Player#6319
Player#6319 collected $0.15 from pot
*** SUMMARY ***
Total Pot $0.15 | Rake $0.00
Seat 1: Player#6319 shows [] and won ($0.15) with 
Seat 2: Player#3151 (button) folded before the flop
Seat 3: Player#5745 (small blind) folded before the flop
Seat 4: warioman (big blind) folded before the flop
Seat 5: Player#8351 folded before the flop

PokerStars Hand #12db9014-d6b1-41e0-ba63-297295423255:  Hold'em No Limit ($0.05/$0.10 USD) - 2021/11/20 10:20:00 ET
Table 'Tempe' 6-max Seat #1 is the button
Seat 1: Player#9731 ($10.46 in chips)
Seat 2: Player#8771 ($35.93 in chips)
Seat 3: Player#6035 ($10.00 in chips)
Seat 4: warioman ($13.36 in chips)
Seat 5: Player#7218 ($16.35 in chips)
Player#8771: posts small blind $0.05
Player#6035: posts big blind $0.10
*** HOLE CARDS ***
Dealt to warioman [Ad 2h]
warioman: folds
Player#7218: raises $0.10 to $0.3
Player#9731: calls $0.30
Player#8771: folds
Player#6035: folds
*** FLOP *** [Qh 7h 4d]
Player#7218: checks
Player#9731: bets $0.38
Player#7218: folds
Player#9731: doesn't show hand
Uncalled bet ($0.38) returned to Player#9731
Player#9731 collected $0.71 from pot
*** SUMMARY ***
Total Pot $0.75 | Rake $0.04
Board [Qh 7h 4d]
Seat 1: Player#9731 shows [] and won ($0.71) with 
Seat 2: Player#8771 (small blind) folded before the flop
Seat 3: Player#6035 (big blind) folded before the flop
Seat 4: warioman folded before the flop
Seat 5: Player#7218 folded on the flop

PokerStars Hand #b34f3da7-48dd-47c3-a396-82825d7b4bca:  Hold'em No Limit ($0.05/$0.10 USD) - 2021/11/20 10:20:00 ET
Table 'Tempe' 6-max Seat #6 is the button
Seat 1: Player#5481 ($10.36 in chips)
Seat 2: Player#3514 ($36.03 in chips)
Seat 3: warioman ($13.36 in chips)
Seat 4: Player#4541 ($16.35 in chips)
Player#5481: posts small blind $0.05
Player#3514: posts big blind $0.10
*** HOLE CARDS ***
Dealt to warioman [Tc 9h]
warioman: folds
Player#4541: folds
Player#5481: raises $0.10 to $0.3
Player#3514: folds
Player#5481: doesn't show hand
Uncalled bet ($0.30) returned to Player#5481
Player#5481 collected $0.10 from pot
*** SUMMARY ***
Total Pot $0.10 | Rake $0.00
Seat 1: Player#5481 shows [] and won ($0.10) with 
Seat 2: Player#3514 (big blind) folded before the flop
Seat 3: warioman folded before the flop
Seat 4: Player#4541 folded before the flop

PokerStars Hand #a6edbafe-70eb-47da-bc4a-30541ad965be:  Hold'em No Limit ($0.1/$0.20 USD) - 2021/11/20 10:20:00 ET
Table 'Bel Air' 6-max Seat #5 is the button
Seat 1: Player#5504 ($12.50 in chips)
Seat 2: Player#5160 ($23.70 in chips)
Seat 3: warioman ($24.81 in chips)
Seat 4: Player#5054 ($10.25 in chips)
Seat 5: Player#3742 ($19.86 in chips)
Seat 6: Player#4309 ($19.70 in chips)
Player#4309: posts small blind $0.10
Player#5504: posts big blind $0.20
*** HOLE CARDS ***
Dealt to warioman [4h Ah]
Player#5160: folds
warioman: raises $0.20 to $0.5
Player#5054: calls $0.50
Player#3742: folds
Player#4309: folds
Player#5504: folds
*** FLOP *** [Ks 9h 3h]
warioman: bets $0.39
Player#5054: calls $0.39
*** TURN *** [Ks 9h 3h] [Js]
warioman: bets $1.56
Player#5054: calls $1.56
*** RIVER *** [Ks 9h 3h] [Js] [Ks]
warioman: checks
Player#5054: bets $3.90
warioman: folds
Player#5054: doesn't show hand
Uncalled bet ($3.90) returned to Player#5054
Player#5054 collected $4.94 from pot
*** SUMMARY ***
Total Pot $5.20 | Rake $0.26
Board [Ks 9h 3h Js Ks]
Seat 1: Player#5504 (big blind) folded before the flop
Seat 2: Player#5160 folded before the flop
Seat 3: warioman folded on the river
Seat 4: Player#5054 shows [] and won ($4.94) with 
Seat 5: Player#3742 (button) folded before the flop
Seat 6: Player#4309 (small blind) folded before the flop

PokerStars Hand #a744b208-1bde-4d3f-b3a1-3676ad50e7e0:  Hold'em No Limit ($0.1/$0.20 USD) - 2021/11/20 10:19:00 ET
Table 'Bel Air' 6-max Seat #4 is the button
Seat 1: Player#0216 ($12.20 in chips)
Seat 2: Player#6978 ($23.70 in chips)
Seat 3: warioman ($24.81 in chips)
Seat 4: Player#5158 ($10.25 in chips)
Seat 5: Player#9683 ($19.96 in chips)
Seat 6: Player#5324 ($19.90 in chips)
Player#9683: posts small blind $0.10
Player#5324: posts big blind $0.20
*** HOLE CARDS ***
Dealt to warioman [8d 4s]
Player#0216: raises $0.20 to $0.6
Player#6978: folds
warioman: folds
Player#5158: folds
Player#9683: folds
Player#5324: folds
Player#0216: doesn't show hand
Uncalled bet ($0.60) returned to Player#0216
Player#0216 collected $0.30 from pot
*** SUMMARY ***
Total Pot $0.30 | Rake $0.00
Seat 1: Player#0216 shows [] and won ($0.30) with 
Seat 2: Player#6978 folded before the flop
Seat 3: warioman folded before the flop
Seat 4: Player#5158 (button) folded before the flop
Seat 5: Player#9683 (small blind) folded before the flop
Seat 6: Player#5324 (big blind) folded before the flop

PokerStars Hand #3b009dcd-06eb-404f-bf90-6002239e1082:  Hold'em No Limit ($0.05/$0.10 USD) - 2021/11/20 10:19:00 ET
Table 'Tempe' 6-max Seat #3 is the button
Seat 1: Player#4135 ($10.00 in chips)
Seat 2: Player#0077 ($36.03 in chips)
Seat 3: warioman ($13.36 in chips)
Seat 4: Player#9183 ($16.75 in chips)
Player#9183: posts small blind $0.05
Player#4135: posts big blind $0.10
*** HOLE CARDS ***
Dealt to warioman [Qd 9h]
Player#0077: folds
warioman: folds
Player#9183: raises $0.10 to $0.3
Player#4135: calls $0.20
*** FLOP *** [3h 4s Ts]
Player#9183: checks
Player#4135: checks
*** TURN *** [3h 4s Ts] [4h]
Player#9183: bets $0.10
Player#4135: calls $0.10
*** RIVER *** [3h 4s Ts] [4h] [6h]
Player#9183: checks
Player#4135: checks
*** SHOW DOWN *** 
Player#4135 collected $0.76 from pot
*** SUMMARY ***
Total Pot $0.80 | Rake $0.04
Board [3h 4s Ts 4h 6h]
Seat 1: Player#4135 shows [7h 7c] and won ($0.76) with 
Seat 2: Player#0077 folded before the flop
Seat 3: warioman (button) folded before the flop
Seat 4: Player#9183 (small blind) mucked

PokerStars Hand #2aa778c9-75a6-4a03-9480-e18fadc5edef:  Hold'em No Limit ($0.1/$0.20 USD) - 2021/11/20 10:19:00 ET
Table 'Bel Air' 6-max Seat #3 is the button
Seat 1: Player#8572 ($12.20 in chips)
Seat 2: Player#6827 ($23.42 in chips)
Seat 3: warioman ($24.81 in chips)
Seat 4: Player#6445 ($10.35 in chips)
Seat 5: Player#2233 ($20.16 in chips)
Seat 6: Player#4576 ($19.90 in chips)
Player#6445: posts small blind $0.10
Player#2233: posts big blind $0.20
*** HOLE CARDS ***
Dealt to warioman [6h Qd]
Player#4576: folds
Player#8572: folds
Player#6827: calls $0.20
warioman: folds
Player#6445: folds
Player#2233: checks
*** FLOP *** [Qh Js Ah]
Player#2233: checks
Player#6827: bets $0.60
Player#2233: folds
Player#6827: doesn't show hand
Uncalled bet ($0.60) returned to Player#6827
Player#6827 collected $0.48 from pot
*** SUMMARY ***
Total Pot $0.50 | Rake $0.03
Board [Qh Js Ah]
Seat 1: Player#8572 folded before the flop
Seat 2: Player#6827 shows [] and won ($0.48) with 
Seat 3: warioman (button) folded before the flop
Seat 4: Player#6445 (small blind) folded before the flop
Seat 5: Player#2233 (big blind) folded on the flop
Seat 6: Player#4576 folded before the flop

PokerStars Hand #9232c779-58c8-44e1-8c55-92862639c635:  Hold'em No Limit ($0.1/$0.20 USD) - 2021/11/20 10:19:00 ET
Table 'Bel Air' 6-max Seat #2 is the button
Seat 1: Player#4239 ($12.20 in chips)
Seat 2: Player#5306 ($23.42 in chips)
Seat 3: warioman ($24.91 in chips)
Seat 4: Player#4471 ($10.25 in chips)
Seat 5: Player#2665 ($20.16 in chips)
Seat 6: Player#1859 ($19.90 in chips)
warioman: posts small blind $0.10
Player#4471: posts big blind $0.20
*** HOLE CARDS ***
Dealt to warioman [Ah 3d]
Player#2665: folds
Player#1859: folds
Player#4239: folds
Player#5306: folds
warioman: folds
Player#4471 collected $0.20 from pot
*** SUMMARY ***
Total Pot $0.20 | Rake $0.00
Seat 1: Player#4239 folded before the flop
Seat 2: Player#5306 (button) folded before the flop
Seat 3: warioman (small blind) folded before the flop
Seat 4: Player#4471 shows [] and won ($0.20) with 
Seat 5: Player#2665 folded before the flop
Seat 6: Player#1859 folded before the flop

PokerStars Hand #c995549e-84d9-44f3-8c28-45a7b09b0132:  Hold'em No Limit ($0.05/$0.10 USD) - 2021/11/20 10:18:00 ET
Table 'Tempe' 6-max Seat #3 is the button
Seat 1: Player#5890 ($10.00 in chips)
Seat 2: Player#6573 ($36.53 in chips)
Seat 3: Player#2650 ($10.62 in chips)
Seat 4: warioman ($13.41 in chips)
Seat 5: Player#9728 ($16.25 in chips)
warioman: posts small blind $0.05
Player#9728: posts big blind $0.10
*** HOLE CARDS ***
Dealt to warioman [9s 6c]
Player#5890: folds
Player#6573: raises $0.10 to $0.3
Player#2650: folds
warioman: folds
Player#9728: calls $0.20
*** FLOP *** [Qh Ts 5h]
Player#9728: checks
Player#6573: bets $0.20
Player#9728: calls $0.20
*** TURN *** [Qh Ts 5h] [3c]
Player#9728: checks
Player#6573: checks
*** RIVER *** [Qh Ts 5h] [3c] [Tc]
Player#9728: checks
Player#6573: checks
*** SHOW DOWN *** 
Player#9728 collected $1.00 from pot
*** SUMMARY ***
Total Pot $1.05 | Rake $0.05
Board [Qh Ts 5h 3c Tc]
Seat 1: Player#5890 folded before the flop
Seat 2: Player#6573 mucked
Seat 3: Player#2650 (button) folded before the flop
Seat 4: warioman (small blind) folded before the flop
Seat 5: Player#9728 shows [6s 6d] and won ($1.00) with 

PokerStars Hand #256c2b4d-909c-44b3-ba79-ae516214f3bb:  Hold'em No Limit ($0.1/$0.20 USD) - 2021/11/20 10:17:00 ET
Table 'Bel Air' 6-max Seat #1 is the button
Seat 1: Player#3440 ($10.93 in chips)
Seat 2: Player#0554 ($24.62 in chips)
Seat 3: warioman ($25.11 in chips)
Seat 4: Player#1667 ($10.25 in chips)
Seat 5: Player#1409 ($20.16 in chips)
Seat 6: Player#6650 ($19.90 in chips)
Player#0554: posts small blind $0.10
warioman: posts big blind $0.20
*** HOLE CARDS ***
Dealt to warioman [8h 2d]
Player#1667: folds
Player#1409: folds
Player#6650: folds
Player#3440: calls $0.20
Player#0554: raises0.20 to $1
warioman: folds
Player#3440: calls $0.80
*** FLOP *** [8d 2h 3h]
Player#0554: checks
Player#3440: checks
*** TURN *** [8d 2h 3h] [9h]
Player#0554: checks
Player#3440: checks
*** RIVER *** [8d 2h 3h] [9h] [Th]
Player#0554: bets $0.20
Player#3440: raises $0.20 to $2.8
Player#0554: folds
Player#3440 Show
*** SHOW DOWN *** 
Uncalled bet ($2.80) returned to Player#3440
Player#3440 collected $2.28 from pot
*** SUMMARY ***
Total Pot $2.40 | Rake $0.12
Board [8d 2h 3h 9h Th]
Seat 1: Player#3440 shows [Jh Qs] and won ($2.28) with 
Seat 2: Player#0554 (small blind) folded on the river
Seat 3: warioman (big blind) folded before the flop
Seat 4: Player#1667 folded before the flop
Seat 5: Player#1409 folded before the flop
Seat 6: Player#6650 folded before the flop

PokerStars Hand #e4416f2c-5d6f-40bb-8577-1892c85423ba:  Hold'em No Limit ($0.05/$0.10 USD) - 2021/11/20 10:17:00 ET
Table 'Tempe' 6-max Seat #2 is the button
Seat 1: Player#2546 ($10.00 in chips)
Seat 2: Player#7662 ($36.38 in chips)
Seat 3: Player#7551 ($10.67 in chips)
Seat 4: warioman ($13.51 in chips)
Seat 5: Player#8826 ($16.25 in chips)
Player#7551: posts small blind $0.05
warioman: posts big blind $0.10
*** HOLE CARDS ***
Dealt to warioman [Qc 8d]
Player#8826: folds
Player#2546: folds
Player#7662: raises $0.10 to $0.3
Player#7551: folds
warioman: folds
Player#7662: doesn't show hand
Uncalled bet ($0.30) returned to Player#7662
Player#7662 collected $0.15 from pot
*** SUMMARY ***
Total Pot $0.15 | Rake $0.00
Seat 1: Player#2546 folded before the flop
Seat 2: Player#7662 shows [] and won ($0.15) with 
Seat 3: Player#7551 (small blind) folded before the flop
Seat 4: warioman (big blind) folded before the flop
Seat 5: Player#8826 folded before the flop

PokerStars Hand #baa5b66f-7495-4f35-bbfb-d93c5faa6bcb:  Hold'em No Limit ($0.1/$0.20 USD) - 2021/11/20 10:17:00 ET
Table 'Bel Air' 6-max Seat #6 is the button
Seat 1: Player#6211 ($13.33 in chips)
Seat 2: Player#9938 ($22.46 in chips)
Seat 3: warioman ($25.11 in chips)
Seat 4: Player#8072 ($10.25 in chips)
Seat 5: Player#5865 ($20.16 in chips)
Seat 6: Player#1143 ($19.90 in chips)
Player#6211: posts small blind $0.10
Player#9938: posts big blind $0.20
*** HOLE CARDS ***
Dealt to warioman [7c 2h]
warioman: folds
Player#8072: folds
Player#5865: folds
Player#1143: folds
Player#6211: calls $0.10
Player#9938: checks
*** FLOP *** [6s Ts 2c]
Player#6211: bets $0.20
Player#9938: calls $0.20
*** TURN *** [6s Ts 2c] [Tc]
Player#6211: bets $0.40
Player#9938: raises $0.40 to $0.8
Player#6211: calls $0.40
*** RIVER *** [6s Ts 2c] [Tc] [4c]
Player#6211: bets $1.20
Player#9938: calls $1.20
*** SHOW DOWN *** 
Player#9938 collected $4.56 from pot
*** SUMMARY ***
Total Pot $4.80 | Rake $0.24
Board [6s Ts 2c Tc 4c]
Seat 1: Player#6211 (small blind) mucked
Seat 2: Player#9938 shows [3s Th] and won ($4.56) with 
Seat 3: warioman folded before the flop
Seat 4: Player#8072 folded before the flop
Seat 5: Player#5865 folded before the flop
Seat 6: Player#1143 (button) folded before the flop

PokerStars Hand #3a8a9057-1331-41e0-ad64-d706e1271dbc:  Hold'em No Limit ($0.1/$0.20 USD) - 2021/11/20 10:16:00 ET
Table 'Bel Air' 6-max Seat #5 is the button
Seat 1: Player#5525 ($13.73 in chips)
Seat 2: Player#1531 ($22.46 in chips)
Seat 3: warioman ($25.11 in chips)
Seat 4: Player#7543 ($10.25 in chips)
Seat 5: Player#5670 ($19.70 in chips)
Seat 6: Player#8031 ($20.00 in chips)
Player#8031: posts small blind $0.10
Player#5525: posts big blind $0.20
*** HOLE CARDS ***
Dealt to warioman [3h 5s]
Player#1531: folds
warioman: folds
Player#7543: folds
Player#5670: raises $0.20 to $0.4
Player#8031: folds
Player#5525: calls $0.20
*** FLOP *** [Ts 5d 2d]
Player#5525: checks
Player#5670: bets $0.45
Player#5525: folds
Player#5670: doesn't show hand
Uncalled bet ($0.45) returned to Player#5670
Player#5670 collected $0.86 from pot
*** SUMMARY ***
Total Pot $0.90 | Rake $0.05
Board [Ts 5d 2d]
Seat 1: Player#5525 (big blind) folded on the flop
Seat 2: Player#1531 folded before the flop
Seat 3: warioman folded before the flop
Seat 4: Player#7543 folded before the flop
Seat 5: Player#5670 shows [] and won ($0.86) with 
Seat 6: Player#8031 (small blind) folded before the flop

PokerStars Hand #7d6db909-2659-4c49-a29f-4fdfc4bcb234:  Hold'em No Limit ($0.05/$0.10 USD) - 2021/11/20 10:16:00 ET
Table 'Tempe' 6-max Seat #2 is the button
Seat 1: Player#7363 ($9.30 in chips)
Seat 2: Player#7928 ($36.38 in chips)
Seat 3: Player#3524 ($10.28 in chips)
Seat 4: Player#1769 ($12.86 in chips)
Seat 5: warioman ($11.20 in chips)
Seat 6: Player#2270 ($16.25 in chips)
Player#3524: posts small blind $0.05
Player#1769: posts big blind $0.10
*** HOLE CARDS ***
Dealt to warioman [Ah 3h]
warioman: raises $0.10 to $0.3
Player#2270: folds
Player#7363: calls $0.30
Player#7928: folds
Player#3524: folds
Player#1769: calls $0.20
*** FLOP *** [Qh Th 9h]
Player#1769: checks
warioman: checks
Player#7363: checks
*** TURN *** [Qh Th 9h] [Jd]
Player#1769: bets $0.47
warioman: calls $0.47
Player#7363: folds
*** RIVER *** [Qh Th 9h] [Jd] [3d]
Player#1769: checks
warioman: bets $1.42
Player#1769: calls $1.42
*** SHOW DOWN *** 
Player#1769: doesn't show hand
warioman collected $4.49 from pot
*** SUMMARY ***
Total Pot $4.73 | Rake $0.24
Board [Qh Th 9h Jd 3d]
Seat 1: Player#7363 folded on the turn
Seat 2: Player#7928 (button) folded before the flop
Seat 3: Player#3524 (small blind) folded before the flop
Seat 4: Player#1769 (big blind) mucked
Seat 5: warioman
Seat 6: Player#2270 folded before the flop

PokerStars Hand #b255386d-f6d9-46b1-91ad-8d751ca82fb4:  Hold'em No Limit ($0.05/$0.10 USD) - 2021/11/20 10:15:00 ET
Table 'Tempe' 6-max Seat #1 is the button
Seat 1: Player#4632 ($9.60 in chips)
Seat 2: Player#7470 ($34.10 in chips)
Seat 3: Player#8756 ($12.18 in chips)
Seat 4: warioman ($11.20 in chips)
Seat 5: Player#7096 ($16.55 in chips)
Player#7470: posts small blind $0.05
Player#8756: posts big blind $0.10
*** HOLE CARDS ***
Dealt to warioman [9h Js]
warioman: folds
Player#7096: raises $0.10 to $0.3
Player#4632: calls $0.30
Player#7470: raises0.30 to $1
Player#8756: calls $0.90
Player#7096: folds
Player#4632: folds
*** FLOP *** [5s 7d 5c]
Player#7470: bets $0.90
Player#8756: calls $0.90
*** TURN *** [5s 7d 5c] [Jc]
Player#7470: bets $1.80
Player#8756: folds
Player#7470: doesn't show hand
Uncalled bet ($1.80) returned to Player#7470
Player#7470 collected $4.18 from pot
*** SUMMARY ***
Total Pot $4.40 | Rake $0.22
Board [5s 7d 5c Jc]
Seat 1: Player#4632 (button) folded before the flop
Seat 2: Player#7470 shows [] and won ($4.18) with 
Seat 3: Player#8756 (big blind) folded on the turn
Seat 4: warioman folded before the flop
Seat 5: Player#7096 folded before the flop

PokerStars Hand #77aaca7a-8c26-4c42-87d4-ddf875543980:  Hold'em No Limit ($0.1/$0.20 USD) - 2021/11/20 10:15:00 ET
Table 'Bel Air' 6-max Seat #4 is the button
Seat 1: Player#2991 ($13.73 in chips)
Seat 2: Player#7084 ($18.82 in chips)
Seat 3: warioman ($26.01 in chips)
Seat 4: Player#8230 ($10.25 in chips)
Seat 5: Player#3353 ($19.80 in chips)
Seat 6: Player#8608 ($20.00 in chips)
Player#3353: posts small blind $0.10
Player#8608: posts big blind $0.20
*** HOLE CARDS ***
Dealt to warioman [8s 8c]
Player#2991: folds
Player#7084: calls $0.20
warioman: raises $0.20 to $0.9
Player#8230: folds
Player#3353: folds
Player#8608: calls $0.70
Player#7084: calls $0.70
*** FLOP *** [3h 7h Th]
Player#8608: checks
Player#7084: checks
warioman: checks
*** TURN *** [3h 7h Th] [9h]
Player#8608: checks
Player#7084: checks
warioman: checks
*** RIVER *** [3h 7h Th] [9h] [5h]
Player#8608: bets $0.84
Player#7084: raises $0.84 to $2.08
warioman: folds
Player#8608: calls $1.24
*** SHOW DOWN *** 
Player#8608: doesn't show hand
Player#7084 collected $6.61 from pot
*** SUMMARY ***
Total Pot $6.96 | Rake $0.35
Board [3h 7h Th 9h 5h]
Seat 1: Player#2991 folded before the flop
Seat 2: Player#7084 shows [8h Ah] and won ($6.61) with 
Seat 3: warioman folded on the river
Seat 4: Player#8230 (button) folded before the flop
Seat 5: Player#3353 (small blind) folded before the flop
Seat 6: Player#8608 (big blind) mucked

PokerStars Hand #1a8c4116-8557-46a6-a80f-cd57494e68da:  Hold'em No Limit ($0.05/$0.10 USD) - 2021/11/20 10:14:00 ET
Table 'Tempe' 6-max Seat #6 is the button
Seat 1: Player#2292 ($10.05 in chips)
Seat 2: Player#5104 ($34.20 in chips)
Seat 3: Player#1639 ($9.09 in chips)
Seat 4: warioman ($14.05 in chips)
Seat 5: Player#9179 ($16.55 in chips)
Player#2292: posts small blind $0.05
Player#5104: posts big blind $0.10
*** HOLE CARDS ***
Dealt to warioman [Ks Kh]
Player#1639: calls $0.10
warioman: raises $0.10 to $0.45
Player#9179: folds
Player#2292: calls $0.40
Player#5104: folds
Player#1639: calls $0.35
*** FLOP *** [Tc 3c 8h]
Player#2292: checks
Player#1639: bets $0.90
warioman: calls $0.90
Player#2292: folds
*** TURN *** [Tc 3c 8h] [5c]
Player#1639: bets $1.50
warioman: calls $1.50
*** RIVER *** [Tc 3c 8h] [5c] [6c]
Player#1639: bets $2.50
warioman: folds
Player#1639 Show
*** SHOW DOWN *** 
Uncalled bet ($2.50) returned to Player#1639
Player#1639 collected $5.94 from pot
*** SUMMARY ***
Total Pot $6.25 | Rake $0.31
Board [Tc 3c 8h 5c 6c]
Seat 1: Player#2292 (small blind) folded on the flop
Seat 2: Player#5104 (big blind) folded before the flop
Seat 3: Player#1639 shows [4s Kc] and won ($5.94) with 
Seat 4: warioman folded on the river
Seat 5: Player#9179 folded before the flop

PokerStars Hand #1763bec7-1efb-40da-b653-6b568410a7a8:  Hold'em No Limit ($0.05/$0.10 USD) - 2021/11/20 10:14:00 ET
Table 'Tempe' 6-max Seat #4 is the button
Seat 1: Player#2027 ($10.00 in chips)
Seat 2: Player#6235 ($34.20 in chips)
Seat 3: Player#5721 ($9.09 in chips)
Seat 4: warioman ($14.05 in chips)
Seat 5: Player#4930 ($16.60 in chips)
Player#4930: posts small blind $0.05
Player#2027: posts big blind $0.10
*** HOLE CARDS ***
Dealt to warioman [4h 8h]
Player#6235: folds
Player#5721: folds
warioman: folds
Player#4930: folds
Player#2027 collected $0.10 from pot
*** SUMMARY ***
Total Pot $0.10 | Rake $0.00
Seat 1: Player#2027 shows [] and won ($0.10) with 
Seat 2: Player#6235 folded before the flop
Seat 3: Player#5721 folded before the flop
Seat 4: warioman (button) folded before the flop
Seat 5: Player#4930 (small blind) folded before the flop

PokerStars Hand #b6dbf470-3944-45c8-a78a-24827b7c4b68:  Hold'em No Limit ($0.1/$0.20 USD) - 2021/11/20 10:14:00 ET
Table 'Bel Air' 6-max Seat #5 is the button
Seat 1: Player#1848 ($14.73 in chips)
Seat 2: Player#0864 ($18.82 in chips)
Seat 3: warioman ($26.01 in chips)
Seat 4: Player#6810 ($9.16 in chips)
Seat 5: Player#7865 ($20.00 in chips)
Seat 6: Player#1383 ($20.00 in chips)
Player#1383: posts small blind $0.10
Player#6810: posts big blind $0.20
*** HOLE CARDS ***
Dealt to warioman [9c 3s]
Player#1383 Waiting
Player#1848: calls $0.20
Player#0864: folds
warioman: folds
Player#6810: raises0.20 to $1
Player#7865: folds
Player#1848: calls $0.80
*** FLOP *** [3d 4h As]
Player#6810: bets $1.10
Player#1848: folds
Player#6810: doesn't show hand
Uncalled bet ($1.10) returned to Player#6810
Player#6810 collected $2.09 from pot
*** SUMMARY ***
Total Pot $2.20 | Rake $0.11
Board [3d 4h As]
Seat 1: Player#1848 folded on the flop
Seat 2: Player#0864 folded before the flop
Seat 3: warioman folded before the flop
Seat 4: Player#6810 shows [] and won ($2.09) with 
Seat 5: Player#7865 (button) folded before the flop
Seat 6: Player#1383 (small blind) mucked

PokerStars Hand #1158f715-2047-4306-b0e1-e95e6d08068a:  Hold'em No Limit ($0.1/$0.20 USD) - 2021/11/20 10:14:00 ET
Table 'Bel Air' 6-max Seat #4 is the button
Seat 1: Player#9878 ($14.73 in chips)
Seat 2: Player#7062 ($18.82 in chips)
Seat 3: warioman ($25.81 in chips)
Seat 4: Player#5047 ($9.36 in chips)
Seat 5: Player#7719 ($20.00 in chips)
Seat 6: Player#5830 ($20.00 in chips)
Player#7719: posts small blind $0.10
Player#5830: posts big blind $0.20
*** HOLE CARDS ***
Dealt to warioman [5s 3s]
Player#7719 Waiting
Player#5830 Waiting
Player#9878: folds
Player#7062: folds
warioman: raises $0.20 to $0.6
Player#5047: folds
warioman: doesn't show hand
Uncalled bet ($0.60) returned to warioman
warioman collected $0.20 from pot
*** SUMMARY ***
Total Pot $0.20 | Rake $0.00
Seat 1: Player#9878 folded before the flop
Seat 2: Player#7062 folded before the flop
Seat 3: warioman
Seat 4: Player#5047 (button) folded before the flop
Seat 5: Player#7719 (small blind) mucked
Seat 6: Player#5830 (big blind) mucked

PokerStars Hand #6a25e7a5-d1c4-4ba5-9e63-75b696bdda73:  Hold'em No Limit ($0.05/$0.10 USD) - 2021/11/20 10:14:00 ET
Table 'Tempe' 6-max Seat #3 is the button
Seat 1: Player#8500 ($8.55 in chips)
Seat 2: Player#7641 ($34.20 in chips)
Seat 3: Player#0849 ($8.95 in chips)
Seat 4: warioman ($14.10 in chips)
Seat 5: Player#3563 ($16.70 in chips)
warioman: posts small blind $0.05
Player#3563: posts big blind $0.10
*** HOLE CARDS ***
Dealt to warioman [Qc 4h]
Player#8500: folds
Player#7641: folds
Player#0849: calls $0.10
warioman: folds
Player#3563: checks
*** FLOP *** [8d Ad 6h]
Player#3563: checks
Player#0849: bets $0.10
Player#3563: folds
Player#0849: doesn't show hand
Uncalled bet ($0.10) returned to Player#0849
Player#0849 collected $0.24 from pot
*** SUMMARY ***
Total Pot $0.25 | Rake $0.01
Board [8d Ad 6h]
Seat 1: Player#8500 folded before the flop
Seat 2: Player#7641 folded before the flop
Seat 3: Player#0849 shows [] and won ($0.24) with 
Seat 4: warioman (small blind) folded before the flop
Seat 5: Player#3563 (big blind) folded on the flop

PokerStars Hand #099bb9f0-64de-455b-9560-90ebcb183b6d:  Hold'em No Limit ($0.1/$0.20 USD) - 2021/11/20 10:14:00 ET
Table 'Bel Air' 6-max Seat #4 is the button
Seat 1: Player#3904 ($14.93 in chips)
Seat 2: Player#4565 ($19.02 in chips)
Seat 3: warioman ($25.44 in chips)
Seat 4: Player#6917 ($9.36 in chips)
Seat 5: Player#5142 ($20.00 in chips)
Seat 6: Player#9044 ($20.00 in chips)
Player#5142: posts small blind $0.10
Player#9044: posts big blind $0.20
*** HOLE CARDS ***
Dealt to warioman [Jh 2c]
Player#5142 Waiting
Player#9044 Waiting
Player#6917: folds
Player#3904: calls $0.20
Player#4565: calls $0.10
warioman: checks
*** FLOP *** [Qh Ad As]
Player#4565: checks
warioman: checks
Player#3904: checks
*** TURN *** [Qh Ad As] [4d]
Player#4565: checks
warioman: checks
Player#3904: checks
*** RIVER *** [Qh Ad As] [4d] [Qd]
Player#4565: checks
warioman: checks
Player#3904: checks
*** SHOW DOWN *** 
warioman collected $0.57 from pot
*** SUMMARY ***
Total Pot $0.60 | Rake $0.03
Board [Qh Ad As 4d Qd]
Seat 1: Player#3904 mucked
Seat 2: Player#4565 mucked
Seat 3: warioman
Seat 4: Player#6917 (button) folded before the flop
Seat 5: Player#5142 (small blind) mucked
Seat 6: Player#9044 (big blind) mucked

PokerStars Hand #8942fda2-7bcd-47ee-8055-2340f21a8ffe:  Hold'em No Limit ($0.1/$0.20 USD) - 2021/11/20 10:13:00 ET
Table 'Bel Air' 6-max Seat #4 is the button
Seat 1: Player#4395 ($13.29 in chips)
Seat 2: Player#9923 ($19.42 in chips)
Seat 3: warioman ($25.44 in chips)
Seat 4: Player#1726 ($10.76 in chips)
Seat 5: Player#4290 ($20.00 in chips)
Player#4290: posts small blind $0.10
Player#4395: posts big blind $0.20
*** HOLE CARDS ***
Dealt to warioman [7c 9h]
Player#4290 Waiting
warioman: folds
Player#1726: calls $0.20
Player#4395: calls $0.10
Player#9923: checks
*** FLOP *** [9d 5c 7d]
Player#4395: checks
Player#9923: bets $0.20
Player#1726: calls $0.20
Player#4395: calls $0.20
*** TURN *** [9d 5c 7d] [Ah]
Player#4395: checks
Player#9923: checks
Player#1726: bets $1.00
Player#4395: raises1.00 to $2
Player#9923: folds
Player#1726: folds
Player#4395: doesn't show hand
Player#9923: doesn't show hand
warioman: doesn't show hand
Player#1726: doesn't show hand
Uncalled bet ($2.00) returned to Player#4395
Player#4395 collected $2.09 from pot
*** SUMMARY ***
Total Pot $2.20 | Rake $0.11
Board [9d 5c 7d Ah]
Seat 1: Player#4395 shows [] and won ($2.09) with 
Seat 2: Player#9923 folded on the turn
Seat 3: warioman folded before the flop
Seat 4: Player#1726 (button) folded on the turn
Seat 5: Player#4290 (small blind) mucked

PokerStars Hand #ffea5fef-db71-493f-b767-783a2c2495c5:  Hold'em No Limit ($0.05/$0.10 USD) - 2021/11/20 10:13:00 ET
Table 'Tempe' 6-max Seat #2 is the button
Seat 1: Player#7416 ($10.00 in chips)
Seat 2: Player#0162 ($32.56 in chips)
Seat 3: Player#9891 ($9.00 in chips)
Seat 4: warioman ($14.40 in chips)
Seat 5: Player#2321 ($16.70 in chips)
Player#9891: posts small blind $0.05
warioman: posts big blind $0.10
*** HOLE CARDS ***
Dealt to warioman [4h 4d]
Player#2321: folds
Player#7416: calls $0.10
Player#0162: raises $0.10 to $0.3
Player#9891: folds
warioman: calls $0.20
Player#7416: calls $0.20
*** FLOP *** [7d 2c Ks]
warioman: checks
Player#7416: bets $0.50
Player#0162: calls $0.50
warioman: folds
*** TURN *** [7d 2c Ks] [5h]
Player#7416: checks
Player#0162: bets $0.60
Player#7416: calls $0.60
*** RIVER *** [7d 2c Ks] [5h] [8h]
Player#7416: checks
Player#0162: bets $0.80
Player#7416: folds
Player#0162: doesn't show hand
Uncalled bet ($0.80) returned to Player#0162
Player#0162 collected $3.04 from pot
*** SUMMARY ***
Total Pot $3.20 | Rake $0.16
Board [7d 2c Ks 5h 8h]
Seat 1: Player#7416 folded on the river
Seat 2: Player#0162 shows [] and won ($3.04) with 
Seat 3: Player#9891 (small blind) folded before the flop
Seat 4: warioman (big blind) folded on the flop
Seat 5: Player#2321 folded before the flop

PokerStars Hand #0b656e26-a660-410c-ae2c-7637a00036f8:  Hold'em No Limit ($0.1/$0.20 USD) - 2021/11/20 10:12:00 ET
Table 'Bel Air' 6-max Seat #5 is the button
Seat 1: Player#1668 ($13.19 in chips)
Seat 2: Player#8336 ($19.42 in chips)
Seat 3: warioman ($25.44 in chips)
Seat 4: Player#1139 ($10.76 in chips)
Seat 5: Player#5329 ($20.00 in chips)
Seat 6: Player#0556 ($14.81 in chips)
Player#0556: posts small blind $0.10
Player#1668: posts big blind $0.20
*** HOLE CARDS ***
Dealt to warioman [6c Jc]
Player#8336: folds
warioman: folds
Player#1139: folds
Player#0556: folds
Player#1668 collected $0.20 from pot
*** SUMMARY ***
Total Pot $0.20 | Rake $0.00
Seat 1: Player#1668 shows [] and won ($0.20) with 
Seat 2: Player#8336 folded before the flop
Seat 3: warioman folded before the flop
Seat 4: Player#1139 folded before the flop
Seat 5: Player#5329 (button) mucked
Seat 6: Player#0556 (small blind) folded before the flop

PokerStars Hand #eb07c2a4-ad67-49c9-ad6b-53cc6ff4133a:  Hold'em No Limit ($0.1/$0.20 USD) - 2021/11/20 10:12:00 ET
Table 'Bel Air' 6-max Seat #3 is the button
Seat 1: Player#3639 ($13.79 in chips)
Seat 2: Player#4246 ($19.42 in chips)
Seat 3: warioman ($25.44 in chips)
Seat 4: Player#8092 ($8.43 in chips)
Seat 5: Player#1002 ($16.76 in chips)
Player#8092: posts small blind $0.10
Player#1002: posts big blind $0.20
*** HOLE CARDS ***
Dealt to warioman [7h 5s]
Player#3639: calls $0.20
Player#4246: folds
warioman: folds
Player#8092: raises $0.20 to $0.6
Player#1002: calls $0.40
Player#3639: calls $0.40
*** FLOP *** [Ts 2s 4d]
Player#8092: checks
Player#1002: bets $1.35
Player#3639: folds
Player#8092: raises $1.35 to $7.83
Player#1002: folds
Player#8092: doesn't show hand
Uncalled bet ($7.83) returned to Player#8092
Player#8092 collected $2.99 from pot
*** SUMMARY ***
Total Pot $3.15 | Rake $0.16
Board [Ts 2s 4d]
Seat 1: Player#3639 folded on the flop
Seat 2: Player#4246 folded before the flop
Seat 3: warioman (button) folded before the flop
Seat 4: Player#8092 shows [] and won ($2.99) with 
Seat 5: Player#1002 (big blind) folded on the flop

PokerStars Hand #3ccb3f49-e6d1-4755-9a28-e8c5a9b7f104:  Hold'em No Limit ($0.05/$0.10 USD) - 2021/11/20 10:11:00 ET
Table 'Tempe' 6-max Seat #6 is the button
Seat 1: Player#1992 ($34.76 in chips)
Seat 2: Player#1076 ($6.73 in chips)
Seat 3: warioman ($14.40 in chips)
Seat 4: Player#4364 ($17.00 in chips)
Player#1992: posts small blind $0.05
Player#1076: posts big blind $0.10
*** HOLE CARDS ***
Dealt to warioman [Th 8c]
warioman: folds
Player#4364: raises $0.10 to $0.3
Player#1992: raises $0.30 to $0.8
Player#1076: calls $0.70
Player#4364: folds
*** FLOP *** [9h Tc Kd]
Player#1992: checks
Player#1076: bets $0.30
Player#1992: calls $0.30
*** TURN *** [9h Tc Kd] [Jd]
Player#1992: bets $1.10
Player#1076: calls $1.10
*** RIVER *** [9h Tc Kd] [Jd] [7d]
Player#1992: checks
Player#1076: checks
*** SHOW DOWN *** 
Player#1076 collected $4.46 from pot
*** SUMMARY ***
Total Pot $4.70 | Rake $0.24
Board [9h Tc Kd Jd 7d]
Seat 1: Player#1992 (small blind) mucked
Seat 2: Player#1076 shows [7c 9c] and won ($4.46) with 
Seat 3: warioman folded before the flop
Seat 4: Player#4364 folded before the flop

PokerStars Hand #cebc62ee-4011-4143-893e-e03264fe3d2c:  Hold'em No Limit ($0.05/$0.10 USD) - 2021/11/20 10:11:00 ET
Table 'Tempe' 6-max Seat #6 is the button
Seat 1: Player#4720 ($34.86 in chips)
Seat 2: Player#0007 ($6.73 in chips)
Seat 3: warioman ($14.30 in chips)
Seat 4: Player#7159 ($17.00 in chips)
Player#4720: posts small blind $0.05
Player#0007: posts big blind $0.10
*** HOLE CARDS ***
Dealt to warioman [Kc Ac]
Player#0007: folds
warioman: raises $0.10 to $0.3
Player#7159: folds
Player#4720: folds
warioman: doesn't show hand
Uncalled bet ($0.30) returned to warioman
warioman collected $0.10 from pot
*** SUMMARY ***
Total Pot $0.10 | Rake $0.00
Seat 1: Player#4720 (small blind) folded before the flop
Seat 2: Player#0007 (big blind) folded before the flop
Seat 3: warioman
Seat 4: Player#7159 folded before the flop

PokerStars Hand #6ae9e4c4-b9cd-452d-a5bd-a28cfdc89690:  Hold'em No Limit ($0.1/$0.20 USD) - 2021/11/20 10:11:00 ET
Table 'Bel Air' 6-max Seat #2 is the button
Seat 1: Player#4579 ($13.79 in chips)
Seat 2: Player#1267 ($15.86 in chips)
Seat 3: warioman ($25.54 in chips)
Seat 4: Player#8499 ($12.28 in chips)
Seat 5: Player#4075 ($16.76 in chips)
warioman: posts small blind $0.10
Player#8499: posts big blind $0.20
*** HOLE CARDS ***
Dealt to warioman [6d 2s]
Player#4075: folds
Player#4579: folds
Player#1267: raises $0.20 to $0.6
warioman: folds
Player#8499: calls $0.40
*** FLOP *** [Qs Ac 8s]
Player#8499: checks
Player#1267: checks
*** TURN *** [Qs Ac 8s] [Th]
Player#8499: bets $0.65
Player#1267: raises $0.65 to $1.3
Player#8499: calls $0.65
*** RIVER *** [Qs Ac 8s] [Th] [4h]
Player#8499: checks
Player#1267: bets $1.95
Player#8499: calls $1.95
*** SHOW DOWN *** 
Player#8499: doesn't show hand
Player#1267 collected $7.41 from pot
*** SUMMARY ***
Total Pot $7.80 | Rake $0.39
Board [Qs Ac 8s Th 4h]
Seat 1: Player#4579 folded before the flop
Seat 2: Player#1267 shows [Ad Qc] and won ($7.41) with 
Seat 3: warioman (small blind) folded before the flop
Seat 4: Player#8499 (big blind) mucked
Seat 5: Player#4075 folded before the flop

PokerStars Hand #a1370ac9-dd9f-49ad-aca8-71b51521099b:  Hold'em No Limit ($0.05/$0.10 USD) - 2021/11/20 10:10:00 ET
Table 'Tempe' 6-max Seat #5 is the button
Seat 1: Player#5610 ($8.10 in chips)
Seat 2: Player#3860 ($27.23 in chips)
Seat 3: Player#4224 ($7.03 in chips)
Seat 4: Player#6001 ($12.86 in chips)
Seat 5: warioman ($14.30 in chips)
Seat 6: Player#8938 ($17.05 in chips)
Player#8938: posts small blind $0.05
Player#5610: posts big blind $0.10
*** HOLE CARDS ***
Dealt to warioman [8h Qd]
Player#3860: raises $0.10 to $0.3
Player#4224: calls $0.30
Player#6001: folds
warioman: folds
Player#8938: folds
Player#5610: calls $0.20
*** FLOP *** [Ah As 6d]
Player#5610: checks
Player#3860: bets $0.71
Player#4224: folds
Player#5610: calls $0.71
*** TURN *** [Ah As 6d] [8s]
Player#5610: checks
Player#3860: bets $1.78
Player#5610: calls $1.78
*** RIVER *** [Ah As 6d] [8s] [Js]
Player#5610: bets $5.31
Player#3860: calls $5.31
*** SHOW DOWN *** 
Player#3860 collected $15.72 from pot
*** SUMMARY ***
Total Pot $16.55 | Rake $0.83
Board [Ah As 6d 8s Js]
Seat 1: Player#5610 (big blind) mucked
Seat 2: Player#3860 shows [Ad Qc] and won ($15.72) with 
Seat 3: Player#4224 folded on the flop
Seat 4: Player#6001 folded before the flop
Seat 5: warioman (button) folded before the flop
Seat 6: Player#8938 (small blind) folded before the flop

PokerStars Hand #55f5ebc8-c0f1-434c-b9e5-a614505bf256:  Hold'em No Limit ($0.1/$0.20 USD) - 2021/11/20 10:10:00 ET
Table 'Bel Air' 6-max Seat #1 is the button
Seat 1: Player#0122 ($13.79 in chips)
Seat 2: Player#6403 ($15.96 in chips)
Seat 3: warioman ($25.74 in chips)
Seat 4: Player#2563 ($9.29 in chips)
Seat 5: Player#8465 ($15.49 in chips)
Seat 6: Player#7483 ($19.76 in chips)
Player#6403: posts small blind $0.10
warioman: posts big blind $0.20
*** HOLE CARDS ***
Dealt to warioman [Qc Jh]
Player#2563: calls $0.20
Player#8465: folds
Player#7483: calls $0.20
Player#0122: folds
Player#6403: folds
warioman: checks
*** FLOP *** [2h Qd Kh]
warioman: checks
Player#2563: checks
Player#7483: bets $0.70
warioman: folds
Player#2563: calls $0.70
*** TURN *** [2h Qd Kh] [Js]
Player#2563: checks
Player#7483: bets $2.10
Player#2563: calls $2.10
*** RIVER *** [2h Qd Kh] [Js] [7s]
Player#2563: checks
Player#7483: checks
*** SHOW DOWN *** 
Player#2563 collected $5.98 from pot
*** SUMMARY ***
Total Pot $6.30 | Rake $0.31
Board [2h Qd Kh Js 7s]
Seat 1: Player#0122 (button) folded before the flop
Seat 2: Player#6403 (small blind) folded before the flop
Seat 3: warioman (big blind) folded on the flop
Seat 4: Player#2563 shows [Td 9d] and won ($5.98) with 
Seat 5: Player#8465 folded before the flop
Seat 6: Player#7483 mucked

PokerStars Hand #db76d9d4-43ff-4f3b-b776-2d7a6f201bec:  Hold'em No Limit ($0.1/$0.20 USD) - 2021/11/20 10:09:00 ET
Table 'Bel Air' 6-max Seat #6 is the button
Seat 1: Player#7017 ($13.89 in chips)
Seat 2: Player#0002 ($16.16 in chips)
Seat 3: warioman ($25.74 in chips)
Seat 4: Player#0641 ($9.29 in chips)
Seat 5: Player#1306 ($15.49 in chips)
Seat 6: Player#3348 ($19.46 in chips)
Player#7017: posts small blind $0.10
Player#0002: posts big blind $0.20
*** HOLE CARDS ***
Dealt to warioman [9s 5h]
warioman: folds
Player#0641: folds
Player#1306: folds
Player#3348: raises $0.20 to $0.6
Player#7017: folds
Player#0002: folds
Player#3348: doesn't show hand
Uncalled bet ($0.60) returned to Player#3348
Player#3348 collected $0.30 from pot
*** SUMMARY ***
Total Pot $0.30 | Rake $0.00
Seat 1: Player#7017 (small blind) folded before the flop
Seat 2: Player#0002 (big blind) folded before the flop
Seat 3: warioman folded before the flop
Seat 4: Player#0641 folded before the flop
Seat 5: Player#1306 folded before the flop
Seat 6: Player#3348 shows [] and won ($0.30) with 

PokerStars Hand #6a5faeea-b7cc-48de-8091-c481252f6fa6:  Hold'em No Limit ($0.1/$0.20 USD) - 2021/11/20 10:09:00 ET
Table 'Bel Air' 6-max Seat #5 is the button
Seat 1: Player#8523 ($14.09 in chips)
Seat 2: Player#2139 ($16.16 in chips)
Seat 3: warioman ($25.74 in chips)
Seat 4: Player#0297 ($9.29 in chips)
Seat 5: Player#4580 ($15.19 in chips)
Seat 6: Player#0248 ($19.56 in chips)
Player#0248: posts small blind $0.10
Player#8523: posts big blind $0.20
*** HOLE CARDS ***
Dealt to warioman [3s 7h]
Player#2139: folds
warioman: folds
Player#0297: folds
Player#4580: raises $0.20 to $0.6
Player#0248: folds
Player#8523: folds
Player#4580: doesn't show hand
Uncalled bet ($0.60) returned to Player#4580
Player#4580 collected $0.30 from pot
*** SUMMARY ***
Total Pot $0.30 | Rake $0.00
Seat 1: Player#8523 (big blind) folded before the flop
Seat 2: Player#2139 folded before the flop
Seat 3: warioman folded before the flop
Seat 4: Player#0297 folded before the flop
Seat 5: Player#4580 shows [] and won ($0.30) with 
Seat 6: Player#0248 (small blind) folded before the flop

PokerStars Hand #e63c725a-f975-4ceb-9a84-45fdfd1dd042:  Hold'em No Limit ($0.05/$0.10 USD) - 2021/11/20 10:09:00 ET
Table 'Tempe' 6-max Seat #4 is the button
Seat 1: Player#0339 ($8.40 in chips)
Seat 2: Player#7920 ($24.48 in chips)
Seat 3: Player#7262 ($9.33 in chips)
Seat 4: Player#4978 ($12.86 in chips)
Seat 5: warioman ($14.35 in chips)
Seat 6: Player#6624 ($17.15 in chips)
warioman: posts small blind $0.05
Player#6624: posts big blind $0.10
*** HOLE CARDS ***
Dealt to warioman [4s Ac]
Player#0339: raises $0.10 to $0.3
Player#7920: raises $0.30 to $0.8
Player#7262: raises $0.80 to $2.3
Player#4978: folds
warioman: folds
Player#6624: folds
Player#0339: folds
Player#7920: raises $ 22.30 to $24.48
Player#7262: folds
Player#7920: doesn't show hand
Uncalled bet ($24.48) returned to Player#7920
Player#7920 collected $2.75 from pot
*** SUMMARY ***
Total Pot $2.75 | Rake $0.00
Seat 1: Player#0339 folded before the flop
Seat 2: Player#7920 shows [] and won ($2.75) with 
Seat 3: Player#7262 folded before the flop
Seat 4: Player#4978 (button) folded before the flop
Seat 5: warioman (small blind) folded before the flop
Seat 6: Player#6624 (big blind) folded before the flop

PokerStars Hand #a678186a-afda-4e99-91b3-34cbf25b8ef1:  Hold'em No Limit ($0.1/$0.20 USD) - 2021/11/20 10:09:00 ET
Table 'Bel Air' 6-max Seat #4 is the button
Seat 1: Player#0118 ($14.09 in chips)
Seat 2: Player#5451 ($16.16 in chips)
Seat 3: warioman ($25.74 in chips)
Seat 4: Player#5060 ($9.29 in chips)
Seat 5: Player#6370 ($14.99 in chips)
Seat 6: Player#8428 ($19.76 in chips)
Player#6370: posts small blind $0.10
Player#8428: posts big blind $0.20
*** HOLE CARDS ***
Dealt to warioman [2c 4c]
Player#0118: folds
Player#5451: folds
warioman: folds
Player#5060: folds
Player#6370: raises $0.20 to $0.6
Player#8428: folds
Player#6370: doesn't show hand
Uncalled bet ($0.60) returned to Player#6370
Player#6370 collected $0.20 from pot
*** SUMMARY ***
Total Pot $0.20 | Rake $0.00
Seat 1: Player#0118 folded before the flop
Seat 2: Player#5451 folded before the flop
Seat 3: warioman folded before the flop
Seat 4: Player#5060 (button) folded before the flop
Seat 5: Player#6370 shows [] and won ($0.20) with 
Seat 6: Player#8428 (big blind) folded before the flop

PokerStars Hand #09c6d23e-abe2-47b1-a398-21e45accf32d:  Hold'em No Limit ($0.1/$0.20 USD) - 2021/11/20 10:08:00 ET
Table 'Bel Air' 6-max Seat #3 is the button
Seat 1: Player#7263 ($14.09 in chips)
Seat 2: Player#4363 ($16.16 in chips)
Seat 3: warioman ($25.44 in chips)
Seat 4: Player#3104 ($9.39 in chips)
Seat 5: Player#1337 ($15.19 in chips)
Seat 6: Player#8595 ($19.76 in chips)
Player#3104: posts small blind $0.10
Player#1337: posts big blind $0.20
*** HOLE CARDS ***
Dealt to warioman [3h 3d]
Player#8595: folds
Player#7263: folds
Player#4363: folds
warioman: raises $0.20 to $0.5
Player#3104: folds
Player#1337: folds
warioman: doesn't show hand
Uncalled bet ($0.50) returned to warioman
warioman collected $0.30 from pot
*** SUMMARY ***
Total Pot $0.30 | Rake $0.00
Seat 1: Player#7263 folded before the flop
Seat 2: Player#4363 folded before the flop
Seat 3: warioman (button)
Seat 4: Player#3104 (small blind) folded before the flop
Seat 5: Player#1337 (big blind) folded before the flop
Seat 6: Player#8595 folded before the flop

PokerStars Hand #67780a28-2c58-42de-9875-1f924a69353e:  Hold'em No Limit ($0.05/$0.10 USD) - 2021/11/20 10:08:00 ET
Table 'Tempe' 6-max Seat #3 is the button
Seat 1: Player#9984 ($8.70 in chips)
Seat 2: Player#9298 ($23.73 in chips)
Seat 3: Player#9145 ($9.33 in chips)
Seat 4: Player#3041 ($12.91 in chips)
Seat 5: warioman ($14.45 in chips)
Seat 6: Player#3007 ($17.45 in chips)
Player#3041: posts small blind $0.05
warioman: posts big blind $0.10
*** HOLE CARDS ***
Dealt to warioman [Kh 8c]
Player#3007: raises $0.10 to $0.3
Player#9984: calls $0.30
Player#9298: raises0.30 to $1
Player#9145: folds
Player#3041: folds
warioman: folds
Player#3007: folds
Player#9984: folds
Player#9298: doesn't show hand
Uncalled bet ($1.00) returned to Player#9298
Player#9298 collected $0.75 from pot
*** SUMMARY ***
Total Pot $0.75 | Rake $0.00
Seat 1: Player#9984 folded before the flop
Seat 2: Player#9298 shows [] and won ($0.75) with 
Seat 3: Player#9145 (button) folded before the flop
Seat 4: Player#3041 (small blind) folded before the flop
Seat 5: warioman (big blind) folded before the flop
Seat 6: Player#3007 folded before the flop

PokerStars Hand #52bd0072-7d33-41e5-8a10-a19dfaea27d9:  Hold'em No Limit ($0.1/$0.20 USD) - 2021/11/20 10:08:00 ET
Table 'Bel Air' 6-max Seat #2 is the button
Seat 1: Player#2907 ($14.09 in chips)
Seat 2: Player#6756 ($16.16 in chips)
Seat 3: warioman ($25.54 in chips)
Seat 4: Player#0374 ($9.29 in chips)
Seat 5: Player#4014 ($15.19 in chips)
Seat 6: Player#2213 ($19.76 in chips)
warioman: posts small blind $0.10
Player#0374: posts big blind $0.20
*** HOLE CARDS ***
Dealt to warioman [3c 5h]
Player#4014: folds
Player#2213: folds
Player#2907: folds
Player#6756: folds
warioman: folds
Player#0374 collected $0.20 from pot
*** SUMMARY ***
Total Pot $0.20 | Rake $0.00
Seat 1: Player#2907 folded before the flop
Seat 2: Player#6756 (button) folded before the flop
Seat 3: warioman (small blind) folded before the flop
Seat 4: Player#0374 shows [] and won ($0.20) with 
Seat 5: Player#4014 folded before the flop
Seat 6: Player#2213 folded before the flop

PokerStars Hand #7c20f31e-6c30-458d-bebc-6b3ca582f5c5:  Hold'em No Limit ($0.1/$0.20 USD) - 2021/11/20 10:07:00 ET
Table 'Bel Air' 6-max Seat #1 is the button
Seat 1: Player#8034 ($14.09 in chips)
Seat 2: Player#3111 ($16.76 in chips)
Seat 3: warioman ($25.74 in chips)
Seat 4: Player#5911 ($7.99 in chips)
Seat 5: Player#9384 ($15.79 in chips)
Seat 6: Player#7665 ($19.76 in chips)
Player#3111: posts small blind $0.10
warioman: posts big blind $0.20
*** HOLE CARDS ***
Dealt to warioman [8d 7c]
Player#5911: calls $0.20
Player#9384: raises $0.20 to $0.6
Player#7665: folds
Player#8034: folds
Player#3111: calls $0.50
warioman: folds
Player#5911: calls $0.40
*** FLOP *** [Jd Ts 3c]
Player#3111: checks
Player#5911: checks
Player#9384: checks
*** TURN *** [Jd Ts 3c] [Ad]
Player#3111: checks
Player#5911: checks
Player#9384: checks
*** RIVER *** [Jd Ts 3c] [Ad] [8d]
Player#3111: checks
Player#5911: checks
Player#9384: checks
*** SHOW DOWN *** 
Player#5911 collected $1.90 from pot
*** SUMMARY ***
Total Pot $2.00 | Rake $0.10
Board [Jd Ts 3c Ad 8d]
Seat 1: Player#8034 (button) folded before the flop
Seat 2: Player#3111 (small blind) mucked
Seat 3: warioman (big blind) folded before the flop
Seat 4: Player#5911 shows [Js Qs] and won ($1.90) with 
Seat 5: Player#9384 mucked
Seat 6: Player#7665 folded before the flop

PokerStars Hand #8b54ab79-ca25-4ab7-8f4e-36ded4a0101a:  Hold'em No Limit ($0.05/$0.10 USD) - 2021/11/20 10:07:00 ET
Table 'Tempe' 6-max Seat #2 is the button
Seat 1: Player#6310 ($12.05 in chips)
Seat 2: Player#6857 ($19.86 in chips)
Seat 3: Player#9842 ($10.13 in chips)
Seat 4: Player#2261 ($13.01 in chips)
Seat 5: warioman ($14.45 in chips)
Seat 6: Player#6148 ($17.45 in chips)
Player#9842: posts small blind $0.05
Player#2261: posts big blind $0.10
*** HOLE CARDS ***
Dealt to warioman [4s 6c]
warioman: folds
Player#6148: folds
Player#6310: raises $0.10 to $0.3
Player#6857: raises $0.30 to $0.8
Player#9842: calls $0.75
Player#2261: folds
Player#6310: calls $0.50
*** FLOP *** [2c Tc Td]
Player#9842: checks
Player#6310: bets $0.75
Player#6857: calls $0.75
Player#9842: folds
*** TURN *** [2c Tc Td] [Ac]
Player#6310: checks
Player#6857: checks
*** RIVER *** [2c Tc Td] [Ac] [4c]
Player#6310: checks
Player#6857: bets $1.80
Player#6310: calls $1.80
*** SHOW DOWN *** 
Player#6310: doesn't show hand
Player#6857 collected $7.22 from pot
*** SUMMARY ***
Total Pot $7.60 | Rake $0.38
Board [2c Tc Td Ac 4c]
Seat 1: Player#6310 mucked
Seat 2: Player#6857 shows [Jc As] and won ($7.22) with 
Seat 3: Player#9842 (small blind) folded on the flop
Seat 4: Player#2261 (big blind) folded before the flop
Seat 5: warioman folded before the flop
Seat 6: Player#6148 folded before the flop

PokerStars Hand #25e3da37-8890-4c8f-9a58-0f333a20ffde:  Hold'em No Limit ($0.1/$0.20 USD) - 2021/11/20 10:06:00 ET
Table 'Bel Air' 6-max Seat #6 is the button
Seat 1: Player#9985 ($14.49 in chips)
Seat 2: Player#5235 ($16.96 in chips)
Seat 3: warioman ($25.74 in chips)
Seat 4: Player#7400 ($7.44 in chips)
Seat 5: Player#8507 ($15.79 in chips)
Seat 6: Player#3748 ($19.76 in chips)
Player#9985: posts small blind $0.10
Player#5235: posts big blind $0.20
*** HOLE CARDS ***
Dealt to warioman [Ts 9d]
warioman: folds
Player#7400: calls $0.20
Player#8507: folds
Player#3748: folds
Player#9985: calls $0.10
Player#5235: checks
*** FLOP *** [5d 6s 2d]
Player#9985: checks
Player#5235: checks
Player#7400: bets $0.20
Player#9985: calls $0.20
Player#5235: folds
*** TURN *** [5d 6s 2d] [4s]
Player#9985: checks
Player#7400: bets $1.00
Player#9985: folds
Player#7400: doesn't show hand
Uncalled bet ($1.00) returned to Player#7400
Player#7400 collected $0.95 from pot
*** SUMMARY ***
Total Pot $1.00 | Rake $0.05
Board [5d 6s 2d 4s]
Seat 1: Player#9985 (small blind) folded on the turn
Seat 2: Player#5235 (big blind) folded on the flop
Seat 3: warioman folded before the flop
Seat 4: Player#7400 shows [] and won ($0.95) with 
Seat 5: Player#8507 folded before the flop
Seat 6: Player#3748 (button) folded before the flop

PokerStars Hand #f53bc562-e80f-47c7-a4dd-b77cb79de71b:  Hold'em No Limit ($0.1/$0.20 USD) - 2021/11/20 10:06:00 ET
Table 'Bel Air' 6-max Seat #5 is the button
Seat 1: Player#6947 ($14.69 in chips)
Seat 2: Player#0271 ($16.96 in chips)
Seat 3: warioman ($26.24 in chips)
Seat 4: Player#7544 ($6.64 in chips)
Seat 5: Player#8792 ($15.79 in chips)
Seat 6: Player#3675 ($19.86 in chips)
Player#3675: posts small blind $0.10
Player#6947: posts big blind $0.20
*** HOLE CARDS ***
Dealt to warioman [Qc 9c]
Player#0271: folds
warioman: raises $0.20 to $0.5
Player#7544: raises $0.50 to $6.64
Player#8792: folds
Player#3675: folds
Player#6947: folds
warioman: folds
Player#7544: doesn't show hand
Uncalled bet ($6.64) returned to Player#7544
Player#7544 collected $0.80 from pot
*** SUMMARY ***
Total Pot $0.80 | Rake $0.00
Seat 1: Player#6947 (big blind) folded before the flop
Seat 2: Player#0271 folded before the flop
Seat 3: warioman folded before the flop
Seat 4: Player#7544 shows [] and won ($0.80) with 
Seat 5: Player#8792 (button) folded before the flop
Seat 6: Player#3675 (small blind) folded before the flop

PokerStars Hand #dc671f90-7f30-4a74-ae69-bac4efe9f801:  Hold'em No Limit ($0.05/$0.10 USD) - 2021/11/20 10:05:00 ET
Table 'Tempe' 6-max Seat #1 is the button
Seat 1: Player#9208 ($12.95 in chips)
Seat 2: Player#7843 ($19.96 in chips)
Seat 3: Player#9075 ($11.73 in chips)
Seat 4: Player#9303 ($10.62 in chips)
Seat 5: warioman ($14.45 in chips)
Seat 6: Player#4014 ($17.45 in chips)
Player#7843: posts small blind $0.05
Player#9075: posts big blind $0.10
*** HOLE CARDS ***
Dealt to warioman [8c Kh]
Player#9303: calls $0.10
warioman: folds
Player#4014: folds
Player#9208: calls $0.10
Player#7843: calls $0.05
Player#9075: checks
*** FLOP *** [Qc Td 9s]
Player#7843: checks
Player#9075: bets $0.20
Player#9303: calls $0.20
Player#9208: calls $0.20
Player#7843: folds
*** TURN *** [Qc Td 9s] [9c]
Player#9075: bets $0.60
Player#9303: calls $0.60
Player#9208: calls $0.60
*** RIVER *** [Qc Td 9s] [9c] [6c]
Player#9075: bets $0.70
Player#9303: calls $0.70
Player#9208: folds
*** SHOW DOWN *** 
Player#9303 collected $3.99 from pot
*** SUMMARY ***
Total Pot $4.20 | Rake $0.21
Board [Qc Td 9s 9c 6c]
Seat 1: Player#9208 (button) folded on the river
Seat 2: Player#7843 (small blind) folded on the flop
Seat 3: Player#9075 (big blind) mucked
Seat 4: Player#9303 shows [Kd Qd] and won ($3.99) with 
Seat 5: warioman folded before the flop
Seat 6: Player#4014 folded before the flop

PokerStars Hand #c1273260-5947-4336-93b6-04309e659bcd:  Hold'em No Limit ($0.05/$0.10 USD) - 2021/11/20 10:05:00 ET
Table 'Tempe' 6-max Seat #6 is the button
Seat 1: Player#9980 ($12.85 in chips)
Seat 2: Player#0923 ($20.06 in chips)
Seat 3: Player#4853 ($11.73 in chips)
Seat 4: Player#1039 ($10.62 in chips)
Seat 5: warioman ($14.45 in chips)
Seat 6: Player#9124 ($17.45 in chips)
Player#9980: posts small blind $0.05
Player#0923: posts big blind $0.10
*** HOLE CARDS ***
Dealt to warioman [Qd 3h]
Player#4853: folds
Player#1039: folds
warioman: folds
Player#9124: folds
Player#9980: raises $0.10 to $0.3
Player#0923: folds
Player#9980: doesn't show hand
Uncalled bet ($0.30) returned to Player#9980
Player#9980 collected $0.10 from pot
*** SUMMARY ***
Total Pot $0.10 | Rake $0.00
Seat 1: Player#9980 shows [] and won ($0.10) with 
Seat 2: Player#0923 (big blind) folded before the flop
Seat 3: Player#4853 folded before the flop
Seat 4: Player#1039 folded before the flop
Seat 5: warioman folded before the flop
Seat 6: Player#9124 (button) folded before the flop

PokerStars Hand #1763bc0f-f170-40c7-9f57-c3df8c0611dd:  Hold'em No Limit ($0.1/$0.20 USD) - 2021/11/20 10:05:00 ET
Table 'Bel Air' 6-max Seat #4 is the button
Seat 1: Player#9724 ($18.84 in chips)
Seat 2: Player#9482 ($12.37 in chips)
Seat 3: warioman ($26.24 in chips)
Seat 4: Player#3765 ($7.04 in chips)
Seat 5: Player#2069 ($15.89 in chips)
Seat 6: Player#4184 ($20.26 in chips)
Player#2069: posts small blind $0.10
Player#4184: posts big blind $0.20
*** HOLE CARDS ***
Dealt to warioman [8h Th]
Player#9724: raises $0.20 to $0.4
Player#9482: calls $0.40
warioman: folds
Player#3765: calls $0.40
Player#2069: folds
Player#4184: calls $0.20
*** FLOP *** [Jc 9h 5s]
Player#4184: checks
Player#9724: bets $0.40
Player#9482: raises $0.40 to $1.45
Player#3765: folds
Player#4184: folds
Player#9724: calls $1.05
*** TURN *** [Jc 9h 5s] [Kc]
Player#9724: bets $2.30
Player#9482: calls $2.30
*** RIVER *** [Jc 9h 5s] [Kc] [Qc]
Player#9724: checks
Player#9482: checks
*** SHOW DOWN *** 
Player#9482 collected $8.74 from pot
*** SUMMARY ***
Total Pot $9.20 | Rake $0.46
Board [Jc 9h 5s Kc Qc]
Seat 1: Player#9724 mucked
Seat 2: Player#9482 shows [Kd Kh] and won ($8.74) with 
Seat 3: warioman folded before the flop
Seat 4: Player#3765 (button) folded on the flop
Seat 5: Player#2069 (small blind) folded before the flop
Seat 6: Player#4184 (big blind) folded on the flop

PokerStars Hand #c1300bcc-a015-4f5e-bcce-96e35e640995:  Hold'em No Limit ($0.05/$0.10 USD) - 2021/11/20 10:05:00 ET
Table 'Tempe' 6-max Seat #5 is the button
Seat 1: Player#0994 ($12.95 in chips)
Seat 2: Player#3009 ($19.91 in chips)
Seat 3: Player#6031 ($11.73 in chips)
Seat 4: Player#0600 ($10.62 in chips)
Seat 5: warioman ($14.45 in chips)
Seat 6: Player#7937 ($17.50 in chips)
Player#7937: posts small blind $0.05
Player#0994: posts big blind $0.10
*** HOLE CARDS ***
Dealt to warioman [9c Qs]
Player#3009: raises $0.10 to $0.3
Player#6031: folds
Player#0600: folds
warioman: folds
Player#7937: folds
Player#0994: folds
Player#3009: doesn't show hand
Uncalled bet ($0.30) returned to Player#3009
Player#3009 collected $0.15 from pot
*** SUMMARY ***
Total Pot $0.15 | Rake $0.00
Seat 1: Player#0994 (big blind) folded before the flop
Seat 2: Player#3009 shows [] and won ($0.15) with 
Seat 3: Player#6031 folded before the flop
Seat 4: Player#0600 folded before the flop
Seat 5: warioman (button) folded before the flop
Seat 6: Player#7937 (small blind) folded before the flop

PokerStars Hand #547699f2-3926-4c15-9225-20f475b021d1:  Hold'em No Limit ($0.1/$0.20 USD) - 2021/11/20 10:04:00 ET
Table 'Bel Air' 6-max Seat #3 is the button
Seat 1: Player#5190 ($18.84 in chips)
Seat 2: Player#1104 ($12.37 in chips)
Seat 3: warioman ($23.28 in chips)
Seat 4: Player#6625 ($9.80 in chips)
Seat 5: Player#1275 ($16.39 in chips)
Seat 6: Player#6881 ($20.26 in chips)
Player#6625: posts small blind $0.10
Player#1275: posts big blind $0.20
*** HOLE CARDS ***
Dealt to warioman [9h 7h]
Player#6881: folds
Player#5190: folds
Player#1104: folds
warioman: raises $0.20 to $0.5
Player#6625: calls $0.40
Player#1275: calls $0.30
*** FLOP *** [8d 3h 5h]
Player#6625: checks
Player#1275: checks
warioman: bets $1.13
Player#6625: raises $1.13 to $2.26
Player#1275: folds
warioman: raises $ 22.26 to $22.78
Player#6625: folds
warioman: doesn't show hand
Uncalled bet ($22.78) returned to warioman
warioman collected $3.57 from pot
*** SUMMARY ***
Total Pot $3.76 | Rake $0.19
Board [8d 3h 5h]
Seat 1: Player#5190 folded before the flop
Seat 2: Player#1104 folded before the flop
Seat 3: warioman (button)
Seat 4: Player#6625 (small blind) folded on the flop
Seat 5: Player#1275 (big blind) folded on the flop
Seat 6: Player#6881 folded before the flop

PokerStars Hand #eb111dbf-bfe4-46a4-82d1-5437e0e2ee7d:  Hold'em No Limit ($0.05/$0.10 USD) - 2021/11/20 10:04:00 ET
Table 'Tempe' 6-max Seat #4 is the button
Seat 1: Player#6831 ($13.35 in chips)
Seat 2: Player#8354 ($19.91 in chips)
Seat 3: Player#1581 ($12.13 in chips)
Seat 4: Player#9174 ($11.02 in chips)
Seat 5: warioman ($14.50 in chips)
Seat 6: Player#5974 ($16.33 in chips)
warioman: posts small blind $0.05
Player#5974: posts big blind $0.10
*** HOLE CARDS ***
Dealt to warioman [9c Jd]
Player#6831: calls $0.10
Player#8354: folds
Player#1581: calls $0.10
Player#9174: calls $0.10
warioman: folds
Player#5974: checks
*** FLOP *** [9s 8h 6h]
Player#5974: bets $0.30
Player#6831: calls $0.30
Player#1581: calls $0.30
Player#9174: calls $0.30
*** TURN *** [9s 8h 6h] [6c]
Player#5974: checks
Player#6831: checks
Player#1581: checks
Player#9174: checks
*** RIVER *** [9s 8h 6h] [6c] [2c]
Player#5974: checks
Player#6831: checks
Player#1581: checks
Player#9174: checks
*** SHOW DOWN *** 
Player#5974 collected $1.57 from pot
*** SUMMARY ***
Total Pot $1.65 | Rake $0.08
Board [9s 8h 6h 6c 2c]
Seat 1: Player#6831 mucked
Seat 2: Player#8354 folded before the flop
Seat 3: Player#1581 mucked
Seat 4: Player#9174 (button) mucked
Seat 5: warioman (small blind) folded before the flop
Seat 6: Player#5974 shows [5s 8s] and won ($1.57) with 

PokerStars Hand #c6429938-0085-4b56-88bb-6f3636c5150e:  Hold'em No Limit ($0.1/$0.20 USD) - 2021/11/20 10:03:00 ET
Table 'Bel Air' 6-max Seat #2 is the button
Seat 1: Player#1354 ($18.84 in chips)
Seat 2: Player#0966 ($12.97 in chips)
Seat 3: warioman ($23.38 in chips)
Seat 4: Player#2261 ($10.00 in chips)
Seat 5: Player#2073 ($15.56 in chips)
Seat 6: Player#5798 ($20.26 in chips)
warioman: posts small blind $0.10
Player#2261: posts big blind $0.20
*** HOLE CARDS ***
Dealt to warioman [8c 7s]
Player#2073: raises $0.20 to $0.6
Player#5798: folds
Player#1354: folds
Player#0966: calls $0.60
warioman: folds
Player#2261: folds
*** FLOP *** [3c 5d 3h]
Player#2073: checks
Player#0966: checks
*** TURN *** [3c 5d 3h] [2h]
Player#2073: bets $0.75
Player#0966: folds
Player#2073: doesn't show hand
Uncalled bet ($0.75) returned to Player#2073
Player#2073 collected $1.43 from pot
*** SUMMARY ***
Total Pot $1.50 | Rake $0.08
Board [3c 5d 3h 2h]
Seat 1: Player#1354 folded before the flop
Seat 2: Player#0966 (button) folded on the turn
Seat 3: warioman (small blind) folded before the flop
Seat 4: Player#2261 (big blind) folded before the flop
Seat 5: Player#2073 shows [] and won ($1.43) with 
Seat 6: Player#5798 folded before the flop

PokerStars Hand #d9b6dde4-8dbb-419e-addb-2af4a7974913:  Hold'em No Limit ($0.1/$0.20 USD) - 2021/11/20 10:03:00 ET
Table 'Bel Air' 6-max Seat #3 is the button
Seat 1: Player#1541 ($18.20 in chips)
Seat 2: Player#0508 ($13.07 in chips)
Seat 3: warioman ($23.98 in chips)
Seat 4: Player#9239 ($10.00 in chips)
Seat 5: Player#0056 ($15.56 in chips)
Seat 6: Player#9088 ($20.26 in chips)
Player#9239: posts small blind $0.10
Player#0508: posts big blind $0.20
*** HOLE CARDS ***
Dealt to warioman [9d 9h]
Player#9239 Waiting
Player#0056: folds
Player#9088: folds
Player#1541: calls $0.20
Player#0508: folds
warioman: checks
*** FLOP *** [4d 2s 4s]
warioman: checks
Player#1541: checks
*** TURN *** [4d 2s 4s] [6d]
warioman: bets $0.20
Player#1541: raises $0.20 to $0.4
warioman: calls $0.20
*** RIVER *** [4d 2s 4s] [6d] [Qd]
warioman: checks
Player#1541: bets $1.30
warioman: folds
Player#1541: doesn't show hand
Uncalled bet ($1.30) returned to Player#1541
Player#1541 collected $1.24 from pot
*** SUMMARY ***
Total Pot $1.30 | Rake $0.07
Board [4d 2s 4s 6d Qd]
Seat 1: Player#1541 shows [] and won ($1.24) with 
Seat 2: Player#0508 (big blind) folded before the flop
Seat 3: warioman (button) folded on the river
Seat 4: Player#9239 (small blind) mucked
Seat 5: Player#0056 folded before the flop
Seat 6: Player#9088 folded before the flop

PokerStars Hand #955e7c1f-1704-4762-8713-0742d211824c:  Hold'em No Limit ($0.05/$0.10 USD) - 2021/11/20 10:03:00 ET
Table 'Tempe' 6-max Seat #3 is the button
Seat 1: Player#9382 ($13.65 in chips)
Seat 2: Player#0412 ($19.91 in chips)
Seat 3: Player#5219 ($12.13 in chips)
Seat 4: Player#0062 ($11.32 in chips)
Seat 5: warioman ($14.60 in chips)
Seat 6: Player#6081 ($15.68 in chips)
Player#0062: posts small blind $0.05
warioman: posts big blind $0.10
*** HOLE CARDS ***
Dealt to warioman [Th 5d]
Player#6081: raises $0.10 to $0.3
Player#9382: calls $0.30
Player#0412: folds
Player#5219: folds
Player#0062: calls $0.25
warioman: folds
*** FLOP *** [5s Js 3c]
Player#0062: checks
Player#6081: checks
Player#9382: checks
*** TURN *** [5s Js 3c] [Qh]
Player#0062: checks
Player#6081: checks
Player#9382: checks
*** RIVER *** [5s Js 3c] [Qh] [Qh]
Player#0062: checks
Player#6081: checks
Player#9382: checks
*** SHOW DOWN *** 
Player#6081 collected $0.95 from pot
*** SUMMARY ***
Total Pot $1.00 | Rake $0.05
Board [5s Js 3c Qh Qh]
Seat 1: Player#9382 mucked
Seat 2: Player#0412 folded before the flop
Seat 3: Player#5219 (button) folded before the flop
Seat 4: Player#0062 (small blind) mucked
Seat 5: warioman (big blind) folded before the flop
Seat 6: Player#6081 shows [Ac Ts] and won ($0.95) with 

PokerStars Hand #8251fb65-2d72-434f-b1e1-77eee44ddb07:  Hold'em No Limit ($0.1/$0.20 USD) - 2021/11/20 10:02:00 ET
Table 'Bel Air' 6-max Seat #3 is the button
Seat 1: Player#1248 ($18.70 in chips)
Seat 2: Player#1459 ($13.27 in chips)
Seat 3: warioman ($23.34 in chips)
Seat 4: Player#9938 ($10.00 in chips)
Seat 5: Player#9037 ($15.56 in chips)
Seat 6: Player#2272 ($20.26 in chips)
Player#9938: posts small blind $0.10
Player#1248: posts big blind $0.20
*** HOLE CARDS ***
Dealt to warioman [Qs Kd]
Player#9938 Waiting
warioman: raises $0.20 to $0.5
Player#9037: folds
Player#2272: folds
Player#1248: calls $0.40
Player#1459: folds
*** FLOP *** [3h 3s Td]
Player#1248: checks
warioman: checks
*** TURN *** [3h 3s Td] [Qc]
Player#1248: checks
warioman: bets $0.36
Player#1248: folds
warioman: doesn't show hand
Uncalled bet ($0.36) returned to warioman
warioman collected $1.14 from pot
*** SUMMARY ***
Total Pot $1.20 | Rake $0.06
Board [3h 3s Td Qc]
Seat 1: Player#1248 (big blind) folded on the turn
Seat 2: Player#1459 folded before the flop
Seat 3: warioman (button)
Seat 4: Player#9938 (small blind) mucked
Seat 5: Player#9037 folded before the flop
Seat 6: Player#2272 folded before the flop

PokerStars Hand #8a344761-defa-429a-a9cc-1886e561d23f:  Hold'em No Limit ($0.05/$0.10 USD) - 2021/11/20 10:01:00 ET
Table 'Tempe' 6-max Seat #2 is the button
Seat 1: Player#7625 ($10.11 in chips)
Seat 2: Player#1380 ($19.91 in chips)
Seat 3: Player#3472 ($13.26 in chips)
Seat 4: Player#5527 ($11.42 in chips)
Seat 5: warioman ($14.60 in chips)
Seat 6: Player#5908 ($18.31 in chips)
Player#3472: posts small blind $0.05
Player#5527: posts big blind $0.10
*** HOLE CARDS ***
Dealt to warioman [8c Ts]
warioman: folds
Player#5908: raises $0.10 to $0.3
Player#7625: raises $0.30 to $0.53
Player#1380: folds
Player#3472: calls $0.48
Player#5527: folds
Player#5908: calls $0.23
*** FLOP *** [5s Th 2c]
Player#3472: bets $0.30
Player#5908: calls $0.30
Player#7625: calls $0.30
*** TURN *** [5s Th 2c] [Js]
Player#3472: checks
Player#5908: bets $0.30
Player#7625: calls $0.30
Player#3472: calls $0.30
*** RIVER *** [5s Th 2c] [Js] [As]
Player#3472: checks
Player#5908: bets $1.50
Player#7625: calls $1.50
Player#3472: folds
*** SHOW DOWN *** 
Player#7625 collected $6.17 from pot
*** SUMMARY ***
Total Pot $6.49 | Rake $0.32
Board [5s Th 2c Js As]
Seat 1: Player#7625 shows [As 8d] and won ($6.17) with 
Seat 2: Player#1380 (button) folded before the flop
Seat 3: Player#3472 (small blind) folded on the river
Seat 4: Player#5527 (big blind) folded before the flop
Seat 5: warioman folded before the flop
Seat 6: Player#5908 mucked

PokerStars Hand #1c342baf-e395-4dcd-8b00-e10a55d1d146:  Hold'em No Limit ($0.1/$0.20 USD) - 2021/11/20 10:01:00 ET
Table 'Bel Air' 6-max Seat #3 is the button
Seat 1: Player#4381 ($17.85 in chips)
Seat 2: Player#1543 ($13.27 in chips)
Seat 3: warioman ($24.17 in chips)
Seat 4: Player#3880 ($10.00 in chips)
Seat 5: Player#9179 ($15.56 in chips)
Seat 6: Player#6319 ($20.36 in chips)
Player#3880: posts small blind $0.10
Player#6319: posts big blind $0.20
*** HOLE CARDS ***
Dealt to warioman [Qh Ks]
Player#3880 Waiting
Player#1543: folds
warioman: raises $0.20 to $0.5
Player#9179: folds
Player#6319: folds
Player#4381: calls $0.30
*** FLOP *** [Td 2h 7d]
Player#4381: checks
warioman: checks
*** TURN *** [Td 2h 7d] [4s]
Player#4381: checks
warioman: bets $0.33
Player#4381: calls $0.33
*** RIVER *** [Td 2h 7d] [4s] [9s]
Player#4381: checks
warioman: checks
*** SHOW DOWN *** 
Player#4381 collected $1.67 from pot
*** SUMMARY ***
Total Pot $1.76 | Rake $0.09
Board [Td 2h 7d 4s 9s]
Seat 1: Player#4381 shows [Ah 4h] and won ($1.67) with 
Seat 2: Player#1543 folded before the flop
Seat 3: warioman (button)
Seat 4: Player#3880 (small blind) mucked
Seat 5: Player#9179 folded before the flop
Seat 6: Player#6319 (big blind) folded before the flop

PokerStars Hand #d032550f-9e46-4c08-8092-ff2cb032294f:  Hold'em No Limit ($0.1/$0.20 USD) - 2021/11/20 10:01:00 ET
Table 'Bel Air' 6-max Seat #4 is the button
Seat 1: Player#7687 ($17.85 in chips)
Seat 2: Player#9707 ($13.27 in chips)
Seat 3: warioman ($24.17 in chips)
Seat 4: Player#5143 ($10.00 in chips)
Seat 5: Player#4912 ($15.96 in chips)
Seat 6: Player#6754 ($20.00 in chips)
Player#4912: posts small blind $0.10
Player#6754: posts big blind $0.20
*** HOLE CARDS ***
Dealt to warioman [Ts 7c]
Player#7687: folds
Player#9707: folds
warioman: folds
Player#4912: raises $0.20 to $0.4
Player#6754: calls $0.20
*** FLOP *** [9s Jd 5d]
Player#4912: checks
Player#6754: bets $0.60
Player#4912: folds
Player#6754: doesn't show hand
Uncalled bet ($0.60) returned to Player#6754
Player#6754 collected $0.76 from pot
*** SUMMARY ***
Total Pot $0.80 | Rake $0.04
Board [9s Jd 5d]
Seat 1: Player#7687 folded before the flop
Seat 2: Player#9707 folded before the flop
Seat 3: warioman folded before the flop
Seat 4: Player#5143 (button) mucked
Seat 5: Player#4912 (small blind) folded on the flop
Seat 6: Player#6754 shows [] and won ($0.76) with 

PokerStars Hand #fda61db6-603d-4109-bc02-0e29d45d045a:  Hold'em No Limit ($0.05/$0.10 USD) - 2021/11/20 10:00:00 ET
Table 'Tempe' 6-max Seat #1 is the button
Seat 1: Player#9042 ($8.95 in chips)
Seat 2: Player#8478 ($19.96 in chips)
Seat 3: Player#9265 ($13.36 in chips)
Seat 4: Player#5412 ($11.42 in chips)
Seat 5: warioman ($14.60 in chips)
Seat 6: Player#0646 ($19.44 in chips)
Player#8478: posts small blind $0.05
Player#9265: posts big blind $0.10
*** HOLE CARDS ***
Dealt to warioman [2s Ad]
Player#5412: folds
warioman: folds
Player#0646: raises $0.10 to $0.3
Player#9042: raises $0.30 to $0.53
Player#8478: folds
Player#9265: folds
Player#0646: calls $0.23
*** FLOP *** [7s Js 7c]
Player#0646: checks
Player#9042: checks
*** TURN *** [7s Js 7c] [Jc]
Player#0646: checks
Player#9042: checks
*** RIVER *** [7s Js 7c] [Jc] [5c]
Player#0646: checks
Player#9042: bets $0.60
Player#0646: calls $0.60
*** SHOW DOWN *** 
Player#0646: doesn't show hand
Player#9042 collected $2.29 from pot
*** SUMMARY ***
Total Pot $2.41 | Rake $0.12
Board [7s Js 7c Jc 5c]
Seat 1: Player#9042 shows [9c 8c] and won ($2.29) with 
Seat 2: Player#8478 (small blind) folded before the flop
Seat 3: Player#9265 (big blind) folded before the flop
Seat 4: Player#5412 folded before the flop
Seat 5: warioman folded before the flop
Seat 6: Player#0646 mucked

PokerStars Hand #aa30ef60-6ffb-4e50-9774-5235c2d3fcbd:  Hold'em No Limit ($0.1/$0.20 USD) - 2021/11/20 10:00:00 ET
Table 'Bel Air' 6-max Seat #4 is the button
Seat 1: Player#0970 ($8.46 in chips)
Seat 2: Player#7935 ($13.27 in chips)
Seat 3: warioman ($22.72 in chips)
Seat 4: Player#8909 ($16.16 in chips)
Seat 5: Player#0131 ($20.00 in chips)
Player#0131: posts small blind $0.10
warioman: posts big blind $0.20
*** HOLE CARDS ***
Dealt to warioman [Kh Ah]
Player#0131 Waiting
Player#0970: calls $0.20
Player#7935: folds
warioman: raises $0.20 to $1.4
Player#8909: folds
Player#0970: calls $1.20
*** FLOP *** [7d 5c Kd]
warioman: bets $1.70
Player#0970: folds
warioman: doesn't show hand
Uncalled bet ($1.70) returned to warioman
warioman collected $2.85 from pot
*** SUMMARY ***
Total Pot $3.00 | Rake $0.15
Board [7d 5c Kd]
Seat 1: Player#0970 folded on the flop
Seat 2: Player#7935 folded before the flop
Seat 3: warioman (big blind)
Seat 4: Player#8909 (button) folded before the flop
Seat 5: Player#0131 (small blind) mucked

PokerStars Hand #6fc06502-5c02-4418-93e7-2c9e9ad793fd:  Hold'em No Limit ($0.05/$0.10 USD) - 2021/11/20 09:59:00 ET
Table 'Tempe' 6-max Seat #6 is the button
Seat 1: Player#3480 ($10.30 in chips)
Seat 2: Player#5380 ($20.41 in chips)
Seat 3: Player#3705 ($13.81 in chips)
Seat 4: Player#0444 ($9.35 in chips)
Seat 5: warioman ($14.60 in chips)
Seat 6: Player#1979 ($19.44 in chips)
Player#3480: posts small blind $0.05
Player#5380: posts big blind $0.10
*** HOLE CARDS ***
Dealt to warioman [2d 8s]
Player#3705: raises $0.10 to $0.2
Player#0444: calls $0.20
warioman: folds
Player#1979: folds
Player#3480: raises $0.20 to $0.45
Player#5380: calls $0.35
Player#3705: calls $0.25
Player#0444: calls $0.25
*** FLOP *** [Qs 4s 6c]
Player#3480: bets $0.90
Player#5380: folds
Player#3705: folds
Player#0444: calls $0.90
*** TURN *** [Qs 4s 6c] [Ac]
Player#3480: checks
Player#0444: checks
*** RIVER *** [Qs 4s 6c] [Ac] [2c]
Player#3480: checks
Player#0444: checks
*** SHOW DOWN *** 
Player#0444 collected $3.42 from pot
*** SUMMARY ***
Total Pot $3.60 | Rake $0.18
Board [Qs 4s 6c Ac 2c]
Seat 1: Player#3480 (small blind) mucked
Seat 2: Player#5380 (big blind) folded on the flop
Seat 3: Player#3705 folded on the flop
Seat 4: Player#0444 shows [Js Jc] and won ($3.42) with 
Seat 5: warioman folded before the flop
Seat 6: Player#1979 (button) folded before the flop

PokerStars Hand #78e04a46-6026-4720-ae3a-f1c3663ebb36:  Hold'em No Limit ($0.1/$0.20 USD) - 2021/11/20 09:59:00 ET
Table 'Bel Air' 6-max Seat #4 is the button
Seat 1: Player#5659 ($8.46 in chips)
Seat 2: Player#9867 ($12.91 in chips)
Seat 3: warioman ($23.12 in chips)
Seat 4: Player#4269 ($16.16 in chips)
Seat 5: Player#5201 ($20.00 in chips)
Player#5201: posts small blind $0.10
Player#9867: posts big blind $0.20
*** HOLE CARDS ***
Dealt to warioman [7d 7h]
Player#5201 Waiting
Player#4269: folds
Player#5659: folds
Player#9867: raises $0.20 to $0.4
warioman: calls $0.20
*** FLOP *** [Kh Th Kd]
Player#9867: checks
warioman: checks
*** TURN *** [Kh Th Kd] [8c]
Player#9867: checks
warioman: checks
*** RIVER *** [Kh Th Kd] [8c] [Ac]
Player#9867: checks
warioman: checks
*** SHOW DOWN *** 
Player#9867 collected $0.76 from pot
*** SUMMARY ***
Total Pot $0.80 | Rake $0.04
Board [Kh Th Kd 8c Ac]
Seat 1: Player#5659 folded before the flop
Seat 2: Player#9867 shows [Jc Jh] and won ($0.76) with 
Seat 3: warioman
Seat 4: Player#4269 (button) folded before the flop
Seat 5: Player#5201 (small blind) mucked

PokerStars Hand #9487dc5d-397d-492d-8bec-e0d834c7e245:  Hold'em No Limit ($0.05/$0.10 USD) - 2021/11/20 09:59:00 ET
Table 'Tempe' 6-max Seat #5 is the button
Seat 1: Player#9727 ($10.00 in chips)
Seat 2: Player#8056 ($20.41 in chips)
Seat 3: Player#2780 ($13.81 in chips)
Seat 4: Player#6606 ($9.35 in chips)
Seat 5: warioman ($14.60 in chips)
Seat 6: Player#7646 ($19.74 in chips)
Player#7646: posts small blind $0.05
Player#9727: posts big blind $0.10
*** HOLE CARDS ***
Dealt to warioman [7s Jh]
Player#8056: folds
Player#2780: folds
Player#6606: folds
warioman: folds
Player#7646: raises $0.10 to $0.3
Player#9727: raises $0.30 to $0.6
Player#7646: folds
Player#9727: doesn't show hand
Uncalled bet ($0.60) returned to Player#9727
Player#9727 collected $0.30 from pot
*** SUMMARY ***
Total Pot $0.30 | Rake $0.00
Seat 1: Player#9727 shows [] and won ($0.30) with 
Seat 2: Player#8056 folded before the flop
Seat 3: Player#2780 folded before the flop
Seat 4: Player#6606 folded before the flop
Seat 5: warioman (button) folded before the flop
Seat 6: Player#7646 (small blind) folded before the flop

PokerStars Hand #ba741a91-c299-4038-8b3e-f677045c0255:  Hold'em No Limit ($0.1/$0.20 USD) - 2021/11/20 09:58:00 ET
Table 'Bel Air' 6-max Seat #6 is the button
Seat 1: Player#7136 ($8.56 in chips)
Seat 2: Player#6154 ($14.86 in chips)
Seat 3: warioman ($21.27 in chips)
Seat 4: Player#3204 ($16.16 in chips)
Player#7136: posts small blind $0.10
Player#6154: posts big blind $0.20
*** HOLE CARDS ***
Dealt to warioman [Kd Th]
warioman: raises $0.20 to $0.5
Player#3204: folds
Player#7136: folds
Player#6154: calls $0.30
*** FLOP *** [Js Ad Jd]
Player#6154: checks
warioman: bets $0.33
Player#6154: calls $0.33
*** TURN *** [Js Ad Jd] [8c]
Player#6154: checks
warioman: checks
*** RIVER *** [Js Ad Jd] [8c] [Qc]
Player#6154: checks
warioman: bets $1.12
Player#6154: calls $1.12
*** SHOW DOWN *** 
Player#6154: doesn't show hand
warioman collected $3.80 from pot
*** SUMMARY ***
Total Pot $4.00 | Rake $0.20
Board [Js Ad Jd 8c Qc]
Seat 1: Player#7136 (small blind) folded before the flop
Seat 2: Player#6154 (big blind) mucked
Seat 3: warioman
Seat 4: Player#3204 folded before the flop

PokerStars Hand #983be8ab-c1df-49f5-9172-d53d67ac2107:  Hold'em No Limit ($0.1/$0.20 USD) - 2021/11/20 09:57:00 ET
Table 'Bel Air' 6-max Seat #4 is the button
Seat 1: Player#8463 ($8.76 in chips)
Seat 2: Player#8407 ($14.86 in chips)
Seat 3: warioman ($21.27 in chips)
Seat 4: Player#4491 ($12.08 in chips)
Seat 5: Player#1652 ($16.26 in chips)
Seat 6: Player#3965 ($26.63 in chips)
Player#1652: posts small blind $0.10
Player#8463: posts big blind $0.20
*** HOLE CARDS ***
Dealt to warioman [Kd 7h]
Player#3965 Decline Entry Bet
Player#8407: folds
warioman: folds
Player#4491: calls $0.20
Player#1652: folds
Player#8463: checks
*** FLOP *** [5d 5s 2h]
Player#8463: checks
Player#4491: checks
*** TURN *** [5d 5s 2h] [6d]
Player#8463: checks
Player#4491: checks
*** RIVER *** [5d 5s 2h] [6d] [6d]
Player#8463: checks
Player#4491: bets $0.50
Player#8463: folds
Player#4491: doesn't show hand
Uncalled bet ($0.50) returned to Player#4491
Player#4491 collected $0.47 from pot
*** SUMMARY ***
Total Pot $0.50 | Rake $0.03
Board [5d 5s 2h 6d 6d]
Seat 1: Player#8463 (big blind) folded on the river
Seat 2: Player#8407 folded before the flop
Seat 3: warioman folded before the flop
Seat 4: Player#4491 shows [] and won ($0.47) with 
Seat 5: Player#1652 (small blind) folded before the flop
Seat 6: Player#3965 mucked

PokerStars Hand #96b55b7a-cbdf-4f8d-be54-360201a8438f:  Hold'em No Limit ($0.05/$0.10 USD) - 2021/11/20 09:57:00 ET
Table 'Tempe' 6-max Seat #4 is the button
Seat 1: Player#5601 ($8.12 in chips)
Seat 2: Player#1024 ($17.31 in chips)
Seat 3: Player#7966 ($13.81 in chips)
Seat 4: Player#8911 ($9.35 in chips)
Seat 5: warioman ($14.65 in chips)
Seat 6: Player#4061 ($19.84 in chips)
warioman: posts small blind $0.05
Player#4061: posts big blind $0.10
*** HOLE CARDS ***
Dealt to warioman [8h 7c]
Player#5601: raises $0.10 to $0.3
Player#1024: raises $0.30 to $0.79
Player#7966: folds
Player#8911: folds
warioman: folds
Player#4061: folds
Player#5601: calls $0.49
*** FLOP *** [Qs 9s Kc]
Player#5601: bets $0.86
Player#1024: calls $0.86
*** TURN *** [Qs 9s Kc] [Th]
Player#5601: checks
Player#1024: bets $1.63
Player#5601: calls $1.63
*** RIVER *** [Qs 9s Kc] [Th] [5h]
Player#5601: checks
Player#1024: bets $3.35
Player#5601: folds
Player#1024: doesn't show hand
Uncalled bet ($3.35) returned to Player#1024
Player#1024 collected $6.37 from pot
*** SUMMARY ***
Total Pot $6.71 | Rake $0.34
Board [Qs 9s Kc Th 5h]
Seat 1: Player#5601 folded on the river
Seat 2: Player#1024 shows [] and won ($6.37) with 
Seat 3: Player#7966 folded before the flop
Seat 4: Player#8911 (button) folded before the flop
Seat 5: warioman (small blind) folded before the flop
Seat 6: Player#4061 (big blind) folded before the flop

PokerStars Hand #0bfa3b62-8b5b-486c-8d34-2d5ce5e64fe6:  Hold'em No Limit ($0.05/$0.10 USD) - 2021/11/20 09:57:00 ET
Table 'Tempe' 6-max Seat #3 is the button
Seat 1: Player#5549 ($10.00 in chips)
Seat 2: Player#9781 ($17.61 in chips)
Seat 3: Player#4566 ($11.69 in chips)
Seat 4: Player#5704 ($9.40 in chips)
Seat 5: warioman ($14.75 in chips)
Seat 6: Player#8380 ($19.84 in chips)
Player#5704: posts small blind $0.05
warioman: posts big blind $0.10
*** HOLE CARDS ***
Dealt to warioman [3c 5h]
Player#8380: folds
Player#5549: raises $0.10 to $0.3
Player#9781: calls $0.30
Player#4566: calls $0.30
Player#5704: folds
warioman: folds
*** FLOP *** [6c 4s Ah]
Player#5549: bets $0.53
Player#9781: folds
Player#4566: calls $0.53
*** TURN *** [6c 4s Ah] [Kh]
Player#5549: bets $1.05
Player#4566: calls $1.05
*** RIVER *** [6c 4s Ah] [Kh] [8h]
Player#5549: checks
Player#4566: checks
*** SHOW DOWN *** 
Player#4566 collected $4.00 from pot
*** SUMMARY ***
Total Pot $4.21 | Rake $0.21
Board [6c 4s Ah Kh 8h]
Seat 1: Player#5549 mucked
Seat 2: Player#9781 folded on the flop
Seat 3: Player#4566 shows [Ad 2c] and won ($4.00) with 
Seat 4: Player#5704 (small blind) folded before the flop
Seat 5: warioman (big blind) folded before the flop
Seat 6: Player#8380 folded before the flop

PokerStars Hand #b2f56548-b75a-4a25-bb46-58d989d4e613:  Hold'em No Limit ($0.1/$0.20 USD) - 2021/11/20 09:57:00 ET
Table 'Bel Air' 6-max Seat #3 is the button
Seat 1: Player#1982 ($8.76 in chips)
Seat 2: Player#3794 ($14.86 in chips)
Seat 3: warioman ($21.27 in chips)
Seat 4: Player#0354 ($13.28 in chips)
Seat 5: Player#2734 ($15.18 in chips)
Seat 6: Player#9158 ($26.63 in chips)
Player#0354: posts small blind $0.10
Player#2734: posts big blind $0.20
*** HOLE CARDS ***
Dealt to warioman [6d Jc]
Player#9158: folds
Player#1982: folds
Player#3794: folds
warioman: folds
Player#0354: calls $0.10
Player#2734: raises $0.20 to $0.6
Player#0354: calls $0.40
*** FLOP *** [3h 2c 7s]
Player#0354: checks
Player#2734: bets $0.60
Player#0354: calls $0.60
*** TURN *** [3h 2c 7s] [8s]
Player#0354: checks
Player#2734: checks
*** RIVER *** [3h 2c 7s] [8s] [9s]
Player#0354: checks
Player#2734: checks
*** SHOW DOWN *** 
Player#2734 collected $2.28 from pot
*** SUMMARY ***
Total Pot $2.40 | Rake $0.12
Board [3h 2c 7s 8s 9s]
Seat 1: Player#1982 folded before the flop
Seat 2: Player#3794 folded before the flop
Seat 3: warioman (button) folded before the flop
Seat 4: Player#0354 (small blind) mucked
Seat 5: Player#2734 shows [5s 5c] and won ($2.28) with 
Seat 6: Player#9158 folded before the flop

PokerStars Hand #160cdb34-3c66-4005-a207-1e27d4faf7e8:  Hold'em No Limit ($0.1/$0.20 USD) - 2021/11/20 09:56:00 ET
Table 'Bel Air' 6-max Seat #2 is the button
Seat 1: Player#8129 ($8.76 in chips)
Seat 2: Player#2910 ($14.86 in chips)
Seat 3: warioman ($21.37 in chips)
Seat 4: Player#8521 ($13.18 in chips)
Seat 5: Player#7427 ($15.18 in chips)
Seat 6: Player#4805 ($26.63 in chips)
warioman: posts small blind $0.10
Player#8521: posts big blind $0.20
*** HOLE CARDS ***
Dealt to warioman [8s 3c]
Player#7427: folds
Player#4805: folds
Player#8129: folds
Player#2910: folds
warioman: folds
Player#8521 collected $0.20 from pot
*** SUMMARY ***
Total Pot $0.20 | Rake $0.00
Seat 1: Player#8129 folded before the flop
Seat 2: Player#2910 (button) folded before the flop
Seat 3: warioman (small blind) folded before the flop
Seat 4: Player#8521 shows [] and won ($0.20) with 
Seat 5: Player#7427 folded before the flop
Seat 6: Player#4805 folded before the flop

PokerStars Hand #573616b0-f075-4e71-b68b-ff7103778b09:  Hold'em No Limit ($0.05/$0.10 USD) - 2021/11/20 09:56:00 ET
Table 'Tempe' 6-max Seat #2 is the button
Seat 1: Player#0994 ($7.31 in chips)
Seat 2: Player#0594 ($17.61 in chips)
Seat 3: Player#2803 ($10.83 in chips)
Seat 4: Player#3457 ($9.50 in chips)
Seat 5: warioman ($14.75 in chips)
Seat 6: Player#6927 ($19.84 in chips)
Player#2803: posts small blind $0.05
Player#3457: posts big blind $0.10
*** HOLE CARDS ***
Dealt to warioman [6d Jc]
warioman: folds
Player#6927: folds
Player#0994: calls $0.10
Player#0594: folds
Player#2803: raises $0.10 to $0.4
Player#3457: folds
Player#0994: calls $0.30
*** FLOP *** [Js 3s Ad]
Player#2803: checks
Player#0994: bets $0.45
Player#2803: calls $0.45
*** TURN *** [Js 3s Ad] [7h]
Player#2803: checks
Player#0994: checks
*** RIVER *** [Js 3s Ad] [7h] [8h]
Player#2803: bets $1.80
Player#0994: folds
Player#2803: doesn't show hand
Uncalled bet ($1.80) returned to Player#2803
Player#2803 collected $1.71 from pot
*** SUMMARY ***
Total Pot $1.80 | Rake $0.09
Board [Js 3s Ad 7h 8h]
Seat 1: Player#0994 folded on the river
Seat 2: Player#0594 (button) folded before the flop
Seat 3: Player#2803 shows [] and won ($1.71) with 
Seat 4: Player#3457 (big blind) folded before the flop
Seat 5: warioman folded before the flop
Seat 6: Player#6927 folded before the flop

PokerStars Hand #baee2502-74ea-45ee-ad08-049d86888a97:  Hold'em No Limit ($0.1/$0.20 USD) - 2021/11/20 09:55:00 ET
Table 'Bel Air' 6-max Seat #1 is the button
Seat 1: Player#1400 ($13.91 in chips)
Seat 2: Player#2641 ($14.96 in chips)
Seat 3: warioman ($21.57 in chips)
Seat 4: Player#7136 ($13.18 in chips)
Seat 5: Player#7162 ($10.26 in chips)
Seat 6: Player#6475 ($26.63 in chips)
Player#2641: posts small blind $0.10
warioman: posts big blind $0.20
*** HOLE CARDS ***
Dealt to warioman [3c Qs]
Player#7136: folds
Player#7162: raises $0.20 to $0.6
Player#6475: folds
Player#1400: calls $0.60
Player#2641: folds
warioman: folds
*** FLOP *** [6c 2s 2c]
Player#7162: checks
Player#1400: bets $1.50
Player#7162: calls $1.50
*** TURN *** [6c 2s 2c] [4c]
Player#7162: checks
Player#1400: checks
*** RIVER *** [6c 2s 2c] [4c] [9c]
Player#7162: bets $3.05
Player#1400: calls $3.05
*** SHOW DOWN *** 
Player#1400: doesn't show hand
Player#7162 collected $10.07 from pot
*** SUMMARY ***
Total Pot $10.60 | Rake $0.53
Board [6c 2s 2c 4c 9c]
Seat 1: Player#1400 (button) mucked
Seat 2: Player#2641 (small blind) folded before the flop
Seat 3: warioman (big blind) folded before the flop
Seat 4: Player#7136 folded before the flop
Seat 5: Player#7162 shows [Ac Jc] and won ($10.07) with 
Seat 6: Player#6475 folded before the flop

PokerStars Hand #8045ec3c-b28e-4046-b41c-bb612a96f4e1:  Hold'em No Limit ($0.05/$0.10 USD) - 2021/11/20 09:55:00 ET
Table 'Tempe' 6-max Seat #1 is the button
Seat 1: Player#0342 ($12.41 in chips)
Seat 2: Player#6066 ($17.66 in chips)
Seat 3: Player#3273 ($5.52 in chips)
Seat 4: Player#3943 ($9.50 in chips)
Seat 5: warioman ($14.75 in chips)
Seat 6: Player#0731 ($20.54 in chips)
Player#6066: posts small blind $0.05
Player#3273: posts big blind $0.10
*** HOLE CARDS ***
Dealt to warioman [3s 8s]
Player#3943: folds
warioman: folds
Player#0731: raises $0.10 to $0.3
Player#0342: calls $0.30
Player#6066: folds
Player#3273: calls $0.20
*** FLOP *** [5s Tc Jh]
Player#3273: checks
Player#0731: bets $0.40
Player#0342: calls $0.40
Player#3273: calls $0.40
*** TURN *** [5s Tc Jh] [Qh]
Player#3273: checks
Player#0731: checks
Player#0342: bets $1.07
Player#3273: raises $1.07 to $2.6
Player#0731: folds
Player#0342: calls $1.53
*** RIVER *** [5s Tc Jh] [Qh] [2h]
Player#3273: bets $1.80
Player#0342: calls $1.80
*** SHOW DOWN *** 
Player#0342: doesn't show hand
Player#3273 collected $10.40 from pot
*** SUMMARY ***
Total Pot $10.95 | Rake $0.55
Board [5s Tc Jh Qh 2h]
Seat 1: Player#0342 (button) mucked
Seat 2: Player#6066 (small blind) folded before the flop
Seat 3: Player#3273 shows [Ah Ks] and won ($10.40) with 
Seat 4: Player#3943 folded before the flop
Seat 5: warioman folded before the flop
Seat 6: Player#0731 folded on the turn

PokerStars Hand #1dc6f6b3-3da8-4279-bd3d-45e248d10cf4:  Hold'em No Limit ($0.1/$0.20 USD) - 2021/11/20 09:55:00 ET
Table 'Bel Air' 6-max Seat #6 is the button
Seat 1: Player#1171 ($14.51 in chips)
Seat 2: Player#3001 ($15.16 in chips)
Seat 3: warioman ($21.57 in chips)
Seat 4: Player#5777 ($13.18 in chips)
Seat 5: Player#9357 ($10.26 in chips)
Seat 6: Player#4874 ($25.90 in chips)
Player#1171: posts small blind $0.10
Player#3001: posts big blind $0.20
*** HOLE CARDS ***
Dealt to warioman [Kd 9c]
warioman: folds
Player#5777: folds
Player#9357: folds
Player#4874: raises $0.20 to $0.6
Player#1171: calls $0.50
Player#3001: folds
*** FLOP *** [7d 8d 5d]
Player#1171: checks
Player#4874: bets $0.50
Player#1171: folds
Player#4874: doesn't show hand
Uncalled bet ($0.50) returned to Player#4874
Player#4874 collected $1.33 from pot
*** SUMMARY ***
Total Pot $1.40 | Rake $0.07
Board [7d 8d 5d]
Seat 1: Player#1171 (small blind) folded on the flop
Seat 2: Player#3001 (big blind) folded before the flop
Seat 3: warioman folded before the flop
Seat 4: Player#5777 folded before the flop
Seat 5: Player#9357 folded before the flop
Seat 6: Player#4874 shows [] and won ($1.33) with 

PokerStars Hand #d6cdf2fd-58d0-40e1-a26a-4941b0759ff6:  Hold'em No Limit ($0.05/$0.10 USD) - 2021/11/20 09:54:00 ET
Table 'Tempe' 6-max Seat #6 is the button
Seat 1: Player#0188 ($12.46 in chips)
Seat 2: Player#2588 ($18.56 in chips)
Seat 3: Player#0314 ($4.66 in chips)
Seat 4: Player#3883 ($9.50 in chips)
Seat 5: warioman ($14.75 in chips)
Seat 6: Player#1088 ($20.54 in chips)
Player#0188: posts small blind $0.05
Player#2588: posts big blind $0.10
*** HOLE CARDS ***
Dealt to warioman [Qs 8d]
Player#0314: raises $0.10 to $0.4
Player#3883: folds
warioman: folds
Player#1088: folds
Player#0188: folds
Player#2588: calls $0.30
*** FLOP *** [6c 5s Js]
Player#2588: checks
Player#0314: bets $0.50
Player#2588: calls $0.50
*** TURN *** [6c 5s Js] [Kd]
Player#2588: checks
Player#0314: checks
*** RIVER *** [6c 5s Js] [Kd] [6d]
Player#2588: checks
Player#0314: checks
*** SHOW DOWN *** 
Player#0314 collected $1.76 from pot
*** SUMMARY ***
Total Pot $1.85 | Rake $0.09
Board [6c 5s Js Kd 6d]
Seat 1: Player#0188 (small blind) folded before the flop
Seat 2: Player#2588 (big blind) mucked
Seat 3: Player#0314 shows [4s 4h] and won ($1.76) with 
Seat 4: Player#3883 folded before the flop
Seat 5: warioman folded before the flop
Seat 6: Player#1088 (button) folded before the flop

PokerStars Hand #8942f5b5-419a-41cd-8598-be97c765b8bc:  Hold'em No Limit ($0.1/$0.20 USD) - 2021/11/20 09:54:00 ET
Table 'Bel Air' 6-max Seat #5 is the button
Seat 1: Player#9848 ($14.71 in chips)
Seat 2: Player#2807 ($15.16 in chips)
Seat 3: warioman ($21.57 in chips)
Seat 4: Player#4249 ($13.18 in chips)
Seat 5: Player#0618 ($10.26 in chips)
Seat 6: Player#1241 ($25.70 in chips)
Player#1241: posts small blind $0.10
Player#9848: posts big blind $0.20
*** HOLE CARDS ***
Dealt to warioman [3d 7c]
Player#2807: folds
warioman: folds
Player#4249: folds
Player#0618: folds
Player#1241: raises $0.20 to $0.6
Player#9848: folds
Player#1241: doesn't show hand
Uncalled bet ($0.60) returned to Player#1241
Player#1241 collected $0.20 from pot
*** SUMMARY ***
Total Pot $0.20 | Rake $0.00
Seat 1: Player#9848 (big blind) folded before the flop
Seat 2: Player#2807 folded before the flop
Seat 3: warioman folded before the flop
Seat 4: Player#4249 folded before the flop
Seat 5: Player#0618 (button) folded before the flop
Seat 6: Player#1241 shows [] and won ($0.20) with 

PokerStars Hand #b7208884-370b-4bd4-81fb-b20db805d1c2:  Hold'em No Limit ($0.05/$0.10 USD) - 2021/11/20 09:54:00 ET
Table 'Tempe' 6-max Seat #5 is the button
Seat 1: Player#7908 ($10.66 in chips)
Seat 2: Player#5276 ($18.56 in chips)
Seat 3: Player#4338 ($6.60 in chips)
Seat 4: Player#6207 ($9.50 in chips)
Seat 5: warioman ($14.75 in chips)
Seat 6: Player#5175 ($20.59 in chips)
Player#5175: posts small blind $0.05
Player#7908: posts big blind $0.10
*** HOLE CARDS ***
Dealt to warioman [4c 2h]
Player#5276: folds
Player#4338: calls $0.10
Player#6207: folds
warioman: folds
Player#5175: folds
Player#7908: raises $0.10 to $0.3
Player#4338: calls $0.20
*** FLOP *** [3d 6s 6c]
Player#7908: bets $0.33
Player#4338: calls $0.33
*** TURN *** [3d 6s 6c] [7s]
Player#7908: checks
Player#4338: checks
*** RIVER *** [3d 6s 6c] [7s] [Js]
Player#7908: bets $1.31
Player#4338: calls $1.31
*** SHOW DOWN *** 
Player#7908: doesn't show hand
Player#5276: doesn't show hand
Player#4338: doesn't show hand
Player#6207: doesn't show hand
warioman: doesn't show hand
Player#5175: doesn't show hand
Player#7908 collected $3.73 from pot
*** SUMMARY ***
Total Pot $3.93 | Rake $0.20
Board [3d 6s 6c 7s Js]
Seat 1: Player#7908 shows [5h 6h] and won ($3.73) with 
Seat 2: Player#5276 folded before the flop
Seat 3: Player#4338 mucked
Seat 4: Player#6207 folded before the flop
Seat 5: warioman (button) folded before the flop
Seat 6: Player#5175 (small blind) folded before the flop

PokerStars Hand #bdc475be-a2c0-433d-9fcb-91ec0655cbe6:  Hold'em No Limit ($0.05/$0.10 USD) - 2021/11/20 09:53:00 ET
Table 'Tempe' 6-max Seat #4 is the button
Seat 1: Player#4090 ($10.34 in chips)
Seat 2: Player#1320 ($18.56 in chips)
Seat 3: Player#5687 ($6.60 in chips)
Seat 4: Player#3445 ($9.50 in chips)
Seat 5: warioman ($14.80 in chips)
Seat 6: Player#8710 ($20.89 in chips)
warioman: posts small blind $0.05
Player#8710: posts big blind $0.10
*** HOLE CARDS ***
Dealt to warioman [Qh Kc]
Player#4090: raises $0.10 to $0.3
Player#1320: folds
Player#5687: folds
Player#3445: folds
warioman: folds
Player#8710: calls $0.20
*** FLOP *** [Ks Ts 3h]
Player#8710: checks
Player#4090: bets $0.33
Player#8710: folds
Player#4090: doesn't show hand
Uncalled bet ($0.33) returned to Player#4090
Player#4090 collected $0.62 from pot
*** SUMMARY ***
Total Pot $0.65 | Rake $0.03
Board [Ks Ts 3h]
Seat 1: Player#4090 shows [] and won ($0.62) with 
Seat 2: Player#1320 folded before the flop
Seat 3: Player#5687 folded before the flop
Seat 4: Player#3445 (button) folded before the flop
Seat 5: warioman (small blind) folded before the flop
Seat 6: Player#8710 (big blind) folded on the flop

PokerStars Hand #a48c5973-074d-49af-a223-e9a341056b3b:  Hold'em No Limit ($0.1/$0.20 USD) - 2021/11/20 09:53:00 ET
Table 'Bel Air' 6-max Seat #4 is the button
Seat 1: Player#0484 ($14.43 in chips)
Seat 2: Player#2205 ($15.16 in chips)
Seat 3: warioman ($21.57 in chips)
Seat 4: Player#2927 ($13.18 in chips)
Seat 5: Player#0514 ($10.36 in chips)
Seat 6: Player#2075 ($25.90 in chips)
Player#0514: posts small blind $0.10
Player#2075: posts big blind $0.20
*** HOLE CARDS ***
Dealt to warioman [As 6h]
Player#0484: calls $0.20
Player#2205: folds
warioman: folds
Player#2927: folds
Player#0514: folds
Player#2075: checks
*** FLOP *** [7h Qc 2s]
Player#2075: checks
Player#0484: checks
*** TURN *** [7h Qc 2s] [Qd]
Player#2075: checks
Player#0484: bets $0.50
Player#2075: folds
Player#0484: doesn't show hand
Uncalled bet ($0.50) returned to Player#0484
Player#0484 collected $0.47 from pot
*** SUMMARY ***
Total Pot $0.50 | Rake $0.03
Board [7h Qc 2s Qd]
Seat 1: Player#0484 shows [] and won ($0.47) with 
Seat 2: Player#2205 folded before the flop
Seat 3: warioman folded before the flop
Seat 4: Player#2927 (button) folded before the flop
Seat 5: Player#0514 (small blind) folded before the flop
Seat 6: Player#2075 (big blind) folded on the turn

PokerStars Hand #b6d41aab-2c22-4823-9417-d8362ab77659:  Hold'em No Limit ($0.05/$0.10 USD) - 2021/11/20 09:52:00 ET
Table 'Tempe' 6-max Seat #3 is the button
Seat 1: Player#7884 ($10.64 in chips)
Seat 2: Player#8457 ($19.86 in chips)
Seat 3: Player#0785 ($5.00 in chips)
Seat 4: Player#3150 ($9.55 in chips)
Seat 5: warioman ($14.90 in chips)
Seat 6: Player#3988 ($20.89 in chips)
Player#3150: posts small blind $0.05
warioman: posts big blind $0.10
*** HOLE CARDS ***
Dealt to warioman [9h 5h]
Player#3988: folds
Player#7884: raises $0.10 to $0.3
Player#8457: raises $0.30 to $0.8
Player#0785: calls $0.80
Player#3150: folds
warioman: folds
Player#7884: folds
*** FLOP *** [Kc Th 2d]
Player#8457: bets $0.50
Player#0785: raises $0.50 to $1.5
Player#8457: folds
Player#0785: doesn't show hand
Uncalled bet ($1.50) returned to Player#0785
Player#0785 collected $2.42 from pot
*** SUMMARY ***
Total Pot $2.55 | Rake $0.13
Board [Kc Th 2d]
Seat 1: Player#7884 folded before the flop
Seat 2: Player#8457 folded on the flop
Seat 3: Player#0785 shows [] and won ($2.42) with 
Seat 4: Player#3150 (small blind) folded before the flop
Seat 5: warioman (big blind) folded before the flop
Seat 6: Player#3988 folded before the flop

PokerStars Hand #1e4db119-1c05-4dbd-bcf2-6ca2aa611a21:  Hold'em No Limit ($0.1/$0.20 USD) - 2021/11/20 09:52:00 ET
Table 'Bel Air' 6-max Seat #3 is the button
Seat 1: Player#1670 ($15.23 in chips)
Seat 2: Player#7710 ($15.96 in chips)
Seat 3: warioman ($21.57 in chips)
Seat 4: Player#4540 ($13.28 in chips)
Seat 5: Player#3111 ($8.78 in chips)
Seat 6: Player#7743 ($25.90 in chips)
Player#4540: posts small blind $0.10
Player#3111: posts big blind $0.20
*** HOLE CARDS ***
Dealt to warioman [5d 8d]
Player#7743: folds
Player#1670: calls $0.20
Player#7710: calls $0.20
warioman: folds
Player#4540: folds
Player#3111: raises $0.20 to $0.8
Player#1670: calls $0.60
Player#7710: calls $0.60
*** FLOP *** [3h 8s Kd]
Player#3111: checks
Player#1670: checks
Player#7710: checks
*** TURN *** [3h 8s Kd] [2s]
Player#3111: checks
Player#1670: checks
Player#7710: checks
*** RIVER *** [3h 8s Kd] [2s] [4s]
Player#3111: bets $1.45
Player#1670: folds
Player#7710: folds
Player#3111: doesn't show hand
Uncalled bet ($1.45) returned to Player#3111
Player#3111 collected $2.38 from pot
*** SUMMARY ***
Total Pot $2.50 | Rake $0.12
Board [3h 8s Kd 2s 4s]
Seat 1: Player#1670 folded on the river
Seat 2: Player#7710 folded on the river
Seat 3: warioman (button) folded before the flop
Seat 4: Player#4540 (small blind) folded before the flop
Seat 5: Player#3111 shows [] and won ($2.38) with 
Seat 6: Player#7743 folded before the flop

PokerStars Hand #ffe4070a-f8bd-4b41-a98a-24b924b338fe:  Hold'em No Limit ($0.05/$0.10 USD) - 2021/11/20 09:51:00 ET
Table 'Tempe' 6-max Seat #2 is the button
Seat 1: Player#2930 ($10.32 in chips)
Seat 2: Player#3783 ($19.86 in chips)
Seat 3: Player#6096 ($5.05 in chips)
Seat 4: Player#5938 ($9.85 in chips)
Seat 5: warioman ($14.90 in chips)
Seat 6: Player#3286 ($20.89 in chips)
Player#6096: posts small blind $0.05
Player#5938: posts big blind $0.10
*** HOLE CARDS ***
Dealt to warioman [Jc 3d]
warioman: folds
Player#3286: folds
Player#2930: raises $0.10 to $0.3
Player#3783: folds
Player#6096: folds
Player#5938: calls $0.20
*** FLOP *** [2s Qc 7h]
Player#5938: checks
Player#2930: checks
*** TURN *** [2s Qc 7h] [Js]
Player#5938: checks
Player#2930: bets $0.33
Player#5938: folds
Player#2930: doesn't show hand
Uncalled bet ($0.33) returned to Player#2930
Player#2930 collected $0.62 from pot
*** SUMMARY ***
Total Pot $0.65 | Rake $0.03
Board [2s Qc 7h Js]
Seat 1: Player#2930 shows [] and won ($0.62) with 
Seat 2: Player#3783 (button) folded before the flop
Seat 3: Player#6096 (small blind) folded before the flop
Seat 4: Player#5938 (big blind) folded on the turn
Seat 5: warioman folded before the flop
Seat 6: Player#3286 folded before the flop

PokerStars Hand #beb52e25-59fc-4ee2-a1fa-46de4a42b7af:  Hold'em No Limit ($0.1/$0.20 USD) - 2021/11/20 09:51:00 ET
Table 'Bel Air' 6-max Seat #2 is the button
Seat 1: Player#3252 ($15.23 in chips)
Seat 2: Player#9744 ($15.96 in chips)
Seat 3: warioman ($21.67 in chips)
Seat 4: Player#6071 ($13.88 in chips)
Seat 5: Player#0694 ($7.57 in chips)
Seat 6: Player#7852 ($26.50 in chips)
warioman: posts small blind $0.10
Player#6071: posts big blind $0.20
*** HOLE CARDS ***
Dealt to warioman [Jd 6s]
Player#0694: raises $0.20 to $0.6
Player#7852: calls $0.60
Player#3252: folds
Player#9744: folds
warioman: folds
Player#6071: calls $0.40
*** FLOP *** [Qh 8d 6h]
Player#6071: checks
Player#0694: checks
Player#7852: checks
*** TURN *** [Qh 8d 6h] [7s]
Player#6071: checks
Player#0694: bets $0.95
Player#7852: folds
Player#6071: folds
Player#0694: doesn't show hand
Uncalled bet ($0.95) returned to Player#0694
Player#0694 collected $1.80 from pot
*** SUMMARY ***
Total Pot $1.90 | Rake $0.09
Board [Qh 8d 6h 7s]
Seat 1: Player#3252 folded before the flop
Seat 2: Player#9744 (button) folded before the flop
Seat 3: warioman (small blind) folded before the flop
Seat 4: Player#6071 (big blind) folded on the turn
Seat 5: Player#0694 shows [] and won ($1.80) with 
Seat 6: Player#7852 folded on the turn

PokerStars Hand #bb250c8e-b6fb-4227-90dc-8b3bc6394246:  Hold'em No Limit ($0.05/$0.10 USD) - 2021/11/20 09:50:00 ET
Table 'Tempe' 6-max Seat #1 is the button
Seat 1: Player#1782 ($10.00 in chips)
Seat 2: Player#8238 ($19.91 in chips)
Seat 3: Player#6862 ($5.35 in chips)
Seat 4: Player#7600 ($9.85 in chips)
Seat 5: warioman ($14.90 in chips)
Seat 6: Player#5755 ($20.89 in chips)
Player#8238: posts small blind $0.05
Player#6862: posts big blind $0.10
*** HOLE CARDS ***
Dealt to warioman [9c 8s]
Player#7600: folds
warioman: folds
Player#5755: folds
Player#1782: raises $0.10 to $0.3
Player#8238: folds
Player#6862: calls $0.20
*** FLOP *** [7s Jh 2c]
Player#6862: checks
Player#1782: bets $0.33
Player#6862: folds
Player#1782: doesn't show hand
Uncalled bet ($0.33) returned to Player#1782
Player#1782 collected $0.62 from pot
*** SUMMARY ***
Total Pot $0.65 | Rake $0.03
Board [7s Jh 2c]
Seat 1: Player#1782 shows [] and won ($0.62) with 
Seat 2: Player#8238 (small blind) folded before the flop
Seat 3: Player#6862 (big blind) folded on the flop
Seat 4: Player#7600 folded before the flop
Seat 5: warioman folded before the flop
Seat 6: Player#5755 folded before the flop

PokerStars Hand #f3b57e73-8a97-4b71-885f-65f3fe506182:  Hold'em No Limit ($0.1/$0.20 USD) - 2021/11/20 09:50:00 ET
Table 'Bel Air' 6-max Seat #1 is the button
Seat 1: Player#1988 ($17.63 in chips)
Seat 2: Player#1844 ($13.61 in chips)
Seat 3: warioman ($21.87 in chips)
Seat 4: Player#8425 ($13.88 in chips)
Seat 5: Player#5511 ($7.57 in chips)
Seat 6: Player#5317 ($26.50 in chips)
Player#1844: posts small blind $0.10
warioman: posts big blind $0.20
*** HOLE CARDS ***
Dealt to warioman [9c 3s]
Player#8425: folds
Player#5511: folds
Player#5317: folds
Player#1988: raises $0.20 to $0.6
Player#1844: calls $0.50
warioman: folds
*** FLOP *** [Qs 5h Ts]
Player#1844: checks
Player#1988: bets $0.60
Player#1844: calls $0.60
*** TURN *** [Qs 5h Ts] [6s]
Player#1844: checks
Player#1988: bets $0.60
Player#1844: calls $0.60
*** RIVER *** [Qs 5h Ts] [6s] [6s]
Player#1844: checks
Player#1988: bets $0.60
Player#1844: calls $0.60
*** SHOW DOWN *** 
Player#1844 collected $4.75 from pot
*** SUMMARY ***
Total Pot $5.00 | Rake $0.25
Board [Qs 5h Ts 6s 6s]
Seat 1: Player#1988 (button) mucked
Seat 2: Player#1844 shows [As Td] and won ($4.75) with 
Seat 3: warioman (big blind) folded before the flop
Seat 4: Player#8425 folded before the flop
Seat 5: Player#5511 folded before the flop
Seat 6: Player#5317 folded before the flop

PokerStars Hand #1c8adfed-72f2-4453-9727-476eff7dadef:  Hold'em No Limit ($0.05/$0.10 USD) - 2021/11/20 09:50:00 ET
Table 'Tempe' 6-max Seat #6 is the button
Seat 1: Player#5329 ($9.60 in chips)
Seat 2: Player#2397 ($19.77 in chips)
Seat 3: Player#0291 ($5.45 in chips)
Seat 4: Player#1131 ($9.85 in chips)
Seat 5: warioman ($14.90 in chips)
Seat 6: Player#4989 ($20.89 in chips)
Player#5329: posts small blind $0.05
Player#2397: posts big blind $0.10
*** HOLE CARDS ***
Dealt to warioman [2h 3h]
Player#0291: calls $0.10
Player#1131: folds
warioman: folds
Player#4989: folds
Player#5329: folds
Player#2397: checks
*** FLOP *** [Qh Qs Kc]
Player#2397: bets $0.10
Player#0291: folds
Player#2397: doesn't show hand
Uncalled bet ($0.10) returned to Player#2397
Player#2397 collected $0.24 from pot
*** SUMMARY ***
Total Pot $0.25 | Rake $0.01
Board [Qh Qs Kc]
Seat 1: Player#5329 (small blind) folded before the flop
Seat 2: Player#2397 shows [] and won ($0.24) with 
Seat 3: Player#0291 folded on the flop
Seat 4: Player#1131 folded before the flop
Seat 5: warioman folded before the flop
Seat 6: Player#4989 (button) folded before the flop

PokerStars Hand #506fe249-0d0c-47b9-9786-aaf2bf83636c:  Hold'em No Limit ($0.05/$0.10 USD) - 2021/11/20 09:49:00 ET
Table 'Tempe' 6-max Seat #5 is the button
Seat 1: Player#2925 ($6.82 in chips)
Seat 2: Player#4284 ($19.77 in chips)
Seat 3: Player#8916 ($4.95 in chips)
Seat 4: Player#0470 ($9.85 in chips)
Seat 5: warioman ($14.90 in chips)
Seat 6: Player#9404 ($20.94 in chips)
Player#9404: posts small blind $0.05
Player#2925: posts big blind $0.10
*** HOLE CARDS ***
Dealt to warioman [6c 5s]
Player#4284: folds
Player#8916: calls $0.10
Player#0470: folds
warioman: folds
Player#9404: folds
Player#2925: checks
*** FLOP *** [9s Jd 6h]
Player#2925: checks
Player#8916: bets $0.40
Player#2925: calls $0.40
*** TURN *** [9s Jd 6h] [Ad]
Player#2925: checks
Player#8916: checks
*** RIVER *** [9s Jd 6h] [Ad] [5d]
Player#2925: checks
Player#8916: checks
*** SHOW DOWN *** 
Player#8916 collected $1.00 from pot
*** SUMMARY ***
Total Pot $1.05 | Rake $0.05
Board [9s Jd 6h Ad 5d]
Seat 1: Player#2925 (big blind) mucked
Seat 2: Player#4284 folded before the flop
Seat 3: Player#8916 shows [Kd 9h] and won ($1.00) with 
Seat 4: Player#0470 folded before the flop
Seat 5: warioman (button) folded before the flop
Seat 6: Player#9404 (small blind) folded before the flop

PokerStars Hand #3ec3a349-4801-448d-957b-b6942db74ba8:  Hold'em No Limit ($0.1/$0.20 USD) - 2021/11/20 09:49:00 ET
Table 'Bel Air' 6-max Seat #6 is the button
Seat 1: Player#0560 ($18.43 in chips)
Seat 2: Player#4450 ($11.23 in chips)
Seat 3: warioman ($21.87 in chips)
Seat 4: Player#7693 ($15.68 in chips)
Seat 5: Player#1323 ($7.57 in chips)
Seat 6: Player#6169 ($26.50 in chips)
Player#0560: posts small blind $0.10
Player#4450: posts big blind $0.20
*** HOLE CARDS ***
Dealt to warioman [4d Jc]
warioman: folds
Player#7693: calls $0.20
Player#1323: folds
Player#6169: folds
Player#0560: calls $0.10
Player#4450: checks
*** FLOP *** [Tc 7s 8c]
Player#0560: checks
Player#4450: checks
Player#7693: bets $0.60
Player#0560: calls $0.60
Player#4450: calls $0.60
*** TURN *** [Tc 7s 8c] [5s]
Player#0560: checks
Player#4450: checks
Player#7693: bets $1.00
Player#0560: folds
Player#4450: calls $1.00
*** RIVER *** [Tc 7s 8c] [5s] [5s]
Player#4450: bets $3.20
Player#7693: folds
Player#4450: doesn't show hand
Uncalled bet ($3.20) returned to Player#4450
Player#4450 collected $4.18 from pot
*** SUMMARY ***
Total Pot $4.40 | Rake $0.22
Board [Tc 7s 8c 5s 5s]
Seat 1: Player#0560 (small blind) folded on the turn
Seat 2: Player#4450 shows [] and won ($4.18) with 
Seat 3: warioman folded before the flop
Seat 4: Player#7693 folded on the river
Seat 5: Player#1323 folded before the flop
Seat 6: Player#6169 (button) folded before the flop

PokerStars Hand #d6619468-4b37-4458-a49f-3c01c93f8b26:  Hold'em No Limit ($0.05/$0.10 USD) - 2021/11/20 09:49:00 ET
Table 'Tempe' 6-max Seat #4 is the button
Seat 1: Player#2827 ($7.12 in chips)
Seat 2: Player#5325 ($19.27 in chips)
Seat 3: Player#7327 ($5.00 in chips)
Seat 4: Player#1907 ($9.85 in chips)
Seat 5: warioman ($14.95 in chips)
Seat 6: Player#6257 ($21.04 in chips)
warioman: posts small blind $0.05
Player#6257: posts big blind $0.10
*** HOLE CARDS ***
Dealt to warioman [6h 8d]
Player#2827: raises $0.10 to $0.3
Player#5325: raises $0.30 to $0.8
Player#7327: folds
Player#1907: folds
warioman: folds
Player#6257: folds
Player#2827: folds
Player#5325: doesn't show hand
Uncalled bet ($0.80) returned to Player#5325
Player#5325 collected $0.50 from pot
*** SUMMARY ***
Total Pot $0.50 | Rake $0.00
Seat 1: Player#2827 folded before the flop
Seat 2: Player#5325 shows [] and won ($0.50) with 
Seat 3: Player#7327 folded before the flop
Seat 4: Player#1907 (button) folded before the flop
Seat 5: warioman (small blind) folded before the flop
Seat 6: Player#6257 (big blind) folded before the flop

PokerStars Hand #69eda00b-60d7-48ea-800b-44f35e7b57f4:  Hold'em No Limit ($0.05/$0.10 USD) - 2021/11/20 09:48:00 ET
Table 'Tempe' 6-max Seat #3 is the button
Seat 1: Player#4457 ($6.97 in chips)
Seat 2: Player#8179 ($19.27 in chips)
Seat 3: Player#0188 ($5.00 in chips)
Seat 4: Player#1612 ($9.90 in chips)
Seat 5: warioman ($15.05 in chips)
Seat 6: Player#5792 ($21.04 in chips)
Player#1612: posts small blind $0.05
warioman: posts big blind $0.10
*** HOLE CARDS ***
Dealt to warioman [3c 6h]
Player#5792: folds
Player#4457: raises $0.10 to $0.3
Player#8179: folds
Player#1612: folds
warioman: folds
Player#4457: doesn't show hand
Uncalled bet ($0.30) returned to Player#4457
Player#4457 collected $0.15 from pot
*** SUMMARY ***
Total Pot $0.15 | Rake $0.00
Seat 1: Player#4457 shows [] and won ($0.15) with 
Seat 2: Player#8179 folded before the flop
Seat 3: Player#0188 (button) mucked
Seat 4: Player#1612 (small blind) folded before the flop
Seat 5: warioman (big blind) folded before the flop
Seat 6: Player#5792 folded before the flop

PokerStars Hand #aeefcd1f-64bc-4e76-b77f-69214447c2f8:  Hold'em No Limit ($0.1/$0.20 USD) - 2021/11/20 09:48:00 ET
Table 'Bel Air' 6-max Seat #5 is the button
Seat 1: Player#1753 ($18.63 in chips)
Seat 2: Player#4951 ($11.23 in chips)
Seat 3: warioman ($21.87 in chips)
Seat 4: Player#3475 ($16.28 in chips)
Seat 5: Player#6800 ($6.74 in chips)
Seat 6: Player#9692 ($26.60 in chips)
Player#9692: posts small blind $0.10
Player#1753: posts big blind $0.20
*** HOLE CARDS ***
Dealt to warioman [Td Ah]
Player#4951: folds
warioman: folds
Player#3475: calls $0.20
Player#6800: raises $0.20 to $0.6
Player#9692: folds
Player#1753: folds
Player#3475: calls $0.40
*** FLOP *** [9d 4d 9s]
Player#3475: checks
Player#6800: checks
*** TURN *** [9d 4d 9s] [2h]
Player#3475: checks
Player#6800: bets $0.75
Player#3475: folds
Player#6800: doesn't show hand
Uncalled bet ($0.75) returned to Player#6800
Player#6800 collected $1.43 from pot
*** SUMMARY ***
Total Pot $1.50 | Rake $0.08
Board [9d 4d 9s 2h]
Seat 1: Player#1753 (big blind) folded before the flop
Seat 2: Player#4951 folded before the flop
Seat 3: warioman folded before the flop
Seat 4: Player#3475 folded on the turn
Seat 5: Player#6800 shows [] and won ($1.43) with 
Seat 6: Player#9692 (small blind) folded before the flop

PokerStars Hand #3d1389a1-7553-447b-8ea4-f60cc437345b:  Hold'em No Limit ($0.05/$0.10 USD) - 2021/11/20 09:48:00 ET
Table 'Tempe' 6-max Seat #2 is the button
Seat 1: Player#9052 ($6.87 in chips)
Seat 2: Player#6442 ($19.27 in chips)
Seat 3: Player#4756 ($10.00 in chips)
Seat 4: warioman ($15.05 in chips)
Seat 5: Player#7522 ($21.04 in chips)
Player#4756: posts small blind $0.05
Player#6442: posts big blind $0.10
*** HOLE CARDS ***
Dealt to warioman [Th 9c]
warioman: folds
Player#7522: folds
Player#9052: raises $0.10 to $0.3
Player#6442: folds
Player#4756: folds
Player#9052: doesn't show hand
Uncalled bet ($0.30) returned to Player#9052
Player#9052 collected $0.10 from pot
*** SUMMARY ***
Total Pot $0.10 | Rake $0.00
Seat 1: Player#9052 shows [] and won ($0.10) with 
Seat 2: Player#6442 (big blind) folded before the flop
Seat 3: Player#4756 (small blind) folded before the flop
Seat 4: warioman folded before the flop
Seat 5: Player#7522 folded before the flop

PokerStars Hand #2edc24eb-4e63-43a9-b855-94a0f68ad3de:  Hold'em No Limit ($0.1/$0.20 USD) - 2021/11/20 09:48:00 ET
Table 'Bel Air' 6-max Seat #4 is the button
Seat 1: Player#0720 ($18.83 in chips)
Seat 2: Player#0166 ($10.76 in chips)
Seat 3: warioman ($21.87 in chips)
Seat 4: Player#3515 ($16.28 in chips)
Seat 5: Player#0925 ($6.84 in chips)
Seat 6: Player#7596 ($26.80 in chips)
Player#0925: posts small blind $0.10
Player#7596: posts big blind $0.20
*** HOLE CARDS ***
Dealt to warioman [7c 9d]
Player#0720: calls $0.20
Player#0166: calls $0.20
warioman: folds
Player#3515: folds
Player#0925: folds
Player#7596: checks
*** FLOP *** [3s 4d 7d]
Player#7596: checks
Player#0720: checks
Player#0166: bets $0.40
Player#7596: folds
Player#0720: folds
Player#0166: doesn't show hand
Uncalled bet ($0.40) returned to Player#0166
Player#0166 collected $0.67 from pot
*** SUMMARY ***
Total Pot $0.70 | Rake $0.04
Board [3s 4d 7d]
Seat 1: Player#0720 folded on the flop
Seat 2: Player#0166 shows [] and won ($0.67) with 
Seat 3: warioman folded before the flop
Seat 4: Player#3515 (button) folded before the flop
Seat 5: Player#0925 (small blind) folded before the flop
Seat 6: Player#7596 (big blind) folded on the flop

PokerStars Hand #12d23b0e-36a5-43c2-868b-2539fbda10b1:  Hold'em No Limit ($0.05/$0.10 USD) - 2021/11/20 09:47:00 ET
Table 'Tempe' 6-max Seat #3 is the button
Seat 1: Player#1323 ($9.04 in chips)
Seat 2: Player#3175 ($19.32 in chips)
Seat 3: Player#0752 ($4.54 in chips)
Seat 4: Player#7501 ($10.00 in chips)
Seat 5: warioman ($15.05 in chips)
Seat 6: Player#0822 ($14.84 in chips)
Player#7501: posts small blind $0.05
Player#3175: posts big blind $0.10
*** HOLE CARDS ***
Dealt to warioman [8s 7h]
Player#7501 Waiting
warioman: folds
Player#0822: raises $0.10 to $0.3
Player#1323: raises $0.30 to $0.53
Player#3175: folds
Player#0752: calls $0.43
Player#0822: raises $0.53 to $2.17
Player#1323: calls $1.64
Player#0752: calls $1.64
*** FLOP *** [7s Kd Tc]
Player#0752: checks
Player#0822: bets $12.67
Player#1323: folds
Player#0752: calls $2.37
Player#0752 Showing Pocket Cards TA
Player#0822 Showing Pocket Cards QJ
*** TURN *** [7s Kd Tc] [Ac]
*** RIVER *** [7s Kd Tc] [Ac] [6h]
Player#0822 collected $20.52 from pot
*** SUMMARY ***
Total Pot $21.60 | Rake $1.08
Board [7s Kd Tc Ac 6h]
Seat 1: Player#1323 folded on the flop
Seat 2: Player#3175 (big blind) folded before the flop
Seat 3: Player#0752 (button) mucked
Seat 4: Player#7501 (small blind) mucked
Seat 5: warioman folded before the flop
Seat 6: Player#0822 shows [Qc Jc] and won ($20.52) with 

PokerStars Hand #a68c71c3-fb76-4f41-a5cd-955cc821137d:  Hold'em No Limit ($0.1/$0.20 USD) - 2021/11/20 09:47:00 ET
Table 'Bel Air' 6-max Seat #3 is the button
Seat 1: Player#5758 ($16.78 in chips)
Seat 2: Player#7967 ($11.36 in chips)
Seat 3: warioman ($21.87 in chips)
Seat 4: Player#1495 ($16.88 in chips)
Seat 5: Player#2998 ($7.04 in chips)
Seat 6: Player#9569 ($27.60 in chips)
Player#1495: posts small blind $0.10
Player#2998: posts big blind $0.20
*** HOLE CARDS ***
Dealt to warioman [5h Kc]
Player#9569: raises $0.20 to $0.6
Player#5758: calls $0.60
Player#7967: calls $0.60
warioman: folds
Player#1495: calls $0.50
Player#2998: folds
*** FLOP *** [9h 9s 9d]
Player#1495: checks
Player#9569: checks
Player#5758: checks
Player#7967: checks
*** TURN *** [9h 9s 9d] [2h]
Player#1495: checks
Player#9569: checks
Player#5758: checks
Player#7967: checks
*** RIVER *** [9h 9s 9d] [2h] [Ah]
Player#1495: checks
Player#9569: bets $0.20
Player#5758: raises $0.20 to $3.2
Player#7967: folds
Player#1495: folds
Player#9569: folds
Player#5758 Show
*** SHOW DOWN *** 
Uncalled bet ($3.20) returned to Player#5758
Player#5758 collected $2.66 from pot
*** SUMMARY ***
Total Pot $2.80 | Rake $0.14
Board [9h 9s 9d 2h Ah]
Seat 1: Player#5758 shows [9c Ac] and won ($2.66) with 
Seat 2: Player#7967 folded on the river
Seat 3: warioman (button) folded before the flop
Seat 4: Player#1495 (small blind) folded on the river
Seat 5: Player#2998 (big blind) folded before the flop
Seat 6: Player#9569 folded on the river

PokerStars Hand #5b1e7f94-ed11-46ce-8551-bf05218e111f:  Hold'em No Limit ($0.05/$0.10 USD) - 2021/11/20 09:47:00 ET
Table 'Tempe' 6-max Seat #3 is the button
Seat 1: Player#5215 ($9.64 in chips)
Seat 2: Player#0918 ($18.78 in chips)
Seat 3: Player#9381 ($4.54 in chips)
Seat 4: Player#5303 ($10.00 in chips)
Seat 5: warioman ($15.05 in chips)
Seat 6: Player#5196 ($14.84 in chips)
Player#5303: posts small blind $0.05
Player#5215: posts big blind $0.10
*** HOLE CARDS ***
Dealt to warioman [2c 5d]
Player#5303 Waiting
Player#9381: folds
warioman: folds
Player#5196: folds
Player#5215: raises $0.10 to $0.3
Player#0918: calls $0.20
*** FLOP *** [3d 7h 3h]
Player#5215: bets $0.30
Player#0918: raises $0.30 to $0.8
Player#5215: folds
Player#0918: doesn't show hand
Uncalled bet ($0.80) returned to Player#0918
Player#0918 collected $0.86 from pot
*** SUMMARY ***
Total Pot $0.90 | Rake $0.05
Board [3d 7h 3h]
Seat 1: Player#5215 (big blind) folded on the flop
Seat 2: Player#0918 shows [] and won ($0.86) with 
Seat 3: Player#9381 (button) folded before the flop
Seat 4: Player#5303 (small blind) mucked
Seat 5: warioman folded before the flop
Seat 6: Player#5196 folded before the flop

PokerStars Hand #502764e8-0924-42e3-9973-4168d4223c4c:  Hold'em No Limit ($0.1/$0.20 USD) - 2021/11/20 09:46:00 ET
Table 'Bel Air' 6-max Seat #2 is the button
Seat 1: Player#7411 ($16.78 in chips)
Seat 2: Player#4421 ($11.36 in chips)
Seat 3: warioman ($21.42 in chips)
Seat 4: Player#3365 ($17.38 in chips)
Seat 5: Player#5018 ($7.04 in chips)
Seat 6: Player#7152 ($27.60 in chips)
warioman: posts small blind $0.10
Player#3365: posts big blind $0.20
*** HOLE CARDS ***
Dealt to warioman [9c Tc]
Player#5018: folds
Player#7152: folds
Player#7411: folds
Player#4421: folds
warioman: raises $0.20 to $0.5
Player#3365: calls $0.30
*** FLOP *** [Jc 8c 4c]
warioman: bets $0.30
Player#3365: folds
warioman: doesn't show hand
Uncalled bet ($0.30) returned to warioman
warioman collected $0.95 from pot
*** SUMMARY ***
Total Pot $1.00 | Rake $0.05
Board [Jc 8c 4c]
Seat 1: Player#7411 folded before the flop
Seat 2: Player#4421 (button) folded before the flop
Seat 3: warioman (small blind)
Seat 4: Player#3365 (big blind) folded on the flop
Seat 5: Player#5018 folded before the flop
Seat 6: Player#7152 folded before the flop

PokerStars Hand #174ff7bf-d6a1-454e-8e9c-017bfbfdfaf4:  Hold'em No Limit ($0.05/$0.10 USD) - 2021/11/20 09:46:00 ET
Table 'Tempe' 6-max Seat #4 is the button
Seat 1: Player#7702 ($9.50 in chips)
Seat 2: Player#4236 ($18.78 in chips)
Seat 3: Player#8483 ($4.64 in chips)
Seat 4: warioman ($15.05 in chips)
Seat 5: Player#0864 ($14.89 in chips)
Player#0864: posts small blind $0.05
Player#7702: posts big blind $0.10
*** HOLE CARDS ***
Dealt to warioman [8d 6h]
Player#4236: folds
Player#8483: calls $0.10
warioman: folds
Player#0864: folds
Player#7702: checks
*** FLOP *** [4c Jd Ts]
Player#7702: checks
Player#8483: checks
*** TURN *** [4c Jd Ts] [Kd]
Player#7702: bets $0.25
Player#8483: folds
Player#7702: doesn't show hand
Uncalled bet ($0.25) returned to Player#7702
Player#7702 collected $0.24 from pot
*** SUMMARY ***
Total Pot $0.25 | Rake $0.01
Board [4c Jd Ts Kd]
Seat 1: Player#7702 shows [] and won ($0.24) with 
Seat 2: Player#4236 folded before the flop
Seat 3: Player#8483 folded on the turn
Seat 4: warioman (button) folded before the flop
Seat 5: Player#0864 (small blind) folded before the flop

PokerStars Hand #048105dd-53a8-4d03-b877-946a468a0091:  Hold'em No Limit ($0.1/$0.20 USD) - 2021/11/20 09:46:00 ET
Table 'Bel Air' 6-max Seat #1 is the button
Seat 1: Player#8260 ($16.78 in chips)
Seat 2: Player#4959 ($11.46 in chips)
Seat 3: warioman ($21.62 in chips)
Seat 4: Player#8878 ($17.38 in chips)
Seat 5: Player#2870 ($6.74 in chips)
Seat 6: Player#7837 ($27.60 in chips)
Player#4959: posts small blind $0.10
warioman: posts big blind $0.20
*** HOLE CARDS ***
Dealt to warioman [Kd 5h]
Player#8878: folds
Player#2870: raises $0.20 to $0.6
Player#7837: folds
Player#8260: folds
Player#4959: folds
warioman: folds
Player#2870: doesn't show hand
Uncalled bet ($0.60) returned to Player#2870
Player#2870 collected $0.30 from pot
*** SUMMARY ***
Total Pot $0.30 | Rake $0.00
Seat 1: Player#8260 (button) folded before the flop
Seat 2: Player#4959 (small blind) folded before the flop
Seat 3: warioman (big blind) folded before the flop
Seat 4: Player#8878 folded before the flop
Seat 5: Player#2870 shows [] and won ($0.30) with 
Seat 6: Player#7837 folded before the flop

PokerStars Hand #d4737adc-277d-4738-90f7-2d148e5e1ce2:  Hold'em No Limit ($0.1/$0.20 USD) - 2021/11/20 09:45:00 ET
Table 'Bel Air' 6-max Seat #6 is the button
Seat 1: Player#3599 ($16.88 in chips)
Seat 2: Player#2097 ($11.66 in chips)
Seat 3: warioman ($20.00 in chips)
Seat 4: Player#3000 ($18.86 in chips)
Seat 5: Player#1839 ($6.74 in chips)
Seat 6: Player#4245 ($27.60 in chips)
Player#3599: posts small blind $0.10
Player#2097: posts big blind $0.20
*** HOLE CARDS ***
Dealt to warioman [Qs Qh]
warioman: raises $0.20 to $0.5
Player#3000: calls $0.50
Player#1839: folds
Player#4245: folds
Player#3599: folds
Player#2097: folds
*** FLOP *** [Tc 6h 4h]
warioman: checks
Player#3000: checks
*** TURN *** [Tc 6h 4h] [Jh]
warioman: bets $0.98
Player#3000: calls $0.98
*** RIVER *** [Tc 6h 4h] [Jh] [Th]
warioman: checks
Player#3000: checks
*** SHOW DOWN *** 
warioman collected $3.10 from pot
*** SUMMARY ***
Total Pot $3.26 | Rake $0.16
Board [Tc 6h 4h Jh Th]
Seat 1: Player#3599 (small blind) folded before the flop
Seat 2: Player#2097 (big blind) folded before the flop
Seat 3: warioman
Seat 4: Player#3000 mucked
Seat 5: Player#1839 folded before the flop
Seat 6: Player#4245 (button) folded before the flop

PokerStars Hand #6bef48a7-4794-4a64-adbd-722b64fda6b9:  Hold'em No Limit ($0.05/$0.10 USD) - 2021/11/20 09:45:00 ET
Table 'Tempe' 6-max Seat #4 is the button
Seat 1: Player#2509 ($10.00 in chips)
Seat 2: Player#5519 ($18.78 in chips)
Seat 3: Player#1360 ($4.04 in chips)
Seat 4: Player#2843 ($12.78 in chips)
Seat 5: warioman ($15.10 in chips)
Seat 6: Player#1976 ($14.99 in chips)
warioman: posts small blind $0.05
Player#1976: posts big blind $0.10
*** HOLE CARDS ***
Dealt to warioman [Ah 5s]
Player#2509: calls $0.10
Player#5519: folds
Player#1360: calls $0.10
Player#2843: folds
warioman: folds
Player#1976: checks
*** FLOP *** [4d 3c Jh]
Player#1976: checks
Player#2509: checks
Player#1360: bets $0.10
Player#1976: folds
Player#2509: calls $0.10
*** TURN *** [4d 3c Jh] [2s]
Player#2509: checks
Player#1360: bets $0.30
Player#2509: calls $0.30
*** RIVER *** [4d 3c Jh] [2s] [6s]
Player#2509: checks
Player#1360: checks
*** SHOW DOWN *** 
Player#1360 collected $1.09 from pot
*** SUMMARY ***
Total Pot $1.15 | Rake $0.06
Board [4d 3c Jh 2s 6s]
Seat 1: Player#2509 mucked
Seat 2: Player#5519 folded before the flop
Seat 3: Player#1360 shows [Kh 9d] and won ($1.09) with 
Seat 4: Player#2843 (button) folded before the flop
Seat 5: warioman (small blind) folded before the flop
Seat 6: Player#1976 (big blind) folded on the flop

PokerStars Hand #0362ebbf-225b-43fd-b4b5-2c8b06da4fa2:  Hold'em No Limit ($0.1/$0.20 USD) - 2021/11/20 09:45:00 ET
Table 'Bel Air' 6-max Seat #5 is the button
Seat 1: Player#7774 ($17.08 in chips)
Seat 2: Player#4711 ($11.66 in chips)
Seat 3: warioman ($19.46 in chips)
Seat 4: Player#2007 ($19.36 in chips)
Seat 5: Player#7592 ($6.74 in chips)
Seat 6: Player#0797 ($26.48 in chips)
Player#0797: posts small blind $0.10
Player#7774: posts big blind $0.20
*** HOLE CARDS ***
Dealt to warioman [Qs As]
Player#4711: folds
warioman: raises $0.20 to $0.5
Player#2007: calls $0.50
Player#7592: folds
Player#0797: calls $0.40
Player#7774: folds
*** FLOP *** [7d 3d 9c]
Player#0797: bets $0.85
warioman: folds
Player#2007: folds
Player#0797: doesn't show hand
Uncalled bet ($0.85) returned to Player#0797
Player#0797 collected $1.61 from pot
*** SUMMARY ***
Total Pot $1.70 | Rake $0.08
Board [7d 3d 9c]
Seat 1: Player#7774 (big blind) folded before the flop
Seat 2: Player#4711 folded before the flop
Seat 3: warioman folded on the flop
Seat 4: Player#2007 folded on the flop
Seat 5: Player#7592 (button) folded before the flop
Seat 6: Player#0797 shows [] and won ($1.61) with 

PokerStars Hand #945ef9fd-e455-4e60-846c-9f47442edb3d:  Hold'em No Limit ($0.05/$0.10 USD) - 2021/11/20 09:45:00 ET
Table 'Tempe' 6-max Seat #3 is the button
Seat 1: Player#4664 ($8.60 in chips)
Seat 2: Player#4053 ($18.78 in chips)
Seat 3: Player#5227 ($3.62 in chips)
Seat 4: Player#8977 ($12.83 in chips)
Seat 5: warioman ($15.20 in chips)
Seat 6: Player#6542 ($15.29 in chips)
Player#8977: posts small blind $0.05
warioman: posts big blind $0.10
*** HOLE CARDS ***
Dealt to warioman [9h 2s]
Player#6542: raises $0.10 to $0.3
Player#4664: folds
Player#4053: folds
Player#5227: calls $0.30
Player#8977: folds
warioman: folds
*** FLOP *** [9s 6c 2d]
Player#6542: checks
Player#5227: bets $0.50
Player#6542: folds
Player#5227: doesn't show hand
Uncalled bet ($0.50) returned to Player#5227
Player#5227 collected $0.71 from pot
*** SUMMARY ***
Total Pot $0.75 | Rake $0.04
Board [9s 6c 2d]
Seat 1: Player#4664 folded before the flop
Seat 2: Player#4053 folded before the flop
Seat 3: Player#5227 shows [] and won ($0.71) with 
Seat 4: Player#8977 (small blind) folded before the flop
Seat 5: warioman (big blind) folded before the flop
Seat 6: Player#6542 folded on the flop

PokerStars Hand #8a182ee0-09bd-4e3f-90e0-1735f2153941:  Hold'em No Limit ($0.1/$0.20 USD) - 2021/11/20 09:43:00 ET
Table 'Bel Air' 6-max Seat #4 is the button
Seat 1: Player#9616 ($20.58 in chips)
Seat 2: Player#6964 ($11.66 in chips)
Seat 3: warioman ($20.96 in chips)
Seat 4: Player#0489 ($14.50 in chips)
Seat 5: Player#4672 ($6.84 in chips)
Seat 6: Player#1933 ($26.68 in chips)
Player#4672: posts small blind $0.10
Player#1933: posts big blind $0.20
*** HOLE CARDS ***
Dealt to warioman [Ts Th]
Player#9616: calls $0.20
Player#6964: folds
warioman: raises $0.20 to $0.5
Player#0489: calls $0.50
Player#4672: folds
Player#1933: folds
Player#9616: calls $0.30
*** FLOP *** [8c 8d 3c]
Player#9616: bets $0.40
warioman: raises0.40 to $1
Player#0489: calls $1.00
Player#9616: calls $0.60
*** TURN *** [8c 8d 3c] [9c]
Player#9616: checks
warioman: checks
Player#0489: checks
*** RIVER *** [8c 8d 3c] [9c] [6c]
Player#9616: checks
warioman: checks
Player#0489: bets $2.00
Player#9616: calls $2.00
warioman: folds
*** SHOW DOWN *** 
Player#9616: doesn't show hand
Player#6964: doesn't show hand
warioman: doesn't show hand
Player#0489: doesn't show hand
Player#4672: doesn't show hand
Player#1933: doesn't show hand
Player#0489 collected $8.36 from pot
*** SUMMARY ***
Total Pot $8.80 | Rake $0.44
Board [8c 8d 3c 9c 6c]
Seat 1: Player#9616 mucked
Seat 2: Player#6964 folded before the flop
Seat 3: warioman folded on the river
Seat 4: Player#0489 shows [Qd Qc] and won ($8.36) with 
Seat 5: Player#4672 (small blind) folded before the flop
Seat 6: Player#1933 (big blind) folded before the flop

PokerStars Hand #b8683d40-f222-492b-b505-b50bd72acf91:  Hold'em No Limit ($0.05/$0.10 USD) - 2021/11/20 09:43:00 ET
Table 'Tempe' 6-max Seat #2 is the button
Seat 1: Player#7280 ($9.70 in chips)
Seat 2: Player#1112 ($18.78 in chips)
Seat 3: Player#8182 ($5.02 in chips)
Seat 4: Player#6212 ($12.93 in chips)
Seat 5: warioman ($15.20 in chips)
Seat 6: Player#3974 ($12.89 in chips)
Player#8182: posts small blind $0.05
Player#6212: posts big blind $0.10
*** HOLE CARDS ***
Dealt to warioman [5s 2c]
warioman: folds
Player#3974: raises $0.10 to $0.3
Player#7280: calls $0.30
Player#1112: folds
Player#8182: calls $0.25
Player#6212: folds
*** FLOP *** [Tc Jd 7c]
Player#8182: bets $0.20
Player#3974: calls $0.20
Player#7280: calls $0.20
*** TURN *** [Tc Jd 7c] [Jc]
Player#8182: bets $0.60
Player#3974: calls $0.60
Player#7280: calls $0.60
*** RIVER *** [Tc Jd 7c] [Jc] [3c]
Player#8182: bets $0.30
Player#3974: raises0.30 to $4
Player#7280: folds
Player#8182: folds
Player#3974: doesn't show hand
Uncalled bet ($4.00) returned to Player#3974
Player#3974 collected $3.51 from pot
*** SUMMARY ***
Total Pot $3.70 | Rake $0.18
Board [Tc Jd 7c Jc 3c]
Seat 1: Player#7280 folded on the river
Seat 2: Player#1112 (button) folded before the flop
Seat 3: Player#8182 (small blind) folded on the river
Seat 4: Player#6212 (big blind) folded before the flop
Seat 5: warioman folded before the flop
Seat 6: Player#3974 shows [] and won ($3.51) with 

PokerStars Hand #f9e25e6b-fa3b-472a-8c02-8ab37927d8f1:  Hold'em No Limit ($0.05/$0.10 USD) - 2021/11/20 09:43:00 ET
Table 'Tempe' 6-max Seat #1 is the button
Seat 1: Player#0874 ($10.00 in chips)
Seat 2: Player#8516 ($18.83 in chips)
Seat 3: Player#8300 ($4.70 in chips)
Seat 4: Player#7228 ($12.93 in chips)
Seat 5: warioman ($15.20 in chips)
Seat 6: Player#8276 ($12.89 in chips)
Player#8516: posts small blind $0.05
Player#8300: posts big blind $0.10
*** HOLE CARDS ***
Dealt to warioman [Qc 6d]
Player#7228: folds
warioman: folds
Player#8276: folds
Player#0874: raises $0.10 to $0.3
Player#8516: folds
Player#8300: calls $0.20
*** FLOP *** [Jc 3h 9h]
Player#8300: bets $0.30
Player#0874: folds
Player#8300: doesn't show hand
Uncalled bet ($0.30) returned to Player#8300
Player#8300 collected $0.62 from pot
*** SUMMARY ***
Total Pot $0.65 | Rake $0.03
Board [Jc 3h 9h]
Seat 1: Player#0874 (button) folded on the flop
Seat 2: Player#8516 (small blind) folded before the flop
Seat 3: Player#8300 shows [] and won ($0.62) with 
Seat 4: Player#7228 folded before the flop
Seat 5: warioman folded before the flop
Seat 6: Player#8276 folded before the flop

PokerStars Hand #68c0ddf7-f8d7-4c0b-b8c0-36f1025cfa43:  Hold'em No Limit ($0.1/$0.20 USD) - 2021/11/20 09:42:00 ET
Table 'Bel Air' 6-max Seat #3 is the button
Seat 1: Player#0213 ($20.58 in chips)
Seat 2: Player#5586 ($12.16 in chips)
Seat 3: warioman ($21.46 in chips)
Seat 4: Player#9206 ($15.00 in chips)
Seat 5: Player#3021 ($5.44 in chips)
Seat 6: Player#1235 ($26.68 in chips)
Player#9206: posts small blind $0.10
Player#3021: posts big blind $0.20
*** HOLE CARDS ***
Dealt to warioman [6c 5c]
Player#1235: folds
Player#0213: folds
Player#5586: calls $0.20
warioman: raises $0.20 to $0.5
Player#9206: calls $0.40
Player#3021: calls $0.30
Player#5586: calls $0.30
*** FLOP *** [8c 9h Ad]
Player#9206: checks
Player#3021: checks
Player#5586: checks
warioman: checks
*** TURN *** [8c 9h Ad] [Kc]
Player#9206: checks
Player#3021: checks
Player#5586: checks
warioman: checks
*** RIVER *** [8c 9h Ad] [Kc] [Ac]
Player#9206: checks
Player#3021: bets $1.20
Player#5586: folds
warioman: folds
Player#9206: folds
Player#3021: doesn't show hand
Uncalled bet ($1.20) returned to Player#3021
Player#3021 collected $1.90 from pot
*** SUMMARY ***
Total Pot $2.00 | Rake $0.10
Board [8c 9h Ad Kc Ac]
Seat 1: Player#0213 folded before the flop
Seat 2: Player#5586 folded on the river
Seat 3: warioman (button) folded on the river
Seat 4: Player#9206 (small blind) folded on the river
Seat 5: Player#3021 shows [] and won ($1.90) with 
Seat 6: Player#1235 folded before the flop

PokerStars Hand #8d2cf651-b5bf-4dde-a319-3592b35b7a31:  Hold'em No Limit ($0.1/$0.20 USD) - 2021/11/20 09:42:00 ET
Table 'Bel Air' 6-max Seat #2 is the button
Seat 1: Player#7030 ($20.78 in chips)
Seat 2: Player#6058 ($12.16 in chips)
Seat 3: warioman ($21.56 in chips)
Seat 4: Player#3763 ($14.70 in chips)
Seat 5: Player#0723 ($5.44 in chips)
Seat 6: Player#0354 ($26.68 in chips)
warioman: posts small blind $0.10
Player#3763: posts big blind $0.20
*** HOLE CARDS ***
Dealt to warioman [3d Jd]
Player#0723: folds
Player#0354: folds
Player#7030: calls $0.20
Player#6058: folds
warioman: folds
Player#3763: raises $0.20 to $0.7
Player#7030: folds
Player#3763: doesn't show hand
Uncalled bet ($0.70) returned to Player#3763
Player#3763 collected $0.30 from pot
*** SUMMARY ***
Total Pot $0.30 | Rake $0.00
Seat 1: Player#7030 folded before the flop
Seat 2: Player#6058 (button) folded before the flop
Seat 3: warioman (small blind) folded before the flop
Seat 4: Player#3763 shows [] and won ($0.30) with 
Seat 5: Player#0723 folded before the flop
Seat 6: Player#0354 folded before the flop

PokerStars Hand #074d51d8-38f4-4256-abc9-e3f9d1ff6df7:  Hold'em No Limit ($0.05/$0.10 USD) - 2021/11/20 09:41:00 ET
Table 'Tempe' 6-max Seat #6 is the button
Seat 1: Player#4335 ($5.50 in chips)
Seat 2: Player#3563 ($17.95 in chips)
Seat 3: Player#6766 ($5.00 in chips)
Seat 4: Player#9847 ($12.93 in chips)
Seat 5: warioman ($15.20 in chips)
Seat 6: Player#2260 ($13.49 in chips)
Player#4335: posts small blind $0.05
Player#3563: posts big blind $0.10
*** HOLE CARDS ***
Dealt to warioman [Tc 8h]
Player#6766 Entry Bet 0.1
Player#6766: checks
Player#9847: folds
warioman: folds
Player#2260: raises $0.10 to $0.3
Player#4335: folds
Player#3563: calls $0.20
Player#6766: calls $0.20
*** FLOP *** [Qs 8d 7d]
Player#3563: bets $0.30
Player#6766: folds
Player#2260: calls $0.30
*** TURN *** [Qs 8d 7d] [8c]
Player#3563: checks
Player#2260: checks
*** RIVER *** [Qs 8d 7d] [8c] [4c]
Player#3563: bets $1.00
Player#2260: folds
Player#3563: doesn't show hand
Uncalled bet ($1.00) returned to Player#3563
Player#3563 collected $1.38 from pot
*** SUMMARY ***
Total Pot $1.45 | Rake $0.07
Board [Qs 8d 7d 8c 4c]
Seat 1: Player#4335 (small blind) folded before the flop
Seat 2: Player#3563 shows [] and won ($1.38) with 
Seat 3: Player#6766 folded on the flop
Seat 4: Player#9847 folded before the flop
Seat 5: warioman folded before the flop
Seat 6: Player#2260 (button) folded on the river

PokerStars Hand #d34b1fe4-5e56-4043-aebb-f4055535800d:  Hold'em No Limit ($0.1/$0.20 USD) - 2021/11/20 09:40:00 ET
Table 'Bel Air' 6-max Seat #1 is the button
Seat 1: Player#2057 ($20.98 in chips)
Seat 2: Player#7449 ($9.08 in chips)
Seat 3: warioman ($21.76 in chips)
Seat 4: Player#6726 ($17.70 in chips)
Seat 5: Player#8845 ($5.44 in chips)
Seat 6: Player#2839 ($26.68 in chips)
Player#7449: posts small blind $0.10
warioman: posts big blind $0.20
*** HOLE CARDS ***
Dealt to warioman [Qc Jh]
Player#6726: calls $0.20
Player#8845: folds
Player#2839: folds
Player#2057: calls $0.20
Player#7449: calls $0.10
warioman: checks
*** FLOP *** [Ah 2c Ts]
Player#7449: checks
warioman: checks
Player#6726: bets $0.60
Player#2057: folds
Player#7449: raises $0.60 to $1.2
warioman: folds
Player#6726: calls $0.60
*** TURN *** [Ah 2c Ts] [Kh]
Player#7449: bets $1.60
Player#6726: calls $1.60
*** RIVER *** [Ah 2c Ts] [Kh] [8h]
Player#7449: bets $3.20
Player#6726: folds
Player#7449: doesn't show hand
Uncalled bet ($3.20) returned to Player#7449
Player#7449 collected $6.08 from pot
*** SUMMARY ***
Total Pot $6.40 | Rake $0.32
Board [Ah 2c Ts Kh 8h]
Seat 1: Player#2057 (button) folded on the flop
Seat 2: Player#7449 shows [] and won ($6.08) with 
Seat 3: warioman (big blind) folded on the flop
Seat 4: Player#6726 folded on the river
Seat 5: Player#8845 folded before the flop
Seat 6: Player#2839 folded before the flop

PokerStars Hand #d86335ca-897e-41f4-a79e-64903f8cfbcb:  Hold'em No Limit ($0.05/$0.10 USD) - 2021/11/20 09:40:00 ET
Table 'Tempe' 6-max Seat #4 is the button
Seat 1: Player#0262 ($8.70 in chips)
Seat 2: Player#2071 ($17.95 in chips)
Seat 3: Player#8647 ($10.00 in chips)
Seat 4: warioman ($15.20 in chips)
Seat 5: Player#2886 ($13.54 in chips)
Player#2886: posts small blind $0.05
Player#0262: posts big blind $0.10
*** HOLE CARDS ***
Dealt to warioman [4h 8s]
Player#8647 Entry Bet 0.1
Player#2071: folds
Player#8647: raises $0.10 to $0.4
warioman: folds
Player#2886: folds
Player#0262: calls $0.30
*** FLOP *** [Qs Qc Kd]
Player#0262: checks
Player#8647: bets $0.75
Player#0262: calls $0.75
*** TURN *** [Qs Qc Kd] [Kc]
Player#0262: checks
Player#8647: bets $2.05
Player#0262: calls $2.05
*** RIVER *** [Qs Qc Kd] [Kc] [5c]
Player#0262: checks
Player#8647: bets $6.80
Player#0262: folds
Player#8647: doesn't show hand
Uncalled bet ($6.80) returned to Player#8647
Player#8647 collected $6.13 from pot
*** SUMMARY ***
Total Pot $6.45 | Rake $0.32
Board [Qs Qc Kd Kc 5c]
Seat 1: Player#0262 (big blind) folded on the river
Seat 2: Player#2071 folded before the flop
Seat 3: Player#8647 shows [] and won ($6.13) with 
Seat 4: warioman (button) folded before the flop
Seat 5: Player#2886 (small blind) folded before the flop

PokerStars Hand #4d752eab-a321-4ddb-ad36-b69e5d13bfd7:  Hold'em No Limit ($0.1/$0.20 USD) - 2021/11/20 09:39:00 ET
Table 'Bel Air' 6-max Seat #6 is the button
Seat 1: Player#7267 ($21.08 in chips)
Seat 2: Player#6122 ($9.28 in chips)
Seat 3: warioman ($21.76 in chips)
Seat 4: Player#9229 ($17.90 in chips)
Seat 5: Player#5567 ($5.44 in chips)
Seat 6: Player#9872 ($26.21 in chips)
Player#7267: posts small blind $0.10
Player#6122: posts big blind $0.20
*** HOLE CARDS ***
Dealt to warioman [Ks Th]
warioman: folds
Player#9229: calls $0.20
Player#5567: folds
Player#9872: calls $0.20
Player#7267: folds
Player#6122: checks
*** FLOP *** [3h Js 6s]
Player#6122: checks
Player#9229: checks
Player#9872: bets $0.60
Player#6122: folds
Player#9229: folds
Player#9872: doesn't show hand
Uncalled bet ($0.60) returned to Player#9872
Player#9872 collected $0.66 from pot
*** SUMMARY ***
Total Pot $0.70 | Rake $0.03
Board [3h Js 6s]
Seat 1: Player#7267 (small blind) folded before the flop
Seat 2: Player#6122 (big blind) folded on the flop
Seat 3: warioman folded before the flop
Seat 4: Player#9229 folded on the flop
Seat 5: Player#5567 folded before the flop
Seat 6: Player#9872 shows [] and won ($0.66) with 

PokerStars Hand #8908ced9-eee7-44c4-a122-ebc6de79bbdc:  Hold'em No Limit ($0.1/$0.20 USD) - 2021/11/20 09:39:00 ET
Table 'Bel Air' 6-max Seat #5 is the button
Seat 1: Player#0776 ($20.00 in chips)
Seat 2: Player#7699 ($9.28 in chips)
Seat 3: warioman ($21.76 in chips)
Seat 4: Player#1797 ($17.90 in chips)
Seat 5: Player#8543 ($5.44 in chips)
Seat 6: Player#4100 ($27.41 in chips)
Player#4100: posts small blind $0.10
Player#0776: posts big blind $0.20
*** HOLE CARDS ***
Dealt to warioman [Qs 2s]
Player#7699: folds
warioman: folds
Player#1797: folds
Player#8543: folds
Player#4100: raises $0.20 to $0.6
Player#0776: raises $0.60 to $1.2
Player#4100: calls $0.60
*** FLOP *** [9d 7d Ad]
Player#4100: checks
Player#0776: bets $2.40
Player#4100: folds
Player#0776 Show
Player#0776 Showing Pocket Cards QQ
Uncalled bet ($2.40) returned to Player#0776
Player#0776 collected $2.28 from pot
*** SUMMARY ***
Total Pot $2.40 | Rake $0.12
Board [9d 7d Ad]
Seat 1: Player#0776 shows [Qc Qd] and won ($2.28) with 
Seat 2: Player#7699 folded before the flop
Seat 3: warioman folded before the flop
Seat 4: Player#1797 folded before the flop
Seat 5: Player#8543 (button) folded before the flop
Seat 6: Player#4100 (small blind) folded on the flop

PokerStars Hand #ba2b4517-d26f-4325-9497-b0a0e6b586a1:  Hold'em No Limit ($0.05/$0.10 USD) - 2021/11/20 09:38:00 ET
Table 'Tempe' 6-max Seat #2 is the button
Seat 1: Player#7232 ($10.00 in chips)
Seat 2: Player#5561 ($16.40 in chips)
Seat 3: warioman ($15.50 in chips)
Seat 4: Player#4628 ($13.64 in chips)
warioman: posts small blind $0.05
Player#4628: posts big blind $0.10
*** HOLE CARDS ***
Dealt to warioman [Kc 9c]
Player#7232: raises $0.10 to $0.3
Player#5561: calls $0.30
warioman: calls $0.25
Player#4628: folds
*** FLOP *** [2s 7h Jd]
warioman: checks
Player#7232: checks
Player#5561: bets $0.30
warioman: folds
Player#7232: raises0.30 to $1
Player#5561: calls $0.70
*** TURN *** [2s 7h Jd] [8c]
Player#7232: checks
Player#5561: checks
*** RIVER *** [2s 7h Jd] [8c] [3c]
Player#7232: checks
Player#5561: checks
*** SHOW DOWN *** 
Player#5561 collected $2.85 from pot
*** SUMMARY ***
Total Pot $3.00 | Rake $0.15
Board [2s 7h Jd 8c 3c]
Seat 1: Player#7232 mucked
Seat 2: Player#5561 shows [7s As] and won ($2.85) with 
Seat 3: warioman (small blind) folded on the flop
Seat 4: Player#4628 (big blind) folded before the flop

PokerStars Hand #0cbc8662-4c40-45d0-b15b-1f213f774962:  Hold'em No Limit ($0.1/$0.20 USD) - 2021/11/20 09:38:00 ET
Table 'Bel Air' 6-max Seat #6 is the button
Seat 1: Player#1780 ($20.00 in chips)
Seat 2: Player#0296 ($11.48 in chips)
Seat 3: warioman ($21.76 in chips)
Seat 4: Player#8536 ($17.90 in chips)
Seat 5: Player#5308 ($5.54 in chips)
Seat 6: Player#2694 ($25.33 in chips)
Player#1780: posts small blind $0.10
Player#5308: posts big blind $0.20
*** HOLE CARDS ***
Dealt to warioman [7h Ad]
Player#1780 Waiting
Player#0296: calls $0.20
warioman: folds
Player#8536: folds
Player#5308: folds
Player#2694: checks
*** FLOP *** [7s 3d Ts]
Player#2694: checks
Player#0296: checks
*** TURN *** [7s 3d Ts] [4h]
Player#2694: bets $0.50
Player#0296: calls $0.50
*** RIVER *** [7s 3d Ts] [4h] [3h]
Player#2694: bets $1.50
Player#0296: calls $1.50
*** SHOW DOWN *** 
Player#0296: doesn't show hand
Player#2694 collected $4.28 from pot
*** SUMMARY ***
Total Pot $4.50 | Rake $0.23
Board [7s 3d Ts 4h 3h]
Seat 1: Player#1780 (small blind) mucked
Seat 2: Player#0296 mucked
Seat 3: warioman folded before the flop
Seat 4: Player#8536 folded before the flop
Seat 5: Player#5308 (big blind) folded before the flop
Seat 6: Player#2694 shows [Tc Kd] and won ($4.28) with 

PokerStars Hand #1fa2f308-a250-48b1-91a8-0c5deec4a154:  Hold'em No Limit ($0.05/$0.10 USD) - 2021/11/20 09:38:00 ET
Table 'Tempe' 6-max Seat #2 is the button
Seat 1: Player#2855 ($8.25 in chips)
Seat 2: Player#5413 ($16.40 in chips)
Seat 3: Player#2857 ($6.27 in chips)
Seat 4: Player#4321 ($25.86 in chips)
Seat 5: warioman ($9.85 in chips)
Seat 6: Player#8042 ($13.64 in chips)
Player#2857: posts small blind $0.05
warioman: posts big blind $0.10
*** HOLE CARDS ***
Dealt to warioman [Qc Kc]
Player#4321 Decline Entry Bet
Player#8042: folds
Player#2855: folds
Player#5413: folds
Player#2857: raises $0.10 to $0.5
warioman: raises $0.50 to $1.5
Player#2857: calls $1.00
*** FLOP *** [9d 3s Tc]
Player#2857: bets $3.00
warioman: raises3.00 to $6
Player#2857: calls $1.77
Player#2857 Showing Pocket Cards TJ
warioman Showing Pocket Cards QK
*** TURN *** [9d 3s Tc] [9c]
*** RIVER *** [9d 3s Tc] [9c] [Kc]
warioman collected $13.08 from pot
*** SUMMARY ***
Total Pot $13.77 | Rake $0.69
Board [9d 3s Tc 9c Kc]
Seat 1: Player#2855 folded before the flop
Seat 2: Player#5413 (button) folded before the flop
Seat 3: Player#2857 (small blind) mucked
Seat 4: Player#4321 mucked
Seat 5: warioman (big blind)
Seat 6: Player#8042 folded before the flop

PokerStars Hand #0d6672c0-153b-4177-bada-96b4c8239c0b:  Hold'em No Limit ($0.1/$0.20 USD) - 2021/11/20 09:37:00 ET
Table 'Bel Air' 6-max Seat #6 is the button
Seat 1: Player#1583 ($20.00 in chips)
Seat 2: Player#1099 ($11.48 in chips)
Seat 3: warioman ($21.76 in chips)
Seat 4: Player#7417 ($16.82 in chips)
Seat 5: Player#8888 ($6.74 in chips)
Seat 6: Player#0766 ($25.33 in chips)
Player#1583: posts small blind $0.10
Player#7417: posts big blind $0.20
*** HOLE CARDS ***
Dealt to warioman [6s 7h]
Player#1583 Waiting
Player#0766: folds
Player#1099: folds
warioman: folds
Player#7417: raises $0.20 to $0.6
Player#8888: calls $0.40
*** FLOP *** [7c 2d 5s]
Player#7417: checks
Player#8888: checks
*** TURN *** [7c 2d 5s] [Ac]
Player#7417: checks
Player#8888: bets $0.60
Player#7417: calls $0.60
*** RIVER *** [7c 2d 5s] [Ac] [9c]
Player#7417: checks
Player#8888: checks
*** SHOW DOWN *** 
Player#7417 collected $2.28 from pot
*** SUMMARY ***
Total Pot $2.40 | Rake $0.12
Board [7c 2d 5s Ac 9c]
Seat 1: Player#1583 (small blind) mucked
Seat 2: Player#1099 folded before the flop
Seat 3: warioman folded before the flop
Seat 4: Player#7417 shows [Ad Kd] and won ($2.28) with 
Seat 5: Player#8888 mucked
Seat 6: Player#0766 (button) folded before the flop

PokerStars Hand #0a26779d-b87c-4424-866e-021f08eb3e1d:  Hold'em No Limit ($0.1/$0.20 USD) - 2021/11/20 09:37:00 ET
Table 'Bel Air' 6-max Seat #1 is the button
Seat 1: Player#0923 ($11.48 in chips)
Seat 2: warioman ($21.86 in chips)
Seat 3: Player#6174 ($16.72 in chips)
Seat 4: Player#9342 ($6.74 in chips)
Seat 5: Player#3216 ($25.33 in chips)
warioman: posts small blind $0.10
Player#6174: posts big blind $0.20
*** HOLE CARDS ***
Dealt to warioman [6s Qd]
Player#9342: folds
Player#3216: folds
Player#0923: folds
warioman: folds
Player#6174 collected $0.20 from pot
*** SUMMARY ***
Total Pot $0.20 | Rake $0.00
Seat 1: Player#0923 (button) folded before the flop
Seat 2: warioman (small blind) folded before the flop
Seat 3: Player#6174 shows [] and won ($0.20) with 
Seat 4: Player#9342 folded before the flop
Seat 5: Player#3216 folded before the flop

PokerStars Hand #bf2e3333-ed11-4419-b528-855cbce26379:  Hold'em No Limit ($0.05/$0.10 USD) - 2021/11/20 09:37:00 ET
Table 'Tempe' 6-max Seat #1 is the button
Seat 1: Player#5185 ($10.00 in chips)
Seat 2: Player#8258 ($13.16 in chips)
Seat 3: Player#3863 ($8.02 in chips)
Seat 4: Player#3258 ($25.86 in chips)
Seat 5: warioman ($9.85 in chips)
Seat 6: Player#5861 ($13.64 in chips)
Player#8258: posts small blind $0.05
Player#3863: posts big blind $0.10
*** HOLE CARDS ***
Dealt to warioman [2s 3h]
Player#3258: folds
warioman: folds
Player#5861: folds
Player#5185: raises $0.10 to $0.3
Player#8258: raises $0.30 to $0.85
Player#3863: calls $0.75
Player#5185: calls $0.55
*** FLOP *** [As Jd 9h]
Player#8258: checks
Player#3863: bets $0.40
Player#5185: calls $0.40
Player#8258: calls $0.40
*** TURN *** [As Jd 9h] [2d]
Player#8258: checks
Player#3863: bets $0.50
Player#5185: calls $0.50
Player#8258: calls $0.50
*** RIVER *** [As Jd 9h] [2d] [Td]
Player#8258: checks
Player#3863: checks
Player#5185: checks
*** SHOW DOWN *** 
Player#8258 collected $4.99 from pot
*** SUMMARY ***
Total Pot $5.25 | Rake $0.26
Board [As Jd 9h 2d Td]
Seat 1: Player#5185 (button) mucked
Seat 2: Player#8258 shows [Ks Kd] and won ($4.99) with 
Seat 3: Player#3863 (big blind) mucked
Seat 4: Player#3258 folded before the flop
Seat 5: warioman folded before the flop
Seat 6: Player#5861 folded before the flop

PokerStars Hand #82e794cb-d5f3-4ac2-9a5e-8962049cee69:  Hold'em No Limit ($0.1/$0.20 USD) - 2021/11/20 09:36:00 ET
Table 'Bel Air' 6-max Seat #6 is the button
Seat 1: Player#8213 ($11.88 in chips)
Seat 2: warioman ($21.50 in chips)
Seat 3: Player#9898 ($16.72 in chips)
Seat 4: Player#2845 ($6.74 in chips)
Seat 5: Player#9874 ($25.33 in chips)
Player#8213: posts small blind $0.10
warioman: posts big blind $0.20
*** HOLE CARDS ***
Dealt to warioman [Th Jc]
Player#9898: folds
Player#2845: folds
Player#9874: folds
Player#8213: calls $0.10
warioman: checks
*** FLOP *** [6d 4h 2h]
Player#8213: checks
warioman: checks
*** TURN *** [6d 4h 2h] [Tc]
Player#8213: checks
warioman: bets $0.20
Player#8213: calls $0.20
*** RIVER *** [6d 4h 2h] [Tc] [8c]
Player#8213: checks
warioman: bets $0.20
Player#8213: folds
warioman: doesn't show hand
Uncalled bet ($0.20) returned to warioman
warioman collected $0.76 from pot
*** SUMMARY ***
Total Pot $0.80 | Rake $0.04
Board [6d 4h 2h Tc 8c]
Seat 1: Player#8213 (small blind) folded on the river
Seat 2: warioman (big blind)
Seat 3: Player#9898 folded before the flop
Seat 4: Player#2845 folded before the flop
Seat 5: Player#9874 folded before the flop

PokerStars Hand #e1b26c3c-d25b-41fd-9b1e-48c0528b4eb9:  Hold'em No Limit ($0.05/$0.10 USD) - 2021/11/20 09:36:00 ET
Table 'Tempe' 6-max Seat #6 is the button
Seat 1: Player#6680 ($4.96 in chips)
Seat 2: Player#0003 ($12.66 in chips)
Seat 3: Player#9095 ($8.52 in chips)
Seat 4: Player#4472 ($25.86 in chips)
Seat 5: warioman ($9.85 in chips)
Seat 6: Player#2996 ($13.64 in chips)
Player#6680: posts small blind $0.05
Player#0003: posts big blind $0.10
*** HOLE CARDS ***
Dealt to warioman [4h Qc]
Player#9095: raises $0.10 to $0.5
Player#4472: folds
warioman: folds
Player#2996: folds
Player#6680: folds
Player#0003: calls $0.40
*** FLOP *** [3s 5c 3h]
Player#0003: checks
Player#9095: checks
*** TURN *** [3s 5c 3h] [5s]
Player#0003: checks
Player#9095: checks
*** RIVER *** [3s 5c 3h] [5s] [4s]
Player#0003: bets $0.53
Player#9095: folds
Player#0003: doesn't show hand
Uncalled bet ($0.53) returned to Player#0003
Player#0003 collected $1.00 from pot
*** SUMMARY ***
Total Pot $1.05 | Rake $0.05
Board [3s 5c 3h 5s 4s]
Seat 1: Player#6680 (small blind) folded before the flop
Seat 2: Player#0003 shows [] and won ($1.00) with 
Seat 3: Player#9095 folded on the river
Seat 4: Player#4472 folded before the flop
Seat 5: warioman folded before the flop
Seat 6: Player#2996 (button) folded before the flop

PokerStars Hand #e6dd93a7-e13e-40b3-acd6-3aa9db40aaad:  Hold'em No Limit ($0.1/$0.20 USD) - 2021/11/20 09:36:00 ET
Table 'Bel Air' 6-max Seat #5 is the button
Seat 1: Player#4542 ($53.45 in chips)
Seat 2: Player#9696 ($12.08 in chips)
Seat 3: warioman ($21.50 in chips)
Seat 4: Player#1639 ($16.72 in chips)
Seat 5: Player#8163 ($7.34 in chips)
Seat 6: Player#0295 ($24.53 in chips)
Player#0295: posts small blind $0.10
Player#9696: posts big blind $0.20
*** HOLE CARDS ***
Dealt to warioman [5d 6s]
Player#4542 Decline Entry Bet
warioman: folds
Player#1639: folds
Player#8163: raises $0.20 to $0.6
Player#0295: raises0.60 to $2
Player#9696: folds
Player#8163: folds
Player#0295: doesn't show hand
Uncalled bet ($2.00) returned to Player#0295
Player#0295 collected $0.80 from pot
*** SUMMARY ***
Total Pot $0.80 | Rake $0.00
Seat 1: Player#4542 mucked
Seat 2: Player#9696 (big blind) folded before the flop
Seat 3: warioman folded before the flop
Seat 4: Player#1639 folded before the flop
Seat 5: Player#8163 (button) folded before the flop
Seat 6: Player#0295 shows [] and won ($0.80) with 

PokerStars Hand #1a345178-b9c2-4f87-91fc-d1080053abad:  Hold'em No Limit ($0.1/$0.20 USD) - 2021/11/20 09:35:00 ET
Table 'Bel Air' 6-max Seat #4 is the button
Seat 1: Player#3816 ($53.45 in chips)
Seat 2: Player#5216 ($12.08 in chips)
Seat 3: warioman ($21.20 in chips)
Seat 4: Player#9609 ($16.72 in chips)
Seat 5: Player#5634 ($7.44 in chips)
Seat 6: Player#9252 ($24.73 in chips)
Player#5634: posts small blind $0.10
Player#9252: posts big blind $0.20
*** HOLE CARDS ***
Dealt to warioman [As Kh]
Player#3816: folds
Player#5216: folds
warioman: raises $0.20 to $0.5
Player#9609: folds
Player#5634: folds
Player#9252: folds
warioman: doesn't show hand
Uncalled bet ($0.50) returned to warioman
warioman collected $0.30 from pot
*** SUMMARY ***
Total Pot $0.30 | Rake $0.00
Seat 1: Player#3816 folded before the flop
Seat 2: Player#5216 folded before the flop
Seat 3: warioman
Seat 4: Player#9609 (button) folded before the flop
Seat 5: Player#5634 (small blind) folded before the flop
Seat 6: Player#9252 (big blind) folded before the flop

PokerStars Hand #39c8d87d-d323-4dc8-8f4f-2fe99b5aec23:  Hold'em No Limit ($0.05/$0.10 USD) - 2021/11/20 09:35:00 ET
Table 'Tempe' 6-max Seat #5 is the button
Seat 1: Player#8038 ($9.54 in chips)
Seat 2: Player#9767 ($12.66 in chips)
Seat 3: Player#1768 ($8.82 in chips)
Seat 4: Player#4835 ($21.40 in chips)
Seat 5: warioman ($9.85 in chips)
Seat 6: Player#4658 ($13.69 in chips)
Player#4658: posts small blind $0.05
Player#8038: posts big blind $0.10
*** HOLE CARDS ***
Dealt to warioman [2c 7c]
Player#9767: folds
Player#1768: raises $0.10 to $0.3
Player#4835: calls $0.30
warioman: folds
Player#4658: folds
Player#8038: calls $0.20
*** FLOP *** [4d 6h 3d]
Player#8038: checks
Player#1768: checks
Player#4835: bets $0.71
Player#8038: calls $0.71
Player#1768: folds
*** TURN *** [4d 6h 3d] [6s]
Player#8038: checks
Player#4835: bets $1.19
Player#8038: calls $1.19
*** RIVER *** [4d 6h 3d] [6s] [Qs]
Player#8038: bets $2.38
Player#4835: calls $2.38
*** SHOW DOWN *** 
Player#4835 collected $9.03 from pot
*** SUMMARY ***
Total Pot $9.51 | Rake $0.48
Board [4d 6h 3d 6s Qs]
Seat 1: Player#8038 (big blind) mucked
Seat 2: Player#9767 folded before the flop
Seat 3: Player#1768 folded on the flop
Seat 4: Player#4835 shows [Jd Js] and won ($9.03) with 
Seat 5: warioman (button) folded before the flop
Seat 6: Player#4658 (small blind) folded before the flop

PokerStars Hand #f29077fe-c764-49aa-b03f-6762819a176c:  Hold'em No Limit ($0.05/$0.10 USD) - 2021/11/20 09:35:00 ET
Table 'Tempe' 6-max Seat #4 is the button
Seat 1: Player#4904 ($9.54 in chips)
Seat 2: Player#5295 ($12.66 in chips)
Seat 3: Player#6982 ($8.67 in chips)
Seat 4: Player#9960 ($21.40 in chips)
Seat 5: warioman ($9.90 in chips)
Seat 6: Player#5845 ($13.79 in chips)
warioman: posts small blind $0.05
Player#5845: posts big blind $0.10
*** HOLE CARDS ***
Dealt to warioman [Jh 9s]
Player#4904: folds
Player#5295: folds
Player#6982: raises $0.10 to $0.3
Player#9960: folds
warioman: folds
Player#5845: folds
Player#6982: doesn't show hand
Uncalled bet ($0.30) returned to Player#6982
Player#6982 collected $0.15 from pot
*** SUMMARY ***
Total Pot $0.15 | Rake $0.00
Seat 1: Player#4904 folded before the flop
Seat 2: Player#5295 folded before the flop
Seat 3: Player#6982 shows [] and won ($0.15) with 
Seat 4: Player#9960 (button) folded before the flop
Seat 5: warioman (small blind) folded before the flop
Seat 6: Player#5845 (big blind) folded before the flop

PokerStars Hand #84cb016b-926f-48b8-918b-113161554de6:  Hold'em No Limit ($0.1/$0.20 USD) - 2021/11/20 09:34:00 ET
Table 'Bel Air' 6-max Seat #3 is the button
Seat 1: Player#8674 ($53.45 in chips)
Seat 2: Player#3667 ($12.68 in chips)
Seat 3: warioman ($19.70 in chips)
Seat 4: Player#1030 ($16.82 in chips)
Seat 5: Player#3395 ($7.64 in chips)
Seat 6: Player#0813 ($25.33 in chips)
Player#1030: posts small blind $0.10
Player#3395: posts big blind $0.20
*** HOLE CARDS ***
Dealt to warioman [Kc Ah]
Player#0813: raises $0.20 to $0.6
Player#8674: folds
Player#3667: calls $0.60
warioman: raises $0.60 to $2.7
Player#1030: folds
Player#3395: folds
Player#0813: folds
Player#3667: folds
warioman: doesn't show hand
Uncalled bet ($2.70) returned to warioman
warioman collected $1.50 from pot
*** SUMMARY ***
Total Pot $1.50 | Rake $0.00
Seat 1: Player#8674 folded before the flop
Seat 2: Player#3667 folded before the flop
Seat 3: warioman (button)
Seat 4: Player#1030 (small blind) folded before the flop
Seat 5: Player#3395 (big blind) folded before the flop
Seat 6: Player#0813 folded before the flop

PokerStars Hand #e85e9227-73b0-4f15-8afe-28df05f66c5e:  Hold'em No Limit ($0.1/$0.20 USD) - 2021/11/20 09:34:00 ET
Table 'Bel Air' 6-max Seat #2 is the button
Seat 1: Player#3727 ($54.05 in chips)
Seat 2: Player#0201 ($12.68 in chips)
Seat 3: warioman ($19.80 in chips)
Seat 4: Player#2460 ($17.02 in chips)
Seat 5: Player#0951 ($7.64 in chips)
Seat 6: Player#6920 ($24.50 in chips)
warioman: posts small blind $0.10
Player#2460: posts big blind $0.20
*** HOLE CARDS ***
Dealt to warioman [4c 5s]
Player#0951: folds
Player#6920: raises $0.20 to $0.6
Player#3727: calls $0.60
Player#0201: folds
warioman: folds
Player#2460: folds
*** FLOP *** [9d 8d 9s]
Player#6920: bets $0.75
Player#3727: folds
Player#6920: doesn't show hand
Uncalled bet ($0.75) returned to Player#6920
Player#6920 collected $1.43 from pot
*** SUMMARY ***
Total Pot $1.50 | Rake $0.08
Board [9d 8d 9s]
Seat 1: Player#3727 folded on the flop
Seat 2: Player#0201 (button) folded before the flop
Seat 3: warioman (small blind) folded before the flop
Seat 4: Player#2460 (big blind) folded before the flop
Seat 5: Player#0951 folded before the flop
Seat 6: Player#6920 shows [] and won ($1.43) with 

PokerStars Hand #958278dd-8870-448d-9c95-4fbe89566f54:  Hold'em No Limit ($0.05/$0.10 USD) - 2021/11/20 09:34:00 ET
Table 'Tempe' 6-max Seat #3 is the button
Seat 1: Player#7291 ($8.76 in chips)
Seat 2: Player#3963 ($12.66 in chips)
Seat 3: Player#5147 ($9.37 in chips)
Seat 4: Player#8869 ($21.45 in chips)
Seat 5: warioman ($10.00 in chips)
Seat 6: Player#0109 ($13.79 in chips)
Player#8869: posts small blind $0.05
warioman: posts big blind $0.10
*** HOLE CARDS ***
Dealt to warioman [Tc 3d]
Player#0109: folds
Player#7291: calls $0.10
Player#3963: folds
Player#5147: calls $0.10
Player#8869: folds
warioman: checks
*** FLOP *** [4s 5h 9s]
warioman: checks
Player#7291: bets $0.30
Player#5147: calls $0.30
warioman: folds
*** TURN *** [4s 5h 9s] [6d]
Player#7291: bets $0.30
Player#5147: calls $0.30
*** RIVER *** [4s 5h 9s] [6d] [5d]
Player#7291: checks
Player#5147: checks
*** SHOW DOWN *** 
Player#7291 collected $1.47 from pot
*** SUMMARY ***
Total Pot $1.55 | Rake $0.08
Board [4s 5h 9s 6d 5d]
Seat 1: Player#7291 shows [Th 6s] and won ($1.47) with 
Seat 2: Player#3963 folded before the flop
Seat 3: Player#5147 (button) mucked
Seat 4: Player#8869 (small blind) folded before the flop
Seat 5: warioman (big blind) folded on the flop
Seat 6: Player#0109 folded before the flop

PokerStars Hand #25dd65eb-f56a-4572-8676-177bc50a304f:  Hold'em No Limit ($0.1/$0.20 USD) - 2021/11/20 09:33:00 ET
Table 'Bel Air' 6-max Seat #1 is the button
Seat 1: Player#5249 ($54.05 in chips)
Seat 2: Player#8197 ($13.48 in chips)
Seat 3: warioman ($20.00 in chips)
Seat 4: Player#5381 ($16.11 in chips)
Seat 5: Player#8380 ($7.64 in chips)
Seat 6: Player#1796 ($24.50 in chips)
Player#8197: posts small blind $0.10
warioman: posts big blind $0.20
*** HOLE CARDS ***
Dealt to warioman [Th 8s]
Player#5381: calls $0.20
Player#8380: folds
Player#1796: folds
Player#5249: folds
Player#8197: calls $0.10
warioman: checks
*** FLOP *** [Jd 3s Js]
Player#8197: bets $0.20
warioman: folds
Player#5381: raises $0.20 to $0.6
Player#8197: calls $0.40
*** TURN *** [Jd 3s Js] [Qs]
Player#8197: checks
Player#5381: checks
*** RIVER *** [Jd 3s Js] [Qs] [8s]
Player#8197: checks
Player#5381: bets $1.80
Player#8197: folds
Player#5381: doesn't show hand
Uncalled bet ($1.80) returned to Player#5381
Player#5381 collected $1.71 from pot
*** SUMMARY ***
Total Pot $1.80 | Rake $0.09
Board [Jd 3s Js Qs 8s]
Seat 1: Player#5249 (button) folded before the flop
Seat 2: Player#8197 (small blind) folded on the river
Seat 3: warioman (big blind) folded on the flop
Seat 4: Player#5381 shows [] and won ($1.71) with 
Seat 5: Player#8380 folded before the flop
Seat 6: Player#1796 folded before the flop

PokerStars Hand #82f48ae2-1c86-488c-8dab-45ee4764725a:  Hold'em No Limit ($0.05/$0.10 USD) - 2021/11/20 09:33:00 ET
Table 'Tempe' 6-max Seat #2 is the button
Seat 1: Player#1286 ($9.62 in chips)
Seat 2: Player#6836 ($12.66 in chips)
Seat 3: Player#2563 ($9.42 in chips)
Seat 4: Player#2103 ($18.03 in chips)
Seat 5: warioman ($10.53 in chips)
Seat 6: Player#6116 ($13.79 in chips)
Player#2563: posts small blind $0.05
Player#2103: posts big blind $0.10
*** HOLE CARDS ***
Dealt to warioman [9h Jh]
warioman: raises $0.10 to $0.3
Player#6116: folds
Player#1286: calls $0.30
Player#6836: folds
Player#2563: folds
Player#2103: calls $0.20
*** FLOP *** [Qh 8s 3h]
Player#2103: checks
warioman: bets $0.28
Player#1286: calls $0.28
Player#2103: raises $0.28 to $0.56
warioman: calls $0.28
Player#1286: calls $0.28
*** TURN *** [Qh 8s 3h] [4c]
Player#2103: bets $1.97
warioman: calls $1.97
Player#1286: folds
*** RIVER *** [Qh 8s 3h] [4c] [Qc]
Player#2103: bets $15.20
warioman: folds
Player#2103: doesn't show hand
Uncalled bet ($15.20) returned to Player#2103
Player#2103 collected $6.24 from pot
*** SUMMARY ***
Total Pot $6.57 | Rake $0.33
Board [Qh 8s 3h 4c Qc]
Seat 1: Player#1286 folded on the turn
Seat 2: Player#6836 (button) folded before the flop
Seat 3: Player#2563 (small blind) folded before the flop
Seat 4: Player#2103 shows [] and won ($6.24) with 
Seat 5: warioman folded on the river
Seat 6: Player#6116 folded before the flop

PokerStars Hand #e1b7c83d-f669-4081-ae51-4dd3e419d7ba:  Hold'em No Limit ($0.05/$0.10 USD) - 2021/11/20 09:32:00 ET
Table 'Tempe' 6-max Seat #1 is the button
Seat 1: Player#6316 ($10.25 in chips)
Seat 2: Player#5630 ($12.71 in chips)
Seat 3: Player#7845 ($8.80 in chips)
Seat 4: Player#2961 ($18.03 in chips)
Seat 5: warioman ($10.53 in chips)
Seat 6: Player#6792 ($13.79 in chips)
Player#5630: posts small blind $0.05
Player#7845: posts big blind $0.10
*** HOLE CARDS ***
Dealt to warioman [3h Jd]
Player#2961: folds
warioman: folds
Player#6792: folds
Player#6316: raises $0.10 to $0.3
Player#5630: folds
Player#7845: calls $0.20
*** FLOP *** [5h Tc Jc]
Player#7845: bets $0.33
Player#6316: calls $0.33
*** TURN *** [5h Tc Jc] [Th]
Player#7845: bets $1.31
Player#6316: folds
Player#7845: doesn't show hand
Uncalled bet ($1.31) returned to Player#7845
Player#7845 collected $1.24 from pot
*** SUMMARY ***
Total Pot $1.31 | Rake $0.07
Board [5h Tc Jc Th]
Seat 1: Player#6316 (button) folded on the turn
Seat 2: Player#5630 (small blind) folded before the flop
Seat 3: Player#7845 shows [] and won ($1.24) with 
Seat 4: Player#2961 folded before the flop
Seat 5: warioman folded before the flop
Seat 6: Player#6792 folded before the flop

PokerStars Hand #273d807b-0522-4cb7-aa44-7121380e92d1:  Hold'em No Limit ($0.1/$0.20 USD) - 2021/11/20 09:31:00 ET
Table 'Bel Air' 6-max Seat #2 is the button
Seat 1: Player#6134 ($49.21 in chips)
Seat 2: Player#2535 ($15.48 in chips)
Seat 3: warioman ($20.00 in chips)
Seat 4: Player#9991 ($18.11 in chips)
Seat 5: Player#2548 ($7.84 in chips)
Seat 6: Player#9117 ($24.50 in chips)
warioman: posts small blind $0.10
Player#6134: posts big blind $0.20
*** HOLE CARDS ***
Dealt to warioman []
System Bonus Pot Event 1
warioman Waiting
Player#9991: calls $0.20
Player#2548: calls $0.20
Player#9117: folds
Player#6134: raises0.20 to $2
Player#2535: calls $1.80
Player#9991: calls $1.80
Player#2548: folds
*** FLOP *** [6s Td 4d]
Player#6134: checks
Player#2535: checks
Player#9991: checks
*** TURN *** [6s Td 4d] [Jd]
Player#6134: bets $3.60
Player#2535: folds
Player#9991: folds
Player#6134: doesn't show hand
Uncalled bet ($3.60) returned to Player#6134
Player#6134 collected $5.89 from pot
*** SUMMARY ***
Total Pot $6.20 | Rake $0.31
Board [6s Td 4d Jd]
Seat 1: Player#6134 shows [] and won ($5.89) with 
Seat 2: Player#2535 (button) folded on the turn
Seat 3: warioman (small blind)
Seat 4: Player#9991 folded on the turn
Seat 5: Player#2548 folded before the flop
Seat 6: Player#9117 folded before the flop

PokerStars Hand #a77a26e7-d70c-47a2-8ee5-1232a5f35877:  Hold'em No Limit ($0.05/$0.10 USD) - 2021/11/20 09:31:00 ET
Table 'Tempe' 6-max Seat #6 is the button
Seat 1: Player#3461 ($10.90 in chips)
Seat 2: Player#8429 ($12.81 in chips)
Seat 3: Player#0400 ($18.03 in chips)
Seat 4: warioman ($9.85 in chips)
Seat 5: Player#2440 ($13.79 in chips)
Player#3461: posts small blind $0.05
Player#8429: posts big blind $0.10
*** HOLE CARDS ***
Dealt to warioman [Qc Tc]
Player#0400: folds
warioman: raises $0.10 to $0.3
Player#2440: folds
Player#3461: calls $0.25
Player#8429: folds
*** FLOP *** [2h 2c 8d]
Player#3461: bets $0.35
warioman: raises $0.35 to $1.2
Player#3461: folds
warioman: doesn't show hand
Uncalled bet ($1.20) returned to warioman
warioman collected $1.00 from pot
*** SUMMARY ***
Total Pot $1.05 | Rake $0.05
Board [2h 2c 8d]
Seat 1: Player#3461 (small blind) folded on the flop
Seat 2: Player#8429 (big blind) folded before the flop
Seat 3: Player#0400 folded before the flop
Seat 4: warioman
Seat 5: Player#2440 folded before the flop

PokerStars Hand #2364d69c-07a3-45e8-83b9-caf7aff776fd:  Hold'em No Limit ($0.05/$0.10 USD) - 2021/11/20 09:31:00 ET
Table 'Tempe' 6-max Seat #5 is the button
Seat 1: Player#5929 ($10.85 in chips)
Seat 2: Player#7288 ($12.81 in chips)
Seat 3: Player#7139 ($12.57 in chips)
Seat 4: Player#2420 ($18.03 in chips)
Seat 5: warioman ($9.85 in chips)
Seat 6: Player#7807 ($13.84 in chips)
Player#7807: posts small blind $0.05
Player#5929: posts big blind $0.10
*** HOLE CARDS ***
Dealt to warioman [3s Ac]
Player#7288: folds
Player#7139: folds
Player#2420: folds
warioman: folds
Player#7807: folds
Player#5929 collected $0.10 from pot
*** SUMMARY ***
Total Pot $0.10 | Rake $0.00
Seat 1: Player#5929 shows [] and won ($0.10) with 
Seat 2: Player#7288 folded before the flop
Seat 3: Player#7139 folded before the flop
Seat 4: Player#2420 folded before the flop
Seat 5: warioman (button) folded before the flop
Seat 6: Player#7807 (small blind) folded before the flop

PokerStars Hand #aac3d3b5-a8ff-413a-8081-10ebfdbfd97e:  Hold'em No Limit ($0.05/$0.10 USD) - 2021/11/20 09:30:00 ET
Table 'Tempe' 6-max Seat #4 is the button
Seat 1: Player#5904 ($11.15 in chips)
Seat 2: Player#2860 ($12.81 in chips)
Seat 3: Player#4246 ($12.57 in chips)
Seat 4: Player#7336 ($17.61 in chips)
Seat 5: warioman ($9.90 in chips)
Seat 6: Player#2301 ($13.94 in chips)
warioman: posts small blind $0.05
Player#2301: posts big blind $0.10
*** HOLE CARDS ***
Dealt to warioman [5s 3c]
Player#5904: raises $0.10 to $0.3
Player#2860: folds
Player#4246: folds
Player#7336: calls $0.30
warioman: folds
Player#2301: folds
*** FLOP *** [As 7c 9s]
Player#5904: checks
Player#7336: checks
*** TURN *** [As 7c 9s] [8s]
Player#5904: checks
Player#7336: checks
*** RIVER *** [As 7c 9s] [8s] [Ts]
Player#5904: checks
Player#7336: checks
*** SHOW DOWN *** 
Player#7336 collected $0.71 from pot
*** SUMMARY ***
Total Pot $0.75 | Rake $0.04
Board [As 7c 9s 8s Ts]
Seat 1: Player#5904 mucked
Seat 2: Player#2860 folded before the flop
Seat 3: Player#4246 folded before the flop
Seat 4: Player#7336 shows [Kd Tc] and won ($0.71) with 
Seat 5: warioman (small blind) folded before the flop
Seat 6: Player#2301 (big blind) folded before the flop

PokerStars Hand #1df64b68-9f12-46f7-87f2-712fdda7b7cf:  Hold'em No Limit ($0.05/$0.10 USD) - 2021/11/20 09:29:00 ET
Table 'Tempe' 6-max Seat #3 is the button
Seat 1: Player#2436 ($12.43 in chips)
Seat 2: Player#3123 ($12.81 in chips)
Seat 3: Player#5790 ($12.57 in chips)
Seat 4: Player#5375 ($17.66 in chips)
Seat 5: warioman ($10.00 in chips)
Seat 6: Player#4320 ($12.64 in chips)
Player#5375: posts small blind $0.05
warioman: posts big blind $0.10
*** HOLE CARDS ***
Dealt to warioman [Js 7d]
Player#4320: raises $0.10 to $0.3
Player#2436: raises $0.30 to $0.6
Player#3123: folds
Player#5790: folds
Player#5375: folds
warioman: folds
Player#4320: calls $0.30
*** FLOP *** [3s 6d 6s]
Player#4320: bets $0.68
Player#2436: calls $0.68
*** TURN *** [3s 6d 6s] [2c]
Player#4320: checks
Player#2436: checks
*** RIVER *** [3s 6d 6s] [2c] [5c]
Player#4320: bets $1.35
Player#2436: folds
Player#4320: doesn't show hand
Uncalled bet ($1.35) returned to Player#4320
Player#4320 collected $2.57 from pot
*** SUMMARY ***
Total Pot $2.71 | Rake $0.14
Board [3s 6d 6s 2c 5c]
Seat 1: Player#2436 folded on the river
Seat 2: Player#3123 folded before the flop
Seat 3: Player#5790 (button) folded before the flop
Seat 4: Player#5375 (small blind) folded before the flop
Seat 5: warioman (big blind) folded before the flop
Seat 6: Player#4320 shows [] and won ($2.57) with 

PokerStars Hand #a71ae552-0503-4d5e-962a-a710f699db6b:  Hold'em No Limit ($0.05/$0.10 USD) - 2021/11/20 09:28:00 ET
Table 'Tempe' 6-max Seat #4 is the button
Seat 1: Player#7849 ($12.68 in chips)
Seat 2: Player#1074 ($12.81 in chips)
Seat 3: Player#4695 ($12.10 in chips)
Seat 4: Player#3266 ($17.91 in chips)
Seat 5: warioman ($10.00 in chips)
Seat 6: Player#7752 ($12.64 in chips)
warioman: posts small blind $0.05
Player#4695: posts big blind $0.10
*** HOLE CARDS ***
Dealt to warioman []
warioman Waiting
Player#7752: folds
Player#7849: calls $0.10
Player#1074: folds
Player#4695: raises $0.10 to $0.25
Player#3266: calls $0.15
Player#7849: calls $0.15
*** FLOP *** [Jc Ts Th]
Player#4695: bets $0.40
Player#3266: folds
Player#7849: folds
Player#4695: doesn't show hand
Uncalled bet ($0.40) returned to Player#4695
Player#4695 collected $0.71 from pot
*** SUMMARY ***
Total Pot $0.75 | Rake $0.04
Board [Jc Ts Th]
Seat 1: Player#7849 folded on the flop
Seat 2: Player#1074 folded before the flop
Seat 3: Player#4695 shows [] and won ($0.71) with 
Seat 4: Player#3266 (button) folded on the flop
Seat 5: warioman (small blind)
Seat 6: Player#7752 folded before the flop

PokerStars Hand #92f67d79-aa24-4b7b-a319-d68944f93908:  Hold'em No Limit ($0.05/$0.10 USD) - 2021/11/20 09:28:00 ET
Table 'Tempe' 6-max Seat #4 is the button
Seat 1: Player#8417 ($12.44 in chips)
Seat 2: Player#1286 ($12.86 in chips)
Seat 3: Player#8510 ($12.20 in chips)
Seat 4: Player#7713 ($18.01 in chips)
Seat 5: warioman ($10.00 in chips)
Seat 6: Player#7493 ($12.64 in chips)
warioman: posts small blind $0.05
Player#1286: posts big blind $0.10
*** HOLE CARDS ***
Dealt to warioman []
warioman Waiting
Player#7713: calls $0.10
Player#7493: folds
Player#8417: calls $0.10
Player#1286: folds
Player#8510: checks
*** FLOP *** [9c 2h 9d]
Player#8510: checks
Player#7713: checks
Player#8417: bets $0.30
Player#8510: folds
Player#7713: folds
Player#8417: doesn't show hand
Uncalled bet ($0.30) returned to Player#8417
Player#8417 collected $0.33 from pot
*** SUMMARY ***
Total Pot $0.35 | Rake $0.02
Board [9c 2h 9d]
Seat 1: Player#8417 shows [] and won ($0.33) with 
Seat 2: Player#1286 (big blind) folded before the flop
Seat 3: Player#8510 folded on the flop
Seat 4: Player#7713 (button) folded on the flop
Seat 5: warioman (small blind)
Seat 6: Player#7493 folded before the flop

PokerStars Hand #ef97fd8a-1e45-42a5-9439-c91994ff2cb3:  Hold'em No Limit ($0.1/$0.20 USD) - 2021/11/19 23:17:00 ET
Table 'Hollywood' 6-max Seat #4 is the button
Seat 1: warioman ($20.75 in chips)
Seat 2: Player#2239 ($18.81 in chips)
Seat 3: Player#0410 ($23.69 in chips)
Seat 4: Player#0953 ($15.16 in chips)
Seat 5: Player#7800 ($51.23 in chips)
Player#7800: posts small blind $0.10
Player#2239: posts big blind $0.20
*** HOLE CARDS ***
Dealt to warioman []
warioman Decline Entry Bet
Player#0410: calls $0.20
Player#0953: folds
Player#7800: folds
Player#2239: checks
*** FLOP *** [9h 8h As]
Player#2239: checks
Player#0410: checks
*** TURN *** [9h 8h As] [Ts]
Player#2239: checks
Player#0410: checks
*** RIVER *** [9h 8h As] [Ts] [6s]
Player#2239: checks
Player#0410: checks
*** SHOW DOWN *** 
Player#0410 collected $0.47 from pot
*** SUMMARY ***
Total Pot $0.50 | Rake $0.03
Board [9h 8h As Ts 6s]
Seat 1: warioman
Seat 2: Player#2239 (big blind) mucked
Seat 3: Player#0410 shows [5s 4c] and won ($0.47) with 
Seat 4: Player#0953 (button) folded before the flop
Seat 5: Player#7800 (small blind) folded before the flop

PokerStars Hand #708ef2e7-f360-4dc4-8c6f-7de3dc6e394a:  Hold'em No Limit ($0.1/$0.20 USD) - 2021/11/19 23:17:00 ET
Table 'Huntsville' 6-max Seat #6 is the button
Seat 1: Player#7995 ($35.72 in chips)
Seat 2: warioman ($42.81 in chips)
Seat 3: Player#5407 ($15.39 in chips)
Seat 4: Player#6553 ($8.86 in chips)
Seat 5: Player#0211 ($18.93 in chips)
Seat 6: Player#2874 ($22.00 in chips)
Player#7995: posts small blind $0.10
Player#5407: posts big blind $0.20
*** HOLE CARDS ***
Dealt to warioman []
warioman Decline Entry Bet
Player#6553: calls $0.20
Player#0211: folds
Player#2874: folds
Player#7995: raises $0.20 to $0.8
Player#5407: folds
Player#6553: calls $0.60
*** FLOP *** [8h Jc Qc]
Player#7995: bets $1.35
Player#6553: calls $1.35
*** TURN *** [8h Jc Qc] [5h]
Player#7995: bets $2.20
Player#6553: raises $2.20 to $4.4
Player#7995: calls $2.20
*** RIVER *** [8h Jc Qc] [5h] [4h]
Player#7995: checks
Player#6553: checks
*** SHOW DOWN *** 
Player#7995 collected $12.64 from pot
*** SUMMARY ***
Total Pot $13.30 | Rake $0.67
Board [8h Jc Qc 5h 4h]
Seat 1: Player#7995 shows [Js Ts] and won ($12.64) with 
Seat 2: warioman
Seat 3: Player#5407 (big blind) folded before the flop
Seat 4: Player#6553 mucked
Seat 5: Player#0211 folded before the flop
Seat 6: Player#2874 (button) folded before the flop

PokerStars Hand #6b8b2fa2-b68d-4044-909e-4a095ea6e196:  Hold'em No Limit ($0.1/$0.20 USD) - 2021/11/19 23:16:00 ET
Table 'Hollywood' 6-max Seat #3 is the button
Seat 1: warioman ($23.60 in chips)
Seat 2: Player#1451 ($15.96 in chips)
Seat 3: Player#6972 ($23.69 in chips)
Seat 4: Player#1628 ($15.26 in chips)
Seat 5: Player#8213 ($51.43 in chips)
Player#1628: posts small blind $0.10
Player#8213: posts big blind $0.20
*** HOLE CARDS ***
Dealt to warioman [Ac 3c]
warioman: raises $0.20 to $0.5
Player#1451: raises $0.50 to $1.35
Player#6972: folds
Player#1628: folds
Player#8213: folds
warioman: calls $0.85
*** FLOP *** [Th 3s Tc]
warioman: checks
Player#1451: bets $1.50
warioman: calls $1.50
*** TURN *** [Th 3s Tc] [Js]
warioman: checks
Player#1451: checks
*** RIVER *** [Th 3s Tc] [Js] [Qs]
warioman: checks
Player#1451: bets $6.40
warioman: folds
Player#1451: doesn't show hand
Uncalled bet ($6.40) returned to Player#1451
Player#1451 collected $5.70 from pot
*** SUMMARY ***
Total Pot $6.00 | Rake $0.30
Board [Th 3s Tc Js Qs]
Seat 1: warioman folded on the river
Seat 2: Player#1451 shows [] and won ($5.70) with 
Seat 3: Player#6972 (button) folded before the flop
Seat 4: Player#1628 (small blind) folded before the flop
Seat 5: Player#8213 (big blind) folded before the flop

PokerStars Hand #1f12e40b-6692-49f0-a6d8-0d1ca0001feb:  Hold'em No Limit ($0.1/$0.20 USD) - 2021/11/19 23:16:00 ET
Table 'Hollywood' 6-max Seat #2 is the button
Seat 1: warioman ($23.60 in chips)
Seat 2: Player#7720 ($15.96 in chips)
Seat 3: Player#3911 ($23.79 in chips)
Seat 4: Player#1776 ($15.16 in chips)
Seat 5: Player#5471 ($51.43 in chips)
Player#3911: posts small blind $0.10
Player#1776: posts big blind $0.20
*** HOLE CARDS ***
Dealt to warioman [Ad 6c]
Player#5471: folds
warioman: folds
Player#7720: folds
Player#3911: folds
Player#1776 collected $0.20 from pot
*** SUMMARY ***
Total Pot $0.20 | Rake $0.00
Seat 1: warioman folded before the flop
Seat 2: Player#7720 (button) folded before the flop
Seat 3: Player#3911 (small blind) folded before the flop
Seat 4: Player#1776 shows [] and won ($0.20) with 
Seat 5: Player#5471 folded before the flop

PokerStars Hand #eb6ffbcf-f8b0-461a-94b1-e9ef4a0cd0ac:  Hold'em No Limit ($0.1/$0.20 USD) - 2021/11/19 23:16:00 ET
Table 'Huntsville' 6-max Seat #5 is the button
Seat 1: Player#0589 ($36.32 in chips)
Seat 2: warioman ($42.81 in chips)
Seat 3: Player#2654 ($13.71 in chips)
Seat 4: Player#7635 ($8.86 in chips)
Seat 5: Player#4497 ($19.53 in chips)
Seat 6: Player#0026 ($22.60 in chips)
Player#0026: posts small blind $0.10
Player#0589: posts big blind $0.20
*** HOLE CARDS ***
Dealt to warioman [5d 6c]
warioman: folds
Player#2654: raises $0.20 to $0.6
Player#7635: folds
Player#4497: calls $0.60
Player#0026: calls $0.50
Player#0589: calls $0.40
*** FLOP *** [2d Js Td]
Player#0026: checks
Player#0589: checks
Player#2654: checks
Player#4497: checks
*** TURN *** [2d Js Td] [6s]
Player#0026: checks
Player#0589: checks
Player#2654: checks
Player#4497: checks
*** RIVER *** [2d Js Td] [6s] [3s]
Player#0026: checks
Player#0589: checks
Player#2654: checks
Player#4497: checks
*** SHOW DOWN *** 
Player#2654 collected $2.28 from pot
*** SUMMARY ***
Total Pot $2.40 | Rake $0.12
Board [2d Js Td 6s 3s]
Seat 1: Player#0589 (big blind) mucked
Seat 2: warioman folded before the flop
Seat 3: Player#2654 shows [Ac Qs] and won ($2.28) with 
Seat 4: Player#7635 folded before the flop
Seat 5: Player#4497 (button) mucked
Seat 6: Player#0026 (small blind) mucked

PokerStars Hand #6a130a86-696c-4019-a863-8d31efc971d7:  Hold'em No Limit ($0.1/$0.20 USD) - 2021/11/19 23:15:00 ET
Table 'Hollywood' 6-max Seat #1 is the button
Seat 1: warioman ($23.60 in chips)
Seat 2: Player#0061 ($15.05 in chips)
Seat 3: Player#2046 ($23.99 in chips)
Seat 4: Player#1805 ($15.96 in chips)
Seat 5: Player#4176 ($51.43 in chips)
Player#0061: posts small blind $0.10
Player#2046: posts big blind $0.20
*** HOLE CARDS ***
Dealt to warioman [6c Jd]
Player#1805: calls $0.20
Player#4176: folds
warioman: folds
Player#0061: calls $0.10
Player#2046: checks
*** FLOP *** [Tc 7d 2s]
Player#0061: checks
Player#2046: checks
Player#1805: checks
*** TURN *** [Tc 7d 2s] [8s]
Player#0061: bets $0.60
Player#2046: folds
Player#1805: calls $0.60
*** RIVER *** [Tc 7d 2s] [8s] [2s]
Player#0061: bets $0.60
Player#1805: folds
Player#0061: doesn't show hand
Uncalled bet ($0.60) returned to Player#0061
Player#0061 collected $1.71 from pot
*** SUMMARY ***
Total Pot $1.80 | Rake $0.09
Board [Tc 7d 2s 8s 2s]
Seat 1: warioman (button) folded before the flop
Seat 2: Player#0061 shows [] and won ($1.71) with 
Seat 3: Player#2046 (big blind) folded on the turn
Seat 4: Player#1805 folded on the river
Seat 5: Player#4176 folded before the flop

PokerStars Hand #8db9d512-7c9f-4401-a81f-83c9c852d87f:  Hold'em No Limit ($0.1/$0.20 USD) - 2021/11/19 23:15:00 ET
Table 'Huntsville' 6-max Seat #4 is the button
Seat 1: Player#8546 ($36.32 in chips)
Seat 2: warioman ($42.81 in chips)
Seat 3: Player#8525 ($13.71 in chips)
Seat 4: Player#8433 ($8.56 in chips)
Seat 5: Player#6104 ($19.63 in chips)
Seat 6: Player#3477 ($22.80 in chips)
Player#6104: posts small blind $0.10
Player#3477: posts big blind $0.20
*** HOLE CARDS ***
Dealt to warioman [2c As]
Player#8546: folds
warioman: folds
Player#8525: folds
Player#8433: calls $0.20
Player#6104: folds
Player#3477: folds
Player#8433 collected $0.40 from pot
*** SUMMARY ***
Total Pot $0.40 | Rake $0.00
Seat 1: Player#8546 folded before the flop
Seat 2: warioman folded before the flop
Seat 3: Player#8525 folded before the flop
Seat 4: Player#8433 shows [] and won ($0.40) with 
Seat 5: Player#6104 (small blind) folded before the flop
Seat 6: Player#3477 (big blind) folded before the flop

PokerStars Hand #481bccc4-5a68-4ff5-86ca-7b479c5919bb:  Hold'em No Limit ($0.1/$0.20 USD) - 2021/11/19 23:14:00 ET
Table 'Hollywood' 6-max Seat #6 is the button
Seat 1: warioman ($23.70 in chips)
Seat 2: Player#7887 ($13.49 in chips)
Seat 3: Player#1041 ($25.19 in chips)
Seat 4: Player#1763 ($16.16 in chips)
Seat 5: Player#2213 ($51.63 in chips)
warioman: posts small blind $0.10
Player#7887: posts big blind $0.20
*** HOLE CARDS ***
Dealt to warioman [3d 4h]
Player#1041: calls $0.20
Player#1763: calls $0.20
Player#2213: calls $0.20
warioman: folds
Player#7887: checks
*** FLOP *** [Td 6s 7h]
Player#7887: checks
Player#1041: bets $1.00
Player#1763: folds
Player#2213: folds
Player#7887: raises $1.00 to $3.9
Player#1041: folds
Player#7887: doesn't show hand
Uncalled bet ($3.90) returned to Player#7887
Player#7887 collected $1.80 from pot
*** SUMMARY ***
Total Pot $1.90 | Rake $0.10
Board [Td 6s 7h]
Seat 1: warioman (small blind) folded before the flop
Seat 2: Player#7887 shows [] and won ($1.80) with 
Seat 3: Player#1041 folded on the flop
Seat 4: Player#1763 folded on the flop
Seat 5: Player#2213 folded on the flop

PokerStars Hand #72d29f37-439d-4843-9757-674690b9d31d:  Hold'em No Limit ($0.1/$0.20 USD) - 2021/11/19 23:14:00 ET
Table 'Hollywood' 6-max Seat #3 is the button
Seat 1: warioman ($23.90 in chips)
Seat 2: Player#1397 ($25.79 in chips)
Seat 3: Player#3068 ($16.16 in chips)
Seat 4: Player#2028 ($50.90 in chips)
Player#2028: posts small blind $0.10
warioman: posts big blind $0.20
*** HOLE CARDS ***
Dealt to warioman [5d Js]
Player#1397: calls $0.20
Player#3068: folds
Player#2028: raises $0.20 to $0.6
warioman: folds
Player#1397: calls $0.40
*** FLOP *** [4c 9h 5s]
Player#2028: checks
Player#1397: checks
*** TURN *** [4c 9h 5s] [6s]
Player#2028: bets $0.60
Player#1397: folds
Player#2028: doesn't show hand
Uncalled bet ($0.60) returned to Player#2028
Player#2028 collected $1.33 from pot
*** SUMMARY ***
Total Pot $1.40 | Rake $0.07
Board [4c 9h 5s 6s]
Seat 1: warioman (big blind) folded before the flop
Seat 2: Player#1397 folded on the turn
Seat 3: Player#3068 (button) folded before the flop
Seat 4: Player#2028 shows [] and won ($1.33) with 

PokerStars Hand #1ee5a7b8-78ae-4a08-9ad5-665a4a399f01:  Hold'em No Limit ($0.1/$0.20 USD) - 2021/11/19 23:14:00 ET
Table 'Huntsville' 6-max Seat #3 is the button
Seat 1: Player#1281 ($36.32 in chips)
Seat 2: warioman ($42.81 in chips)
Seat 3: Player#3709 ($25.51 in chips)
Seat 4: Player#5758 ($8.76 in chips)
Seat 5: Player#4346 ($19.83 in chips)
Seat 6: Player#7487 ($11.80 in chips)
Player#5758: posts small blind $0.10
Player#4346: posts big blind $0.20
*** HOLE CARDS ***
Dealt to warioman [Jd 6s]
Player#7487: calls $0.20
Player#1281: folds
warioman: folds
Player#3709: calls $0.20
Player#5758: calls $0.10
Player#4346: checks
*** FLOP *** [Th 6h 9c]
Player#5758: checks
Player#4346: checks
Player#7487: bets $0.60
Player#3709: raises $0.60 to $1.6
Player#5758: folds
Player#4346: folds
Player#7487: calls $1.00
*** TURN *** [Th 6h 9c] [Qs]
Player#7487: checks
Player#3709: bets $3.00
Player#7487: raises3.00 to $10
Player#3709: calls $7.00
Player#7487 Showing Pocket Cards AA
Player#3709 Showing Pocket Cards 9T
*** RIVER *** [Th 6h 9c] [Qs] [Ac]
Player#7487 collected $22.80 from pot
*** SUMMARY ***
Total Pot $24.00 | Rake $1.20
Board [Th 6h 9c Qs Ac]
Seat 1: Player#1281 folded before the flop
Seat 2: warioman folded before the flop
Seat 3: Player#3709 (button) mucked
Seat 4: Player#5758 (small blind) folded on the flop
Seat 5: Player#4346 (big blind) folded on the flop
Seat 6: Player#7487 shows [Ac Ad] and won ($22.80) with 

PokerStars Hand #ed252dc7-d86a-415f-b43f-6f88017203aa:  Hold'em No Limit ($0.1/$0.20 USD) - 2021/11/19 23:13:00 ET
Table 'Hollywood' 6-max Seat #4 is the button
Seat 1: Player#4536 ($6.80 in chips)
Seat 2: warioman ($23.90 in chips)
Seat 3: Player#6739 ($13.49 in chips)
Seat 4: Player#2754 ($25.49 in chips)
Seat 5: Player#4220 ($16.26 in chips)
Seat 6: Player#9287 ($51.10 in chips)
Player#4220: posts small blind $0.10
Player#9287: posts big blind $0.20
*** HOLE CARDS ***
Dealt to warioman [4h Jd]
Player#4536: folds
warioman: folds
Player#6739: folds
Player#2754: raises0.20 to $1
Player#4220: folds
Player#9287: folds
Player#2754: doesn't show hand
Uncalled bet ($1.00) returned to Player#2754
Player#2754 collected $0.30 from pot
*** SUMMARY ***
Total Pot $0.30 | Rake $0.00
Seat 1: Player#4536 folded before the flop
Seat 2: warioman folded before the flop
Seat 3: Player#6739 folded before the flop
Seat 4: Player#2754 shows [] and won ($0.30) with 
Seat 5: Player#4220 (small blind) folded before the flop
Seat 6: Player#9287 (big blind) folded before the flop

PokerStars Hand #e7a280d5-325d-4237-a092-d98a001b12a8:  Hold'em No Limit ($0.1/$0.20 USD) - 2021/11/19 23:12:00 ET
Table 'Hollywood' 6-max Seat #3 is the button
Seat 1: Player#3539 ($11.00 in chips)
Seat 2: warioman ($23.90 in chips)
Seat 3: Player#4137 ($13.49 in chips)
Seat 4: Player#7009 ($25.59 in chips)
Seat 5: Player#3397 ($12.38 in chips)
Seat 6: Player#8622 ($51.10 in chips)
Player#7009: posts small blind $0.10
Player#3397: posts big blind $0.20
*** HOLE CARDS ***
Dealt to warioman [9c 5h]
Player#8622: folds
Player#3539: calls $0.20
warioman: folds
Player#4137: folds
Player#7009: folds
Player#3397: checks
*** FLOP *** [8d 9d 4c]
Player#3397: checks
Player#3539: bets $0.60
Player#3397: calls $0.60
*** TURN *** [8d 9d 4c] [8h]
Player#3397: checks
Player#3539: bets $0.80
Player#3397: raises0.80 to $2
Player#3539: calls $1.20
*** RIVER *** [8d 9d 4c] [8h] [Th]
Player#3397: bets $1.40
Player#3539: calls $1.40
*** SHOW DOWN *** 
Player#3539: doesn't show hand
Player#3397 collected $8.07 from pot
*** SUMMARY ***
Total Pot $8.50 | Rake $0.43
Board [8d 9d 4c 8h Th]
Seat 1: Player#3539 mucked
Seat 2: warioman folded before the flop
Seat 3: Player#4137 (button) folded before the flop
Seat 4: Player#7009 (small blind) folded before the flop
Seat 5: Player#3397 shows [7c 8c] and won ($8.07) with 
Seat 6: Player#8622 folded before the flop

PokerStars Hand #13d2af38-ef41-4ec8-888c-273fdf80482d:  Hold'em No Limit ($0.1/$0.20 USD) - 2021/11/19 23:12:00 ET
Table 'Hollywood' 6-max Seat #2 is the button
Seat 1: Player#8358 ($11.00 in chips)
Seat 2: warioman ($23.90 in chips)
Seat 3: Player#5710 ($13.69 in chips)
Seat 4: Player#7310 ($25.79 in chips)
Seat 5: Player#4132 ($12.01 in chips)
Seat 6: Player#1542 ($51.10 in chips)
Player#5710: posts small blind $0.10
Player#7310: posts big blind $0.20
*** HOLE CARDS ***
Dealt to warioman [4h 7h]
Player#4132: calls $0.20
Player#1542: folds
Player#8358: folds
warioman: folds
Player#5710: calls $0.10
Player#7310: checks
*** FLOP *** [5c Ts 8s]
Player#5710: checks
Player#7310: checks
Player#4132: bets $0.40
Player#5710: folds
Player#7310: folds
Player#4132: doesn't show hand
Uncalled bet ($0.40) returned to Player#4132
Player#4132 collected $0.57 from pot
*** SUMMARY ***
Total Pot $0.60 | Rake $0.03
Board [5c Ts 8s]
Seat 1: Player#8358 folded before the flop
Seat 2: warioman (button) folded before the flop
Seat 3: Player#5710 (small blind) folded on the flop
Seat 4: Player#7310 (big blind) folded on the flop
Seat 5: Player#4132 shows [] and won ($0.57) with 
Seat 6: Player#1542 folded before the flop

PokerStars Hand #3c2b1b7a-538c-42db-8c86-88fc5d486d26:  Hold'em No Limit ($0.1/$0.20 USD) - 2021/11/19 23:12:00 ET
Table 'Huntsville' 6-max Seat #2 is the button
Seat 1: Player#8806 ($36.32 in chips)
Seat 2: warioman ($46.17 in chips)
Seat 3: Player#6525 ($25.61 in chips)
Seat 4: Player#1521 ($5.45 in chips)
Seat 5: Player#5641 ($19.83 in chips)
Seat 6: Player#8134 ($12.00 in chips)
Player#6525: posts small blind $0.10
Player#1521: posts big blind $0.20
*** HOLE CARDS ***
Dealt to warioman [Kh Qd]
Player#5641: folds
Player#8134: calls $0.20
Player#8806: folds
warioman: raises $0.20 to $0.9
Player#6525: folds
Player#1521: calls $0.70
Player#8134: folds
*** FLOP *** [Qh 7d Ac]
Player#1521: checks
warioman: checks
*** TURN *** [Qh 7d Ac] [2h]
Player#1521: checks
warioman: bets $0.83
Player#1521: raises $0.83 to $1.66
warioman: calls $0.83
*** RIVER *** [Qh 7d Ac] [2h] [4h]
Player#1521: bets $0.80
warioman: calls $0.80
*** SHOW DOWN *** 
warioman: doesn't show hand
Player#1521 collected $6.67 from pot
*** SUMMARY ***
Total Pot $7.02 | Rake $0.35
Board [Qh 7d Ac 2h 4h]
Seat 1: Player#8806 folded before the flop
Seat 2: warioman (button)
Seat 3: Player#6525 (small blind) folded before the flop
Seat 4: Player#1521 shows [Ah 9s] and won ($6.67) with 
Seat 5: Player#5641 folded before the flop
Seat 6: Player#8134 folded before the flop

PokerStars Hand #d9f87644-771a-4e02-8ded-76fae85526e2:  Hold'em No Limit ($0.1/$0.20 USD) - 2021/11/19 23:11:00 ET
Table 'Huntsville' 6-max Seat #1 is the button
Seat 1: Player#4754 ($36.32 in chips)
Seat 2: warioman ($46.27 in chips)
Seat 3: Player#9156 ($25.81 in chips)
Seat 4: Player#5290 ($5.45 in chips)
Seat 5: Player#7091 ($19.53 in chips)
Seat 6: Player#1827 ($12.00 in chips)
warioman: posts small blind $0.10
Player#9156: posts big blind $0.20
*** HOLE CARDS ***
Dealt to warioman [9d 7c]
Player#5290: folds
Player#7091: raises $0.20 to $0.6
Player#1827: folds
Player#4754: folds
warioman: folds
Player#9156: folds
Player#7091: doesn't show hand
Uncalled bet ($0.60) returned to Player#7091
Player#7091 collected $0.30 from pot
*** SUMMARY ***
Total Pot $0.30 | Rake $0.00
Seat 1: Player#4754 (button) folded before the flop
Seat 2: warioman (small blind) folded before the flop
Seat 3: Player#9156 (big blind) folded before the flop
Seat 4: Player#5290 folded before the flop
Seat 5: Player#7091 shows [] and won ($0.30) with 
Seat 6: Player#1827 folded before the flop

PokerStars Hand #8a6c9cf9-8153-4d3a-a9f6-27506c4202d4:  Hold'em No Limit ($0.1/$0.20 USD) - 2021/11/19 23:11:00 ET
Table 'Hollywood' 6-max Seat #1 is the button
Seat 1: Player#2923 ($11.60 in chips)
Seat 2: warioman ($24.00 in chips)
Seat 3: Player#4349 ($14.29 in chips)
Seat 4: Player#0863 ($24.58 in chips)
Seat 5: Player#9673 ($12.01 in chips)
Seat 6: Player#4589 ($51.10 in chips)
warioman: posts small blind $0.10
Player#4349: posts big blind $0.20
*** HOLE CARDS ***
Dealt to warioman [As 5d]
Player#0863: calls $0.20
Player#9673: folds
Player#4589: folds
Player#2923: raises $0.20 to $0.6
warioman: folds
Player#4349: calls $0.40
Player#0863: calls $0.40
*** FLOP *** [4d 3s Qd]
Player#4349: checks
Player#0863: bets $2.60
Player#2923: folds
Player#4349: folds
Player#0863: doesn't show hand
Uncalled bet ($2.60) returned to Player#0863
Player#0863 collected $1.80 from pot
*** SUMMARY ***
Total Pot $1.90 | Rake $0.10
Board [4d 3s Qd]
Seat 1: Player#2923 (button) folded on the flop
Seat 2: warioman (small blind) folded before the flop
Seat 3: Player#4349 (big blind) folded on the flop
Seat 4: Player#0863 shows [] and won ($1.80) with 
Seat 5: Player#9673 folded before the flop
Seat 6: Player#4589 folded before the flop

PokerStars Hand #23a4a54d-ee92-4e47-8b9f-aa8a6ac427ee:  Hold'em No Limit ($0.1/$0.20 USD) - 2021/11/19 23:10:00 ET
Table 'Hollywood' 6-max Seat #6 is the button
Seat 1: Player#4624 ($11.70 in chips)
Seat 2: warioman ($24.20 in chips)
Seat 3: Player#9800 ($14.29 in chips)
Seat 4: Player#3627 ($24.78 in chips)
Seat 5: Player#1843 ($11.51 in chips)
Seat 6: Player#0003 ($51.10 in chips)
Player#4624: posts small blind $0.10
warioman: posts big blind $0.20
*** HOLE CARDS ***
Dealt to warioman [Qd 6h]
Player#9800: folds
Player#3627: calls $0.20
Player#1843: raises $0.20 to $0.8
Player#0003: folds
Player#4624: folds
warioman: folds
Player#3627: folds
Player#1843: doesn't show hand
Uncalled bet ($0.80) returned to Player#1843
Player#1843 collected $0.50 from pot
*** SUMMARY ***
Total Pot $0.50 | Rake $0.00
Seat 1: Player#4624 (small blind) folded before the flop
Seat 2: warioman (big blind) folded before the flop
Seat 3: Player#9800 folded before the flop
Seat 4: Player#3627 folded before the flop
Seat 5: Player#1843 shows [] and won ($0.50) with 
Seat 6: Player#0003 (button) folded before the flop

PokerStars Hand #b3b81dcc-45f2-48b6-b9ff-b29f3026f08f:  Hold'em No Limit ($0.1/$0.20 USD) - 2021/11/19 23:10:00 ET
Table 'Hollywood' 6-max Seat #5 is the button
Seat 1: Player#6157 ($11.90 in chips)
Seat 2: warioman ($24.20 in chips)
Seat 3: Player#0825 ($14.29 in chips)
Seat 4: Player#6052 ($23.69 in chips)
Seat 5: Player#3892 ($11.51 in chips)
Seat 6: Player#4894 ($52.10 in chips)
Player#4894: posts small blind $0.10
Player#6157: posts big blind $0.20
*** HOLE CARDS ***
Dealt to warioman [3h Jh]
warioman: folds
Player#0825: folds
Player#6052: raises0.20 to $1
Player#3892: folds
Player#4894: calls $0.90
Player#6157: folds
*** FLOP *** [7d 7h Jd]
Player#4894: checks
Player#6052: bets $2.20
Player#4894: folds
Player#6052: doesn't show hand
Uncalled bet ($2.20) returned to Player#6052
Player#6052 collected $2.09 from pot
*** SUMMARY ***
Total Pot $2.20 | Rake $0.11
Board [7d 7h Jd]
Seat 1: Player#6157 (big blind) folded before the flop
Seat 2: warioman folded before the flop
Seat 3: Player#0825 folded before the flop
Seat 4: Player#6052 shows [] and won ($2.09) with 
Seat 5: Player#3892 (button) folded before the flop
Seat 6: Player#4894 (small blind) folded on the flop

PokerStars Hand #2e4cb732-500a-4f79-bb84-ccaf7a55164a:  Hold'em No Limit ($0.1/$0.20 USD) - 2021/11/19 23:09:00 ET
Table 'Huntsville' 6-max Seat #6 is the button
Seat 1: Player#8879 ($21.84 in chips)
Seat 2: warioman ($46.47 in chips)
Seat 3: Player#9675 ($25.81 in chips)
Seat 4: Player#2340 ($20.90 in chips)
Seat 5: Player#1343 ($19.53 in chips)
Seat 6: Player#0025 ($12.40 in chips)
Player#8879: posts small blind $0.10
warioman: posts big blind $0.20
*** HOLE CARDS ***
Dealt to warioman [9h 3s]
Player#9675: folds
Player#2340: raises $0.20 to $0.4
Player#1343: folds
Player#0025: calls $0.40
Player#8879: raises $0.40 to $1.8
warioman: folds
Player#2340: calls $1.40
Player#0025: folds
*** FLOP *** [Ks 9s Ac]
Player#8879: bets $3.15
Player#2340: calls $3.15
*** TURN *** [Ks 9s Ac] [Tc]
Player#8879: checks
Player#2340: checks
*** RIVER *** [Ks 9s Ac] [Tc] [2c]
Player#8879: checks
Player#2340: bets $10.50
Player#8879: calls $10.50
*** SHOW DOWN *** 
Player#8879 collected $30.00 from pot
*** SUMMARY ***
Total Pot $31.50 | Rake $1.50
Board [Ks 9s Ac Tc 2c]
Seat 1: Player#8879 shows [Js Jc] and won ($30.00) with 
Seat 2: warioman (big blind) folded before the flop
Seat 3: Player#9675 folded before the flop
Seat 4: Player#2340 mucked
Seat 5: Player#1343 folded before the flop
Seat 6: Player#0025 (button) folded before the flop

PokerStars Hand #30e4d00b-89a2-4f3a-b446-b9a839a13b99:  Hold'em No Limit ($0.1/$0.20 USD) - 2021/11/19 23:09:00 ET
Table 'Hollywood' 6-max Seat #4 is the button
Seat 1: Player#7879 ($12.10 in chips)
Seat 2: warioman ($24.20 in chips)
Seat 3: Player#8181 ($14.39 in chips)
Seat 4: Player#8808 ($24.69 in chips)
Seat 5: Player#5285 ($10.13 in chips)
Seat 6: Player#0575 ($52.30 in chips)
Player#5285: posts small blind $0.10
Player#0575: posts big blind $0.20
*** HOLE CARDS ***
Dealt to warioman [As 2d]
Player#7879: calls $0.20
warioman: folds
Player#8181: folds
Player#8808: calls $0.20
Player#5285: calls $0.10
Player#0575: checks
*** FLOP *** [Ts Kc 7h]
Player#5285: checks
Player#0575: checks
Player#7879: checks
Player#8808: checks
*** TURN *** [Ts Kc 7h] [Jh]
Player#5285: bets $0.80
Player#0575: folds
Player#7879: folds
Player#8808: calls $0.80
*** RIVER *** [Ts Kc 7h] [Jh] [5h]
Player#5285: bets $1.60
Player#8808: folds
Player#5285: doesn't show hand
Uncalled bet ($1.60) returned to Player#5285
Player#5285 collected $2.37 from pot
*** SUMMARY ***
Total Pot $2.50 | Rake $0.12
Board [Ts Kc 7h Jh 5h]
Seat 1: Player#7879 folded on the turn
Seat 2: warioman folded before the flop
Seat 3: Player#8181 folded before the flop
Seat 4: Player#8808 (button) folded on the river
Seat 5: Player#5285 shows [] and won ($2.37) with 
Seat 6: Player#0575 (big blind) folded on the turn

PokerStars Hand #38d5a010-dff4-47b8-8fbd-dff39913a695:  Hold'em No Limit ($0.1/$0.20 USD) - 2021/11/19 23:09:00 ET
Table 'Hollywood' 6-max Seat #3 is the button
Seat 1: Player#6133 ($12.10 in chips)
Seat 2: warioman ($24.20 in chips)
Seat 3: Player#3740 ($14.39 in chips)
Seat 4: Player#1363 ($24.79 in chips)
Seat 5: Player#7168 ($10.03 in chips)
Seat 6: Player#1108 ($52.30 in chips)
Player#1363: posts small blind $0.10
Player#7168: posts big blind $0.20
*** HOLE CARDS ***
Dealt to warioman [5s 7c]
Player#1108: folds
Player#6133: folds
warioman: folds
Player#1363: folds
Player#7168 collected $0.20 from pot
*** SUMMARY ***
Total Pot $0.20 | Rake $0.00
Seat 1: Player#6133 folded before the flop
Seat 2: warioman folded before the flop
Seat 3: Player#3740 (button) mucked
Seat 4: Player#1363 (small blind) folded before the flop
Seat 5: Player#7168 shows [] and won ($0.20) with 
Seat 6: Player#1108 folded before the flop

PokerStars Hand #ec17f239-fede-4b64-b459-2385580e63eb:  Hold'em No Limit ($0.1/$0.20 USD) - 2021/11/19 23:09:00 ET
Table 'Huntsville' 6-max Seat #5 is the button
Seat 1: Player#2228 ($22.44 in chips)
Seat 2: warioman ($46.47 in chips)
Seat 3: Player#9098 ($25.81 in chips)
Seat 4: Player#9828 ($20.90 in chips)
Seat 5: Player#2256 ($20.13 in chips)
Seat 6: Player#8504 ($11.29 in chips)
Player#8504: posts small blind $0.10
Player#2228: posts big blind $0.20
*** HOLE CARDS ***
Dealt to warioman [3s 8s]
warioman: folds
Player#9098: folds
Player#9828: folds
Player#2256: raises $0.20 to $0.6
Player#8504: calls $0.50
Player#2228: calls $0.40
*** FLOP *** [Jc 9h 7d]
Player#8504: checks
Player#2228: checks
Player#2256: checks
*** TURN *** [Jc 9h 7d] [Ks]
Player#8504: bets $1.35
Player#2228: folds
Player#2256: folds
Player#8504: doesn't show hand
Uncalled bet ($1.35) returned to Player#8504
Player#8504 collected $1.71 from pot
*** SUMMARY ***
Total Pot $1.80 | Rake $0.09
Board [Jc 9h 7d Ks]
Seat 1: Player#2228 (big blind) folded on the turn
Seat 2: warioman folded before the flop
Seat 3: Player#9098 folded before the flop
Seat 4: Player#9828 folded before the flop
Seat 5: Player#2256 (button) folded on the turn
Seat 6: Player#8504 shows [] and won ($1.71) with 

PokerStars Hand #0ccef4d8-67a5-40c9-8f8b-2b60419b23cb:  Hold'em No Limit ($0.1/$0.20 USD) - 2021/11/19 23:08:00 ET
Table 'Hollywood' 6-max Seat #1 is the button
Seat 1: Player#9994 ($12.10 in chips)
Seat 2: warioman ($23.83 in chips)
Seat 3: Player#4299 ($24.99 in chips)
Seat 4: Player#8609 ($10.23 in chips)
Seat 5: Player#3006 ($52.30 in chips)
warioman: posts small blind $0.10
Player#4299: posts big blind $0.20
*** HOLE CARDS ***
Dealt to warioman [Js 9s]
Player#8609: calls $0.20
Player#3006: folds
Player#9994: folds
warioman: calls $0.10
Player#4299: checks
*** FLOP *** [5s As Ah]
warioman: bets $0.20
Player#4299: folds
Player#8609: folds
warioman: doesn't show hand
Uncalled bet ($0.20) returned to warioman
warioman collected $0.57 from pot
*** SUMMARY ***
Total Pot $0.60 | Rake $0.03
Board [5s As Ah]
Seat 1: Player#9994 (button) folded before the flop
Seat 2: warioman (small blind)
Seat 3: Player#4299 (big blind) folded on the flop
Seat 4: Player#8609 folded on the flop
Seat 5: Player#3006 folded before the flop

PokerStars Hand #6c2cb0de-0276-46b0-b700-c6d1d101332c:  Hold'em No Limit ($0.1/$0.20 USD) - 2021/11/19 23:08:00 ET
Table 'Hollywood' 6-max Seat #6 is the button
Seat 1: Player#0090 ($12.20 in chips)
Seat 2: warioman ($24.03 in chips)
Seat 3: Player#1239 ($25.59 in chips)
Seat 4: Player#2821 ($10.23 in chips)
Seat 5: Player#4280 ($51.47 in chips)
Player#0090: posts small blind $0.10
warioman: posts big blind $0.20
*** HOLE CARDS ***
Dealt to warioman [4s Th]
Player#1239: calls $0.20
Player#2821: folds
Player#4280: raises $0.20 to $0.6
Player#0090: folds
warioman: folds
Player#1239: calls $0.40
*** FLOP *** [2c 5c As]
Player#1239: checks
Player#4280: bets $0.75
Player#1239: folds
Player#4280: doesn't show hand
Uncalled bet ($0.75) returned to Player#4280
Player#4280 collected $1.43 from pot
*** SUMMARY ***
Total Pot $1.50 | Rake $0.08
Board [2c 5c As]
Seat 1: Player#0090 (small blind) folded before the flop
Seat 2: warioman (big blind) folded before the flop
Seat 3: Player#1239 folded on the flop
Seat 4: Player#2821 folded before the flop
Seat 5: Player#4280 shows [] and won ($1.43) with 

PokerStars Hand #5fb3559e-de17-4cb9-8793-acaac376befa:  Hold'em No Limit ($0.1/$0.20 USD) - 2021/11/19 23:08:00 ET
Table 'Huntsville' 6-max Seat #4 is the button
Seat 1: Player#1844 ($22.44 in chips)
Seat 2: warioman ($46.47 in chips)
Seat 3: Player#3885 ($23.00 in chips)
Seat 4: Player#7750 ($23.70 in chips)
Seat 5: Player#8612 ($20.23 in chips)
Seat 6: Player#0964 ($11.49 in chips)
Player#8612: posts small blind $0.10
Player#0964: posts big blind $0.20
*** HOLE CARDS ***
Dealt to warioman [Kd 9s]
Player#1844: folds
warioman: folds
Player#3885: raises $0.20 to $0.6
Player#7750: raises0.60 to $1
Player#8612: folds
Player#0964: folds
Player#3885: raises $1.00 to $2.8
Player#7750: calls $1.80
*** FLOP *** [2s 6h 6c]
Player#3885: bets $2.00
Player#7750: folds
Player#3885: doesn't show hand
Uncalled bet ($2.00) returned to Player#3885
Player#3885 collected $5.60 from pot
*** SUMMARY ***
Total Pot $5.90 | Rake $0.29
Board [2s 6h 6c]
Seat 1: Player#1844 folded before the flop
Seat 2: warioman folded before the flop
Seat 3: Player#3885 shows [] and won ($5.60) with 
Seat 4: Player#7750 (button) folded on the flop
Seat 5: Player#8612 (small blind) folded before the flop
Seat 6: Player#0964 (big blind) folded before the flop

PokerStars Hand #b2388bcf-fac0-4687-8595-49d548512eb8:  Hold'em No Limit ($0.1/$0.20 USD) - 2021/11/19 23:08:00 ET
Table 'Hollywood' 6-max Seat #4 is the button
Seat 1: Player#1992 ($12.40 in chips)
Seat 2: warioman ($24.03 in chips)
Seat 3: Player#7747 ($25.59 in chips)
Seat 4: Player#8477 ($9.93 in chips)
Seat 5: Player#8538 ($51.57 in chips)
Player#8538: posts small blind $0.10
Player#1992: posts big blind $0.20
*** HOLE CARDS ***
Dealt to warioman [7s Kd]
warioman: folds
Player#7747: folds
Player#8477: raises $0.20 to $0.6
Player#8538: folds
Player#1992: folds
Player#8477: doesn't show hand
Uncalled bet ($0.60) returned to Player#8477
Player#8477 collected $0.30 from pot
*** SUMMARY ***
Total Pot $0.30 | Rake $0.00
Seat 1: Player#1992 (big blind) folded before the flop
Seat 2: warioman folded before the flop
Seat 3: Player#7747 folded before the flop
Seat 4: Player#8477 shows [] and won ($0.30) with 
Seat 5: Player#8538 (small blind) folded before the flop

PokerStars Hand #e0260426-2ca0-405c-a733-f740d1c2759e:  Hold'em No Limit ($0.1/$0.20 USD) - 2021/11/19 23:07:00 ET
Table 'Huntsville' 6-max Seat #3 is the button
Seat 1: Player#0142 ($22.44 in chips)
Seat 2: warioman ($46.47 in chips)
Seat 3: Player#9998 ($23.00 in chips)
Seat 4: Player#7660 ($23.90 in chips)
Seat 5: Player#2278 ($19.50 in chips)
Seat 6: Player#3303 ($12.09 in chips)
Player#7660: posts small blind $0.10
Player#2278: posts big blind $0.20
*** HOLE CARDS ***
Dealt to warioman [6c Qs]
Player#3303: calls $0.20
Player#0142: folds
warioman: folds
Player#9998: folds
Player#7660: calls $0.10
Player#2278: raises $0.20 to $0.6
Player#3303: calls $0.40
Player#7660: folds
*** FLOP *** [4d Kc 4c]
Player#2278: bets $0.70
Player#3303: folds
Player#2278: doesn't show hand
Uncalled bet ($0.70) returned to Player#2278
Player#2278 collected $1.33 from pot
*** SUMMARY ***
Total Pot $1.40 | Rake $0.07
Board [4d Kc 4c]
Seat 1: Player#0142 folded before the flop
Seat 2: warioman folded before the flop
Seat 3: Player#9998 (button) folded before the flop
Seat 4: Player#7660 (small blind) folded before the flop
Seat 5: Player#2278 shows [] and won ($1.33) with 
Seat 6: Player#3303 folded on the flop

PokerStars Hand #e9049bcf-1124-45b3-b39a-b03dce44635f:  Hold'em No Limit ($0.1/$0.20 USD) - 2021/11/19 23:07:00 ET
Table 'Hollywood' 6-max Seat #3 is the button
Seat 1: Player#8644 ($13.00 in chips)
Seat 2: warioman ($24.03 in chips)
Seat 3: Player#5293 ($24.29 in chips)
Seat 4: Player#3006 ($10.13 in chips)
Seat 5: Player#4172 ($52.17 in chips)
Player#3006: posts small blind $0.10
Player#4172: posts big blind $0.20
*** HOLE CARDS ***
Dealt to warioman [7c 8s]
Player#8644 Entry Bet 0.2
Player#8644: checks
warioman: folds
Player#5293: calls $0.20
Player#3006: calls $0.10
Player#4172: checks
*** FLOP *** [Qc 2c Jh]
Player#3006: checks
Player#4172: checks
Player#8644: checks
Player#5293: checks
*** TURN *** [Qc 2c Jh] [Kc]
Player#3006: folds
Player#4172: bets $0.40
Player#8644: calls $0.40
Player#5293: calls $0.40
*** RIVER *** [Qc 2c Jh] [Kc] [Jc]
Player#4172: checks
Player#8644: checks
Player#5293: bets $2.00
Player#4172: folds
Player#8644: folds
Player#5293: doesn't show hand
Uncalled bet ($2.00) returned to Player#5293
Player#5293 collected $1.71 from pot
*** SUMMARY ***
Total Pot $1.80 | Rake $0.09
Board [Qc 2c Jh Kc Jc]
Seat 1: Player#8644 folded on the river
Seat 2: warioman folded before the flop
Seat 3: Player#5293 shows [] and won ($1.71) with 
Seat 4: Player#3006 (small blind) folded on the turn
Seat 5: Player#4172 (big blind) folded on the river

PokerStars Hand #c7119ab0-0f41-433a-ab16-5c428af71092:  Hold'em No Limit ($0.1/$0.20 USD) - 2021/11/19 23:07:00 ET
Table 'Huntsville' 6-max Seat #2 is the button
Seat 1: Player#1547 ($22.44 in chips)
Seat 2: warioman ($46.47 in chips)
Seat 3: Player#3071 ($23.10 in chips)
Seat 4: Player#0258 ($24.10 in chips)
Seat 5: Player#3981 ($19.50 in chips)
Seat 6: Player#5268 ($11.81 in chips)
Player#3071: posts small blind $0.10
Player#0258: posts big blind $0.20
*** HOLE CARDS ***
Dealt to warioman [5h 6c]
Player#3981: folds
Player#5268: calls $0.20
Player#1547: folds
warioman: folds
Player#3071: folds
Player#0258: checks
*** FLOP *** [9c Kd 2h]
Player#0258: checks
Player#5268: bets $0.60
Player#0258: folds
Player#5268: doesn't show hand
Uncalled bet ($0.60) returned to Player#5268
Player#5268 collected $0.48 from pot
*** SUMMARY ***
Total Pot $0.50 | Rake $0.03
Board [9c Kd 2h]
Seat 1: Player#1547 folded before the flop
Seat 2: warioman (button) folded before the flop
Seat 3: Player#3071 (small blind) folded before the flop
Seat 4: Player#0258 (big blind) folded on the flop
Seat 5: Player#3981 folded before the flop
Seat 6: Player#5268 shows [] and won ($0.48) with 

PokerStars Hand #836351a9-6de6-4816-9ae5-8aa081ca55dc:  Hold'em No Limit ($0.1/$0.20 USD) - 2021/11/19 23:06:00 ET
Table 'Huntsville' 6-max Seat #1 is the button
Seat 1: Player#9655 ($22.44 in chips)
Seat 2: warioman ($46.57 in chips)
Seat 3: Player#2294 ($23.50 in chips)
Seat 4: Player#3182 ($24.50 in chips)
Seat 5: Player#3631 ($19.50 in chips)
Seat 6: Player#5025 ($10.97 in chips)
warioman: posts small blind $0.10
Player#2294: posts big blind $0.20
*** HOLE CARDS ***
Dealt to warioman [7s 6h]
Player#3182: raises $0.20 to $0.4
Player#3631: folds
Player#5025: calls $0.40
Player#9655: folds
warioman: folds
Player#2294: calls $0.20
*** FLOP *** [9d Qd 3s]
Player#2294: checks
Player#3182: checks
Player#5025: bets $0.65
Player#2294: folds
Player#3182: folds
Player#5025: doesn't show hand
Uncalled bet ($0.65) returned to Player#5025
Player#5025 collected $1.24 from pot
*** SUMMARY ***
Total Pot $1.30 | Rake $0.07
Board [9d Qd 3s]
Seat 1: Player#9655 (button) folded before the flop
Seat 2: warioman (small blind) folded before the flop
Seat 3: Player#2294 (big blind) folded on the flop
Seat 4: Player#3182 folded on the flop
Seat 5: Player#3631 folded before the flop
Seat 6: Player#5025 shows [] and won ($1.24) with 

PokerStars Hand #d16636bc-c423-47c9-b979-d01cbaf31a1f:  Hold'em No Limit ($0.1/$0.20 USD) - 2021/11/19 23:06:00 ET
Table 'Hollywood' 6-max Seat #1 is the button
Seat 1: warioman ($24.03 in chips)
Seat 2: Player#1918 ($12.78 in chips)
Seat 3: Player#0847 ($22.91 in chips)
Seat 4: Player#7678 ($52.17 in chips)
Player#1918: posts small blind $0.10
Player#0847: posts big blind $0.20
*** HOLE CARDS ***
Dealt to warioman [6c 4s]
Player#7678: folds
warioman: folds
Player#1918: calls $0.10
Player#0847: checks
*** FLOP *** [2c Qs 3c]
Player#1918: checks
Player#0847: checks
*** TURN *** [2c Qs 3c] [Qd]
Player#1918: checks
Player#0847: bets $0.40
Player#1918: raises $0.40 to $1.8
Player#0847: calls $1.40
*** RIVER *** [2c Qs 3c] [Qd] [Jd]
Player#1918: bets $4.00
Player#0847: raises $ 24.00 to $20.91
Player#1918: calls $6.78
*** SHOW DOWN *** 
Player#1918 collected $34.19 from pot
*** SUMMARY ***
Total Pot $35.69 | Rake $1.50
Board [2c Qs 3c Qd Jd]
Seat 1: warioman (button) folded before the flop
Seat 2: Player#1918 shows [3d 3s] and won ($34.19) with 
Seat 3: Player#0847 (big blind) mucked
Seat 4: Player#7678 folded before the flop

PokerStars Hand #88fe6f98-5348-4628-b515-af59fa15da3a:  Hold'em No Limit ($0.1/$0.20 USD) - 2021/11/19 23:05:00 ET
Table 'Huntsville' 6-max Seat #6 is the button
Seat 1: Player#7173 ($20.40 in chips)
Seat 2: warioman ($46.77 in chips)
Seat 3: Player#3385 ($24.50 in chips)
Seat 4: Player#1527 ($24.50 in chips)
Seat 5: Player#0322 ($19.50 in chips)
Seat 6: Player#0466 ($11.97 in chips)
Player#7173: posts small blind $0.10
warioman: posts big blind $0.20
*** HOLE CARDS ***
Dealt to warioman [Ad 4s]
Player#3385: calls $0.20
Player#1527: folds
Player#0322: folds
Player#0466: calls $0.20
Player#7173: raises0.20 to $1
warioman: folds
Player#3385: calls $0.80
Player#0466: calls $0.80
*** FLOP *** [5d 7s 2d]
Player#7173: bets $2.00
Player#3385: folds
Player#0466: folds
Player#7173: doesn't show hand
Uncalled bet ($2.00) returned to Player#7173
Player#7173 collected $3.04 from pot
*** SUMMARY ***
Total Pot $3.20 | Rake $0.16
Board [5d 7s 2d]
Seat 1: Player#7173 shows [] and won ($3.04) with 
Seat 2: warioman (big blind) folded before the flop
Seat 3: Player#3385 folded on the flop
Seat 4: Player#1527 folded before the flop
Seat 5: Player#0322 folded before the flop
Seat 6: Player#0466 (button) folded on the flop

PokerStars Hand #250d543c-d6cf-440a-9f3f-b3dc475681a3:  Hold'em No Limit ($0.1/$0.20 USD) - 2021/11/19 23:05:00 ET
Table 'Huntsville' 6-max Seat #5 is the button
Seat 1: Player#2772 ($20.00 in chips)
Seat 2: warioman ($46.77 in chips)
Seat 3: Player#5148 ($24.50 in chips)
Seat 4: Player#7729 ($24.70 in chips)
Seat 5: Player#3882 ($19.50 in chips)
Seat 6: Player#8799 ($12.17 in chips)
Player#8799: posts small blind $0.10
Player#2772: posts big blind $0.20
*** HOLE CARDS ***
Dealt to warioman [Td Qc]
warioman: folds
Player#5148: folds
Player#7729: calls $0.20
Player#3882: folds
Player#8799: calls $0.10
Player#2772: raises0.20 to $1
Player#7729: folds
Player#8799: folds
Player#2772: doesn't show hand
Uncalled bet ($1.00) returned to Player#2772
Player#2772 collected $0.40 from pot
*** SUMMARY ***
Total Pot $0.40 | Rake $0.00
Seat 1: Player#2772 shows [] and won ($0.40) with 
Seat 2: warioman folded before the flop
Seat 3: Player#5148 folded before the flop
Seat 4: Player#7729 folded before the flop
Seat 5: Player#3882 (button) folded before the flop
Seat 6: Player#8799 (small blind) folded before the flop

PokerStars Hand #c570bcdb-9e56-4a64-b8de-9164647174e1:  Hold'em No Limit ($0.1/$0.20 USD) - 2021/11/19 23:04:00 ET
Table 'Hollywood' 6-max Seat #2 is the button
Seat 1: Player#2770 ($16.14 in chips)
Seat 2: warioman ($19.70 in chips)
Seat 3: Player#1273 ($16.58 in chips)
Seat 4: Player#7769 ($23.86 in chips)
Seat 5: Player#3597 ($52.17 in chips)
Player#1273: posts small blind $0.10
warioman: posts big blind $0.20
*** HOLE CARDS ***
Dealt to warioman [3c Kc]
Player#7769: calls $0.20
Player#3597: folds
Player#2770: folds
warioman: raises $0.20 to $0.5
Player#1273: calls $0.30
Player#7769: calls $0.30
*** FLOP *** [Ks Kh Qs]
Player#1273: checks
Player#7769: checks
warioman: bets $0.45
Player#1273: calls $0.45
Player#7769: calls $0.45
*** TURN *** [Ks Kh Qs] [Qc]
Player#1273: checks
Player#7769: checks
warioman: checks
*** RIVER *** [Ks Kh Qs] [Qc] [Tc]
Player#1273: bets $2.85
Player#7769: folds
warioman: calls $2.85
*** SHOW DOWN *** 
warioman collected $8.12 from pot
*** SUMMARY ***
Total Pot $8.55 | Rake $0.43
Board [Ks Kh Qs Qc Tc]
Seat 1: Player#2770 folded before the flop
Seat 2: warioman (big blind)
Seat 3: Player#1273 (small blind) mucked
Seat 4: Player#7769 folded on the river
Seat 5: Player#3597 folded before the flop

PokerStars Hand #7a21ac2b-0a47-4dbd-997e-b1d8452f6299:  Hold'em No Limit ($0.1/$0.20 USD) - 2021/11/19 23:04:00 ET
Table 'Huntsville' 6-max Seat #4 is the button
Seat 1: Player#1550 ($20.00 in chips)
Seat 2: warioman ($46.97 in chips)
Seat 3: Player#8815 ($25.50 in chips)
Seat 4: Player#4130 ($23.32 in chips)
Seat 5: Player#4485 ($19.60 in chips)
Seat 6: Player#9445 ($12.37 in chips)
Player#4485: posts small blind $0.10
Player#9445: posts big blind $0.20
*** HOLE CARDS ***
Dealt to warioman [Ac 4h]
Player#1550: folds
warioman: calls $0.20
Player#8815: raises $0.20 to $0.6
Player#4130: raises0.60 to $1
Player#4485: folds
Player#9445: folds
warioman: folds
Player#8815: calls $0.40
*** FLOP *** [4s 5c Kh]
Player#8815: checks
Player#4130: bets $2.50
Player#8815: folds
Player#4130: doesn't show hand
Uncalled bet ($2.50) returned to Player#4130
Player#4130 collected $2.38 from pot
*** SUMMARY ***
Total Pot $2.50 | Rake $0.12
Board [4s 5c Kh]
Seat 1: Player#1550 folded before the flop
Seat 2: warioman folded before the flop
Seat 3: Player#8815 folded on the flop
Seat 4: Player#4130 shows [] and won ($2.38) with 
Seat 5: Player#4485 (small blind) folded before the flop
Seat 6: Player#9445 (big blind) folded before the flop

PokerStars Hand #f46da064-60cc-4262-a72e-6810421f2255:  Hold'em No Limit ($0.1/$0.20 USD) - 2021/11/19 23:03:00 ET
Table 'Hollywood' 6-max Seat #1 is the button
Seat 1: Player#2000 ($16.14 in chips)
Seat 2: warioman ($19.80 in chips)
Seat 3: Player#9352 ($14.59 in chips)
Seat 4: Player#5077 ($21.13 in chips)
Seat 5: Player#8949 ($19.48 in chips)
Seat 6: Player#3849 ($52.17 in chips)
warioman: posts small blind $0.10
Player#9352: posts big blind $0.20
*** HOLE CARDS ***
Dealt to warioman [4h 8c]
Player#5077: calls $0.20
Player#8949: raises $0.20 to $0.8
Player#3849: folds
Player#2000: folds
warioman: folds
Player#9352: folds
Player#5077: calls $0.60
*** FLOP *** [Qh Kc 9c]
Player#5077: checks
Player#8949: bets $1.40
Player#5077: calls $1.40
*** TURN *** [Qh Kc 9c] [Qd]
Player#5077: checks
Player#8949: checks
*** RIVER *** [Qh Kc 9c] [Qd] [3d]
Player#5077: bets $2.35
Player#8949: calls $2.35
*** SHOW DOWN *** 
Player#8949 collected $8.93 from pot
*** SUMMARY ***
Total Pot $9.40 | Rake $0.47
Board [Qh Kc 9c Qd 3d]
Seat 1: Player#2000 (button) folded before the flop
Seat 2: warioman (small blind) folded before the flop
Seat 3: Player#9352 (big blind) folded before the flop
Seat 4: Player#5077 mucked
Seat 5: Player#8949 shows [Ts Th] and won ($8.93) with 
Seat 6: Player#3849 folded before the flop

PokerStars Hand #0e2e5ff2-8d54-4191-a539-cc8083d0b69d:  Hold'em No Limit ($0.1/$0.20 USD) - 2021/11/19 23:03:00 ET
Table 'Huntsville' 6-max Seat #3 is the button
Seat 1: Player#8583 ($20.00 in chips)
Seat 2: warioman ($46.23 in chips)
Seat 3: Player#5926 ($26.00 in chips)
Seat 4: Player#1472 ($23.42 in chips)
Seat 5: Player#5761 ($19.80 in chips)
Seat 6: Player#2589 ($12.37 in chips)
Player#1472: posts small blind $0.10
Player#5761: posts big blind $0.20
*** HOLE CARDS ***
Dealt to warioman [Jd Qd]
Player#2589: folds
Player#8583: folds
warioman: raises $0.20 to $0.5
Player#5926: calls $0.50
Player#1472: folds
Player#5761: folds
*** FLOP *** [5c Qs 6c]
warioman: checks
Player#5926: checks
*** TURN *** [5c Qs 6c] [2h]
warioman: bets $0.78
Player#5926: folds
warioman: doesn't show hand
Uncalled bet ($0.78) returned to warioman
warioman collected $1.24 from pot
*** SUMMARY ***
Total Pot $1.30 | Rake $0.07
Board [5c Qs 6c 2h]
Seat 1: Player#8583 folded before the flop
Seat 2: warioman
Seat 3: Player#5926 (button) folded on the turn
Seat 4: Player#1472 (small blind) folded before the flop
Seat 5: Player#5761 (big blind) folded before the flop
Seat 6: Player#2589 folded before the flop

PokerStars Hand #dd94c500-4b2b-4412-921b-133988072ba0:  Hold'em No Limit ($0.1/$0.20 USD) - 2021/11/19 23:03:00 ET
Table 'Hollywood' 6-max Seat #6 is the button
Seat 1: Player#2474 ($16.34 in chips)
Seat 2: warioman ($20.00 in chips)
Seat 3: Player#3969 ($14.59 in chips)
Seat 4: Player#7123 ($20.76 in chips)
Seat 5: Player#3720 ($19.48 in chips)
Seat 6: Player#0962 ($52.17 in chips)
Player#2474: posts small blind $0.10
warioman: posts big blind $0.20
*** HOLE CARDS ***
Dealt to warioman [7h 2h]
Player#3969: folds
Player#7123: calls $0.20
Player#3720: folds
Player#0962: folds
Player#2474: calls $0.10
warioman: checks
*** FLOP *** [9c Jc 8c]
Player#2474: checks
warioman: checks
Player#7123: bets $0.60
Player#2474: folds
warioman: folds
Player#7123: doesn't show hand
Uncalled bet ($0.60) returned to Player#7123
Player#7123 collected $0.57 from pot
*** SUMMARY ***
Total Pot $0.60 | Rake $0.03
Board [9c Jc 8c]
Seat 1: Player#2474 (small blind) folded on the flop
Seat 2: warioman (big blind) folded on the flop
Seat 3: Player#3969 folded before the flop
Seat 4: Player#7123 shows [] and won ($0.57) with 
Seat 5: Player#3720 folded before the flop
Seat 6: Player#0962 (button) folded before the flop

PokerStars Hand #c6e4d4a7-66f7-48fa-9308-fdeef158cdc7:  Hold'em No Limit ($0.1/$0.20 USD) - 2021/11/19 23:03:00 ET
Table 'Huntsville' 6-max Seat #2 is the button
Seat 1: Player#0061 ($18.14 in chips)
Seat 2: warioman ($46.23 in chips)
Seat 3: Player#4666 ($26.20 in chips)
Seat 4: Player#9964 ($23.62 in chips)
Seat 5: Player#7596 ($19.80 in chips)
Seat 6: Player#7383 ($12.00 in chips)
Player#4666: posts small blind $0.10
Player#9964: posts big blind $0.20
*** HOLE CARDS ***
Dealt to warioman [6s 5d]
Player#7596: folds
Player#7383: calls $0.20
Player#0061: folds
warioman: folds
Player#4666: calls $0.10
Player#9964: checks
*** FLOP *** [6d 2s 4s]
Player#4666: checks
Player#9964: checks
Player#7383: bets $0.60
Player#4666: folds
Player#9964: folds
Player#7383: doesn't show hand
Uncalled bet ($0.60) returned to Player#7383
Player#7383 collected $0.57 from pot
*** SUMMARY ***
Total Pot $0.60 | Rake $0.03
Board [6d 2s 4s]
Seat 1: Player#0061 folded before the flop
Seat 2: warioman (button) folded before the flop
Seat 3: Player#4666 (small blind) folded on the flop
Seat 4: Player#9964 (big blind) folded on the flop
Seat 5: Player#7596 folded before the flop
Seat 6: Player#7383 shows [] and won ($0.57) with 

PokerStars Hand #49d988c1-81f4-404a-a64e-9581071f268b:  Hold'em No Limit ($0.1/$0.20 USD) - 2021/11/19 23:02:00 ET
Table 'Hollywood' 6-max Seat #1 is the button
Seat 1: Player#4806 ($15.44 in chips)
Seat 2: warioman ($20.00 in chips)
Seat 3: Player#1121 ($14.59 in chips)
Seat 4: Player#8682 ($20.76 in chips)
Seat 5: Player#3023 ($19.48 in chips)
Seat 6: Player#8811 ($53.17 in chips)
warioman: posts small blind $0.10
Player#8811: posts big blind $0.20
*** HOLE CARDS ***
Dealt to warioman []
warioman Waiting
Player#1121: folds
Player#8682: folds
Player#3023: folds
Player#8811: calls $0.10
Player#4806: raises0.20 to $1
Player#8811: calls $0.80
*** FLOP *** [9h 6s Ts]
Player#8811: checks
Player#4806: bets $2.00
Player#8811: folds
Player#4806: doesn't show hand
Uncalled bet ($2.00) returned to Player#4806
Player#4806 collected $1.90 from pot
*** SUMMARY ***
Total Pot $2.00 | Rake $0.10
Board [9h 6s Ts]
Seat 1: Player#4806 shows [] and won ($1.90) with 
Seat 2: warioman (small blind)
Seat 3: Player#1121 folded before the flop
Seat 4: Player#8682 folded before the flop
Seat 5: Player#3023 folded before the flop
Seat 6: Player#8811 (big blind) folded on the flop

PokerStars Hand #dbbad398-acbf-4b08-b189-45fb85768f04:  Hold'em No Limit ($0.1/$0.20 USD) - 2021/11/19 23:02:00 ET
Table 'Huntsville' 6-max Seat #1 is the button
Seat 1: Player#9191 ($21.84 in chips)
Seat 2: warioman ($46.33 in chips)
Seat 3: Player#4254 ($26.40 in chips)
Seat 4: Player#0984 ($20.00 in chips)
Seat 5: Player#8072 ($19.80 in chips)
Seat 6: Player#7063 ($12.00 in chips)
warioman: posts small blind $0.10
Player#4254: posts big blind $0.20
*** HOLE CARDS ***
Dealt to warioman [4h 2s]
Player#0984 Entry Bet 0.2
Player#0984: checks
Player#8072: folds
Player#7063: folds
Player#9191: raises $0.20 to $0.9
warioman: folds
Player#4254: folds
Player#0984: calls $0.70
*** FLOP *** [2c Ac Jc]
Player#0984: checks
Player#9191: bets $1.40
Player#0984: raises $1.40 to $2.8
Player#9191: calls $1.40
*** TURN *** [2c Ac Jc] [Qc]
Player#0984: bets $7.70
Player#9191: folds
Player#0984: doesn't show hand
Uncalled bet ($7.70) returned to Player#0984
Player#0984 collected $7.12 from pot
*** SUMMARY ***
Total Pot $7.50 | Rake $0.38
Board [2c Ac Jc Qc]
Seat 1: Player#9191 (button) folded on the turn
Seat 2: warioman (small blind) folded before the flop
Seat 3: Player#4254 (big blind) folded before the flop
Seat 4: Player#0984 shows [] and won ($7.12) with 
Seat 5: Player#8072 folded before the flop
Seat 6: Player#7063 folded before the flop

PokerStars Hand #4c5eb05d-685d-49ee-b884-8c7f7cbd1b1d:  Hold'em No Limit ($0.1/$0.20 USD) - 2021/11/19 23:01:00 ET
Table 'Hollywood' 6-max Seat #1 is the button
Seat 1: Player#5809 ($15.44 in chips)
Seat 2: warioman ($20.00 in chips)
Seat 3: Player#4132 ($12.76 in chips)
Seat 4: Player#6517 ($20.76 in chips)
Seat 5: Player#8168 ($20.88 in chips)
Seat 6: Player#5539 ($53.77 in chips)
warioman: posts small blind $0.10
Player#8168: posts big blind $0.20
*** HOLE CARDS ***
Dealt to warioman []
warioman Waiting
Player#5809: folds
Player#4132: raises $0.20 to $0.6
Player#6517: folds
Player#8168: calls $0.50
Player#5539: calls $0.40
*** FLOP *** [Ah 9h Ad]
Player#8168: checks
Player#5539: checks
Player#4132: checks
*** TURN *** [Ah 9h Ad] [8s]
Player#8168: bets $0.80
Player#5539: folds
Player#4132: calls $0.80
*** RIVER *** [Ah 9h Ad] [8s] [Qs]
Player#8168: checks
Player#4132: bets $1.70
Player#8168: folds
Player#4132: doesn't show hand
Uncalled bet ($1.70) returned to Player#4132
Player#4132 collected $3.23 from pot
*** SUMMARY ***
Total Pot $3.40 | Rake $0.17
Board [Ah 9h Ad 8s Qs]
Seat 1: Player#5809 (button) folded before the flop
Seat 2: warioman (small blind)
Seat 3: Player#4132 shows [] and won ($3.23) with 
Seat 4: Player#6517 folded before the flop
Seat 5: Player#8168 (big blind) folded on the river
Seat 6: Player#5539 folded on the turn

PokerStars Hand #9c26c037-a6d0-43c8-a152-07096f239e16:  Hold'em No Limit ($0.1/$0.20 USD) - 2021/11/19 23:01:00 ET
Table 'Hollywood' 6-max Seat #1 is the button
Seat 1: Player#9025 ($15.44 in chips)
Seat 2: warioman ($20.00 in chips)
Seat 3: Player#8105 ($12.76 in chips)
Seat 4: Player#8004 ($20.86 in chips)
Seat 5: Player#8531 ($22.68 in chips)
Seat 6: Player#7587 ($52.05 in chips)
warioman: posts small blind $0.10
Player#8004: posts big blind $0.20
*** HOLE CARDS ***
Dealt to warioman []
warioman Waiting
Player#7587: raises $0.20 to $0.6
Player#9025: folds
Player#8105: folds
Player#8004: folds
Player#8531: calls $0.40
*** FLOP *** [As 8c 9h]
Player#8531: checks
Player#7587: checks
*** TURN *** [As 8c 9h] [Jd]
Player#8531: checks
Player#7587: checks
*** RIVER *** [As 8c 9h] [Jd] [6d]
Player#8531: bets $0.60
Player#7587: raises $0.60 to $1.2
Player#8531: calls $0.60
*** SHOW DOWN *** 
Player#8531: doesn't show hand
Player#7587 collected $3.52 from pot
*** SUMMARY ***
Total Pot $3.70 | Rake $0.19
Board [As 8c 9h Jd 6d]
Seat 1: Player#9025 (button) folded before the flop
Seat 2: warioman (small blind)
Seat 3: Player#8105 folded before the flop
Seat 4: Player#8004 (big blind) folded before the flop
Seat 5: Player#8531 mucked
Seat 6: Player#7587 shows [6c Ac] and won ($3.52) with 

PokerStars Hand #97f26a7c-e760-4f3d-a756-9f531372afcf:  Hold'em No Limit ($0.1/$0.20 USD) - 2021/11/19 23:00:00 ET
Table 'Huntsville' 6-max Seat #3 is the button
Seat 1: Player#7060 ($21.94 in chips)
Seat 2: warioman ($46.53 in chips)
Seat 3: Player#2615 ($22.82 in chips)
Seat 4: Player#6769 ($20.00 in chips)
Seat 5: Player#4460 ($20.00 in chips)
Seat 6: Player#0131 ($15.45 in chips)
Player#6769: posts small blind $0.10
Player#7060: posts big blind $0.20
*** HOLE CARDS ***
Dealt to warioman [6h 2s]
Player#6769 Waiting
Player#4460 Entry Bet 0.2
Player#2615: raises $0.20 to $0.6
Player#4460: folds
Player#0131: calls $0.60
Player#7060: folds
warioman: folds
*** FLOP *** [3c 9h 4h]
Player#2615: bets $1.00
Player#0131: calls $1.00
*** TURN *** [3c 9h 4h] [6c]
Player#2615: checks
Player#0131: bets $1.85
Player#2615: calls $1.85
*** RIVER *** [3c 9h 4h] [6c] [Kc]
Player#2615: bets $3.60
Player#0131: folds
Player#2615: doesn't show hand
Uncalled bet ($3.60) returned to Player#2615
Player#2615 collected $6.84 from pot
*** SUMMARY ***
Total Pot $7.20 | Rake $0.36
Board [3c 9h 4h 6c Kc]
Seat 1: Player#7060 (big blind) folded before the flop
Seat 2: warioman folded before the flop
Seat 3: Player#2615 shows [] and won ($6.84) with 
Seat 4: Player#6769 (small blind) mucked
Seat 5: Player#4460 folded before the flop
Seat 6: Player#0131 folded on the river

PokerStars Hand #6731ee10-9090-48d1-abaa-8e0784acb71d:  Hold'em No Limit ($0.1/$0.20 USD) - 2021/11/19 23:00:00 ET
Table 'Hollywood' 6-max Seat #2 is the button
Seat 1: Player#3383 ($14.94 in chips)
Seat 2: warioman ($20.00 in chips)
Seat 3: Player#7325 ($12.86 in chips)
Seat 4: Player#2745 ($21.06 in chips)
Seat 5: Player#2566 ($22.68 in chips)
Seat 6: Player#3035 ($52.25 in chips)
Player#7325: posts small blind $0.10
Player#2745: posts big blind $0.20
*** HOLE CARDS ***
Dealt to warioman []
Player#2566: folds
Player#3035: calls $0.20
Player#3383: raises $0.20 to $0.9
Player#7325: folds
Player#2745: folds
Player#3035: folds
Player#3383: doesn't show hand
Uncalled bet ($0.90) returned to Player#3383
Player#3383 collected $0.50 from pot
*** SUMMARY ***
Total Pot $0.50 | Rake $0.00
Seat 1: Player#3383 shows [] and won ($0.50) with 
Seat 2: warioman (button)
Seat 3: Player#7325 (small blind) folded before the flop
Seat 4: Player#2745 (big blind) folded before the flop
Seat 5: Player#2566 folded before the flop
Seat 6: Player#3035 folded before the flop

PokerStars Hand #9cfca25e-c028-49af-b83f-3e4ab75a15c5:  Hold'em No Limit ($0.1/$0.20 USD) - 2021/11/19 22:59:00 ET
Table 'Huntsville' 6-max Seat #4 is the button
Seat 1: Player#3740 ($22.54 in chips)
Seat 2: warioman ($46.53 in chips)
Seat 3: Player#4858 ($20.00 in chips)
Seat 4: Player#7988 ($20.00 in chips)
Seat 5: Player#1200 ($17.95 in chips)
Player#1200: posts small blind $0.10
Player#3740: posts big blind $0.20
*** HOLE CARDS ***
Dealt to warioman [8s 5h]
warioman: folds
Player#4858: raises $0.20 to $0.6
Player#1200: calls $0.50
Player#3740: calls $0.40
*** FLOP *** [Qs As 3d]
Player#1200: checks
Player#3740: checks
Player#4858: checks
*** TURN *** [Qs As 3d] [6s]
Player#1200: bets $0.90
Player#3740: folds
Player#4858: calls $0.90
*** RIVER *** [Qs As 3d] [6s] [9s]
Player#1200: bets $1.00
Player#4858: raises $1.00 to $6.6
Player#1200: folds
Player#4858: doesn't show hand
Uncalled bet ($6.60) returned to Player#4858
Player#4858 collected $4.37 from pot
*** SUMMARY ***
Total Pot $4.60 | Rake $0.23
Board [Qs As 3d 6s 9s]
Seat 1: Player#3740 (big blind) folded on the turn
Seat 2: warioman folded before the flop
Seat 3: Player#4858 shows [] and won ($4.37) with 
Seat 4: Player#7988 (button) mucked
Seat 5: Player#1200 (small blind) folded on the river

PokerStars Hand #f69fd7a5-66d0-4fdc-9e7a-5de71a5ac77a:  Hold'em No Limit ($0.1/$0.20 USD) - 2021/11/19 22:59:00 ET
Table 'Bel Air' 6-max Seat #1 is the button
Seat 1: Player#4215 ($40.78 in chips)
Seat 2: Player#4014 ($19.94 in chips)
Seat 3: warioman ($24.67 in chips)
Player#4014: posts small blind $0.10
warioman: posts big blind $0.20
*** HOLE CARDS ***
Dealt to warioman [9d 4h]
Player#4215: raises $0.20 to $0.4
Player#4014: folds
warioman: folds
Player#4215: doesn't show hand
Uncalled bet ($0.40) returned to Player#4215
Player#4215 collected $0.30 from pot
*** SUMMARY ***
Total Pot $0.30 | Rake $0.00
Seat 1: Player#4215 shows [] and won ($0.30) with 
Seat 2: Player#4014 (small blind) folded before the flop
Seat 3: warioman (big blind) folded before the flop

PokerStars Hand #27b8d9f1-204e-4d63-81f2-ac78d10f58ea:  Hold'em No Limit ($0.1/$0.20 USD) - 2021/11/19 22:58:00 ET
Table 'Bel Air' 6-max Seat #6 is the button
Seat 1: Player#8668 ($40.88 in chips)
Seat 2: Player#2930 ($19.84 in chips)
Seat 3: warioman ($24.67 in chips)
Player#8668: posts small blind $0.10
Player#2930: posts big blind $0.20
*** HOLE CARDS ***
Dealt to warioman [6s 5d]
warioman: folds
Player#8668: folds
Player#2930 collected $0.20 from pot
*** SUMMARY ***
Total Pot $0.20 | Rake $0.00
Seat 1: Player#8668 (small blind) folded before the flop
Seat 2: Player#2930 shows [] and won ($0.20) with 
Seat 3: warioman folded before the flop

PokerStars Hand #c86580c0-6370-4cab-bbf2-b32423859688:  Hold'em No Limit ($0.1/$0.20 USD) - 2021/11/19 22:58:00 ET
Table 'Huntsville' 6-max Seat #2 is the button
Seat 1: Player#4831 ($22.54 in chips)
Seat 2: warioman ($48.48 in chips)
Seat 3: Player#1741 ($5.18 in chips)
Seat 4: Player#2141 ($26.28 in chips)
Seat 5: Player#3944 ($16.10 in chips)
Player#1741: posts small blind $0.10
Player#3944: posts big blind $0.20
*** HOLE CARDS ***
Dealt to warioman [Kh 3h]
Player#2141 Decline Entry Bet
Player#4831: folds
warioman: raises $0.20 to $0.5
Player#1741: folds
Player#3944: calls $0.30
*** FLOP *** [9h 4d 4h]
Player#3944: checks
warioman: bets $0.33
Player#3944: calls $0.33
*** TURN *** [9h 4d 4h] [As]
Player#3944: checks
warioman: bets $1.12
Player#3944: calls $1.12
*** RIVER *** [9h 4d 4h] [As] [7s]
Player#3944: bets $2.00
warioman: folds
Player#3944: doesn't show hand
Uncalled bet ($2.00) returned to Player#3944
Player#3944 collected $3.80 from pot
*** SUMMARY ***
Total Pot $4.00 | Rake $0.20
Board [9h 4d 4h As 7s]
Seat 1: Player#4831 folded before the flop
Seat 2: warioman (button) folded on the river
Seat 3: Player#1741 (small blind) folded before the flop
Seat 4: Player#2141 mucked
Seat 5: Player#3944 shows [] and won ($3.80) with 

PokerStars Hand #bae00bc4-107d-4812-9c5c-58fa807ffa08:  Hold'em No Limit ($0.1/$0.20 USD) - 2021/11/19 22:58:00 ET
Table 'Bel Air' 6-max Seat #2 is the button
Seat 1: Player#0061 ($40.78 in chips)
Seat 2: Player#6257 ($19.84 in chips)
Seat 3: warioman ($24.77 in chips)
warioman: posts small blind $0.10
Player#0061: posts big blind $0.20
*** HOLE CARDS ***
Dealt to warioman [Kc 2h]
Player#6257: folds
warioman: folds
Player#0061 collected $0.20 from pot
*** SUMMARY ***
Total Pot $0.20 | Rake $0.00
Seat 1: Player#0061 shows [] and won ($0.20) with 
Seat 2: Player#6257 (button) folded before the flop
Seat 3: warioman (small blind) folded before the flop

PokerStars Hand #146373e3-a417-43f7-8253-dce1b4929a9e:  Hold'em No Limit ($0.1/$0.20 USD) - 2021/11/19 22:58:00 ET
Table 'Bel Air' 6-max Seat #1 is the button
Seat 1: Player#5921 ($40.32 in chips)
Seat 2: Player#7657 ($19.94 in chips)
Seat 3: warioman ($25.17 in chips)
Player#7657: posts small blind $0.10
warioman: posts big blind $0.20
*** HOLE CARDS ***
Dealt to warioman [2h Kh]
Player#5921: raises $0.20 to $0.4
Player#7657: folds
warioman: calls $0.20
*** FLOP *** [Ac 9d 7c]
warioman: checks
Player#5921: bets $0.40
warioman: folds
Player#5921: doesn't show hand
Uncalled bet ($0.40) returned to Player#5921
Player#5921 collected $0.85 from pot
*** SUMMARY ***
Total Pot $0.90 | Rake $0.05
Board [Ac 9d 7c]
Seat 1: Player#5921 shows [] and won ($0.85) with 
Seat 2: Player#7657 (small blind) folded before the flop
Seat 3: warioman (big blind) folded on the flop

PokerStars Hand #d9dd7435-6350-484c-afda-a452afa8921a:  Hold'em No Limit ($0.1/$0.20 USD) - 2021/11/19 22:57:00 ET
Table 'Bel Air' 6-max Seat #6 is the button
Seat 1: Player#3143 ($40.42 in chips)
Seat 2: Player#0066 ($20.44 in chips)
Seat 3: warioman ($24.62 in chips)
Player#3143: posts small blind $0.10
Player#0066: posts big blind $0.20
*** HOLE CARDS ***
Dealt to warioman [Td Tc]
warioman: raises $0.20 to $0.5
Player#3143: folds
Player#0066: calls $0.30
*** FLOP *** [As 6h 4h]
Player#0066: checks
warioman: bets $0.33
Player#0066: folds
warioman: doesn't show hand
Uncalled bet ($0.33) returned to warioman
warioman collected $1.05 from pot
*** SUMMARY ***
Total Pot $1.10 | Rake $0.06
Board [As 6h 4h]
Seat 1: Player#3143 (small blind) folded before the flop
Seat 2: Player#0066 (big blind) folded on the flop
Seat 3: warioman

PokerStars Hand #81cd2937-bd4e-4552-99a6-0f313c9c3019:  Hold'em No Limit ($0.1/$0.20 USD) - 2021/11/19 22:57:00 ET
Table 'Huntsville' 6-max Seat #1 is the button
Seat 1: Player#3972 ($22.54 in chips)
Seat 2: warioman ($48.58 in chips)
Seat 3: Player#6958 ($13.60 in chips)
Seat 4: Player#5455 ($26.28 in chips)
Seat 5: Player#9389 ($8.42 in chips)
warioman: posts small blind $0.10
Player#6958: posts big blind $0.20
*** HOLE CARDS ***
Dealt to warioman [2s Ah]
Player#5455: folds
Player#9389: calls $0.20
Player#3972: folds
warioman: folds
Player#6958: raises $0.20 to $0.6
Player#9389: calls $0.40
*** FLOP *** [6h Jh 4c]
Player#6958: bets $0.60
Player#9389: calls $0.60
*** TURN *** [6h Jh 4c] [5h]
Player#6958: bets $0.80
Player#9389: raises0.80 to $3
Player#6958: calls $2.20
*** RIVER *** [6h Jh 4c] [5h] [Kh]
Player#6958: bets $3.60
Player#9389: raises $3.60 to $4.22
Player#6958: calls $0.62
*** SHOW DOWN *** 
Player#6958: doesn't show hand
Player#9389 collected $16.09 from pot
*** SUMMARY ***
Total Pot $16.94 | Rake $0.85
Board [6h Jh 4c 5h Kh]
Seat 1: Player#3972 (button) folded before the flop
Seat 2: warioman (small blind) folded before the flop
Seat 3: Player#6958 (big blind) mucked
Seat 4: Player#5455 folded before the flop
Seat 5: Player#9389 shows [Kc 4d] and won ($16.09) with 

PokerStars Hand #2cae1ca8-e4b2-41c2-8dde-73931f010363:  Hold'em No Limit ($0.1/$0.20 USD) - 2021/11/19 22:57:00 ET
Table 'Bel Air' 6-max Seat #2 is the button
Seat 1: Player#2531 ($40.24 in chips)
Seat 2: Player#7142 ($20.44 in chips)
Seat 3: warioman ($24.82 in chips)
warioman: posts small blind $0.10
Player#2531: posts big blind $0.20
*** HOLE CARDS ***
Dealt to warioman [Kc 3c]
Player#7142: folds
warioman: calls $0.10
Player#2531: checks
*** FLOP *** [Ts Td 2c]
warioman: checks
Player#2531: bets $0.20
warioman: folds
Player#2531: doesn't show hand
Uncalled bet ($0.20) returned to Player#2531
Player#2531 collected $0.38 from pot
*** SUMMARY ***
Total Pot $0.40 | Rake $0.02
Board [Ts Td 2c]
Seat 1: Player#2531 shows [] and won ($0.38) with 
Seat 2: Player#7142 (button) folded before the flop
Seat 3: warioman (small blind) folded on the flop

PokerStars Hand #fd471a87-6f5d-477e-91d0-f6614d7d1c3a:  Hold'em No Limit ($0.1/$0.20 USD) - 2021/11/19 22:56:00 ET
Table 'Bel Air' 6-max Seat #1 is the button
Seat 1: Player#4358 ($38.84 in chips)
Seat 2: Player#3712 ($21.64 in chips)
Seat 3: Player#4655 ($34.14 in chips)
Seat 4: warioman ($25.02 in chips)
Player#3712: posts small blind $0.10
warioman: posts big blind $0.20
*** HOLE CARDS ***
Dealt to warioman [Jc 9s]
Player#4655 Decline Entry Bet
Player#4358: raises $0.20 to $0.4
Player#3712: raises $0.40 to $1.2
warioman: folds
Player#4358: raises1.20 to $5
Player#3712: folds
Player#4358: doesn't show hand
Uncalled bet ($5.00) returned to Player#4358
Player#4358 collected $1.40 from pot
*** SUMMARY ***
Total Pot $1.40 | Rake $0.00
Seat 1: Player#4358 shows [] and won ($1.40) with 
Seat 2: Player#3712 (small blind) folded before the flop
Seat 3: Player#4655 mucked
Seat 4: warioman (big blind) folded before the flop

PokerStars Hand #0317474d-fb4b-42fa-ae00-af673726e28b:  Hold'em No Limit ($0.1/$0.20 USD) - 2021/11/19 22:56:00 ET
Table 'Huntsville' 6-max Seat #6 is the button
Seat 1: Player#4880 ($22.74 in chips)
Seat 2: warioman ($49.18 in chips)
Seat 3: Player#6733 ($13.80 in chips)
Seat 4: Player#5748 ($26.28 in chips)
Seat 5: Player#5744 ($7.50 in chips)
Player#4880: posts small blind $0.10
warioman: posts big blind $0.20
*** HOLE CARDS ***
Dealt to warioman [Jh 7s]
Player#6733: calls $0.20
Player#5748: folds
Player#5744: calls $0.20
Player#4880: calls $0.10
warioman: checks
*** FLOP *** [7c 3h 2s]
Player#4880: checks
warioman: bets $0.40
Player#6733: folds
Player#5744: calls $0.40
Player#4880: folds
*** TURN *** [7c 3h 2s] [Ah]
warioman: checks
Player#5744: bets $1.00
warioman: folds
Player#5744: doesn't show hand
Uncalled bet ($1.00) returned to Player#5744
Player#5744 collected $1.52 from pot
*** SUMMARY ***
Total Pot $1.60 | Rake $0.08
Board [7c 3h 2s Ah]
Seat 1: Player#4880 (small blind) folded on the flop
Seat 2: warioman (big blind) folded on the turn
Seat 3: Player#6733 folded on the flop
Seat 4: Player#5748 folded before the flop
Seat 5: Player#5744 shows [] and won ($1.52) with 

PokerStars Hand #9d5544f8-e312-4999-8da2-a82521e1fdf0:  Hold'em No Limit ($0.1/$0.20 USD) - 2021/11/19 22:56:00 ET
Table 'Bel Air' 6-max Seat #6 is the button
Seat 1: Player#8824 ($39.64 in chips)
Seat 2: Player#4700 ($20.92 in chips)
Seat 3: Player#2344 ($34.14 in chips)
Seat 4: warioman ($25.02 in chips)
Player#8824: posts small blind $0.10
Player#4700: posts big blind $0.20
*** HOLE CARDS ***
Dealt to warioman [5d 8s]
Player#2344: folds
warioman: folds
Player#8824: calls $0.10
Player#4700: raises $0.20 to $0.8
Player#8824: calls $0.60
*** FLOP *** [Qs As Tc]
Player#8824: checks
Player#4700: bets $0.80
Player#8824: folds
Player#4700: doesn't show hand
Uncalled bet ($0.80) returned to Player#4700
Player#4700 collected $1.52 from pot
*** SUMMARY ***
Total Pot $1.60 | Rake $0.08
Board [Qs As Tc]
Seat 1: Player#8824 (small blind) folded on the flop
Seat 2: Player#4700 shows [] and won ($1.52) with 
Seat 3: Player#2344 folded before the flop
Seat 4: warioman folded before the flop

PokerStars Hand #c793fcb1-c5c5-4c8b-bf10-1271253888eb:  Hold'em No Limit ($0.1/$0.20 USD) - 2021/11/19 22:55:00 ET
Table 'Bel Air' 6-max Seat #3 is the button
Seat 1: Player#1942 ($39.84 in chips)
Seat 2: Player#9361 ($20.92 in chips)
Seat 3: Player#1563 ($33.84 in chips)
Seat 4: warioman ($25.12 in chips)
warioman: posts small blind $0.10
Player#1942: posts big blind $0.20
*** HOLE CARDS ***
Dealt to warioman [7c 4h]
Player#9361: folds
Player#1563: raises $0.20 to $0.6
warioman: folds
Player#1942: folds
Player#1563: doesn't show hand
Uncalled bet ($0.60) returned to Player#1563
Player#1563 collected $0.30 from pot
*** SUMMARY ***
Total Pot $0.30 | Rake $0.00
Seat 1: Player#1942 (big blind) folded before the flop
Seat 2: Player#9361 folded before the flop
Seat 3: Player#1563 shows [] and won ($0.30) with 
Seat 4: warioman (small blind) folded before the flop

PokerStars Hand #11a63a40-82ae-43cb-9eda-51a1631f1ad0:  Hold'em No Limit ($0.1/$0.20 USD) - 2021/11/19 22:55:00 ET
Table 'Bel Air' 6-max Seat #2 is the button
Seat 1: Player#5638 ($39.84 in chips)
Seat 2: Player#0875 ($20.92 in chips)
Seat 3: Player#1771 ($33.64 in chips)
Seat 4: warioman ($25.32 in chips)
Player#1771: posts small blind $0.10
warioman: posts big blind $0.20
*** HOLE CARDS ***
Dealt to warioman [7c 4d]
Player#5638: folds
Player#0875: folds
Player#1771: raises $0.20 to $0.6
warioman: folds
Player#1771: doesn't show hand
Uncalled bet ($0.60) returned to Player#1771
Player#1771 collected $0.20 from pot
*** SUMMARY ***
Total Pot $0.20 | Rake $0.00
Seat 1: Player#5638 folded before the flop
Seat 2: Player#0875 (button) folded before the flop
Seat 3: Player#1771 shows [] and won ($0.20) with 
Seat 4: warioman (big blind) folded before the flop

PokerStars Hand #bae97ef0-69b2-4042-b325-103b01568177:  Hold'em No Limit ($0.1/$0.20 USD) - 2021/11/19 22:55:00 ET
Table 'Huntsville' 6-max Seat #5 is the button
Seat 1: Player#1597 ($20.14 in chips)
Seat 2: warioman ($49.18 in chips)
Seat 3: Player#0820 ($16.20 in chips)
Seat 4: Player#3957 ($45.53 in chips)
Seat 5: Player#1858 ($26.28 in chips)
Seat 6: Player#6541 ($7.70 in chips)
Player#6541: posts small blind $0.10
Player#1597: posts big blind $0.20
*** HOLE CARDS ***
Dealt to warioman [3h 7h]
warioman: folds
Player#0820: calls $0.20
Player#3957: folds
Player#1858: folds
Player#6541: calls $0.10
Player#1597: raises $0.20 to $0.8
Player#0820: raises $0.80 to $2.4
Player#6541: folds
Player#1597: raises $2.40 to $7.4
Player#0820: folds
Player#1597: doesn't show hand
Uncalled bet ($7.40) returned to Player#1597
Player#1597 collected $2.60 from pot
*** SUMMARY ***
Total Pot $2.60 | Rake $0.00
Seat 1: Player#1597 shows [] and won ($2.60) with 
Seat 2: warioman folded before the flop
Seat 3: Player#0820 folded before the flop
Seat 4: Player#3957 folded before the flop
Seat 5: Player#1858 (button) folded before the flop
Seat 6: Player#6541 (small blind) folded before the flop

PokerStars Hand #8f2edf09-746b-4013-8e81-16dda9843bf8:  Hold'em No Limit ($0.1/$0.20 USD) - 2021/11/19 22:54:00 ET
Table 'Bel Air' 6-max Seat #1 is the button
Seat 1: Player#7753 ($40.04 in chips)
Seat 2: Player#3847 ($21.72 in chips)
Seat 3: Player#8515 ($32.73 in chips)
Seat 4: warioman ($25.32 in chips)
Player#3847: posts small blind $0.10
Player#8515: posts big blind $0.20
*** HOLE CARDS ***
Dealt to warioman [4c 9c]
warioman: folds
Player#7753: calls $0.20
Player#3847: calls $0.10
Player#8515: checks
*** FLOP *** [4d 7c 3d]
Player#3847: bets $0.60
Player#8515: calls $0.60
Player#7753: folds
*** TURN *** [4d 7c 3d] [Ad]
Player#3847: checks
Player#8515: bets $1.00
Player#3847: folds
Player#7753: doesn't show hand
Player#3847: doesn't show hand
Player#8515: doesn't show hand
warioman: doesn't show hand
Uncalled bet ($1.00) returned to Player#8515
Player#8515 collected $1.71 from pot
*** SUMMARY ***
Total Pot $1.80 | Rake $0.09
Board [4d 7c 3d Ad]
Seat 1: Player#7753 (button) folded on the flop
Seat 2: Player#3847 (small blind) folded on the turn
Seat 3: Player#8515 shows [] and won ($1.71) with 
Seat 4: warioman folded before the flop

PokerStars Hand #a83377f7-e862-4643-9897-bb5ec69a3671:  Hold'em No Limit ($0.1/$0.20 USD) - 2021/11/19 22:54:00 ET
Table 'Huntsville' 6-max Seat #4 is the button
Seat 1: Player#9073 ($20.14 in chips)
Seat 2: warioman ($49.18 in chips)
Seat 3: Player#8409 ($19.70 in chips)
Seat 4: Player#8967 ($45.53 in chips)
Seat 5: Player#2587 ($19.80 in chips)
Seat 6: Player#3323 ($11.20 in chips)
Player#2587: posts small blind $0.10
Player#3323: posts big blind $0.20
*** HOLE CARDS ***
Dealt to warioman [2c 5s]
Player#9073: folds
warioman: folds
Player#8409: raises $0.20 to $0.6
Player#8967: folds
Player#2587: calls $0.50
Player#3323: calls $0.40
*** FLOP *** [Qs 7c 3s]
Player#2587: checks
Player#3323: checks
Player#8409: bets $0.80
Player#2587: calls $0.80
Player#3323: calls $0.80
*** TURN *** [Qs 7c 3s] [Ac]
Player#2587: checks
Player#3323: bets $2.10
Player#8409: calls $2.10
Player#2587: raises $2.10 to $9.45
Player#3323: folds
Player#8409: folds
Player#2587: doesn't show hand
Uncalled bet ($9.45) returned to Player#2587
Player#2587 collected $7.98 from pot
*** SUMMARY ***
Total Pot $8.40 | Rake $0.42
Board [Qs 7c 3s Ac]
Seat 1: Player#9073 folded before the flop
Seat 2: warioman folded before the flop
Seat 3: Player#8409 folded on the turn
Seat 4: Player#8967 (button) folded before the flop
Seat 5: Player#2587 shows [] and won ($7.98) with 
Seat 6: Player#3323 (big blind) folded on the turn

PokerStars Hand #79fae57e-686f-4676-bb1f-ccefd9c1615f:  Hold'em No Limit ($0.1/$0.20 USD) - 2021/11/19 22:53:00 ET
Table 'Bel Air' 6-max Seat #6 is the button
Seat 1: Player#8338 ($40.14 in chips)
Seat 2: Player#1907 ($22.22 in chips)
Seat 3: Player#1985 ($32.73 in chips)
Seat 4: warioman ($24.77 in chips)
Player#8338: posts small blind $0.10
Player#1907: posts big blind $0.20
*** HOLE CARDS ***
Dealt to warioman [4s 6s]
Player#1985: folds
warioman: raises $0.20 to $0.5
Player#8338: folds
Player#1907: calls $0.30
*** FLOP *** [4h 5s Js]
Player#1907: checks
warioman: checks
*** TURN *** [4h 5s Js] [8d]
Player#1907: checks
warioman: checks
*** RIVER *** [4h 5s Js] [8d] [3d]
Player#1907: checks
warioman: bets $0.83
Player#1907: folds
warioman: doesn't show hand
Uncalled bet ($0.83) returned to warioman
warioman collected $1.05 from pot
*** SUMMARY ***
Total Pot $1.10 | Rake $0.06
Board [4h 5s Js 8d 3d]
Seat 1: Player#8338 (small blind) folded before the flop
Seat 2: Player#1907 (big blind) folded on the river
Seat 3: Player#1985 folded before the flop
Seat 4: warioman

PokerStars Hand #cde89136-46de-4f1a-bf50-c51792a83664:  Hold'em No Limit ($0.1/$0.20 USD) - 2021/11/19 22:53:00 ET
Table 'Bel Air' 6-max Seat #3 is the button
Seat 1: Player#8221 ($40.34 in chips)
Seat 2: Player#9309 ($22.22 in chips)
Seat 3: Player#7986 ($32.43 in chips)
Seat 4: warioman ($24.87 in chips)
warioman: posts small blind $0.10
Player#8221: posts big blind $0.20
*** HOLE CARDS ***
Dealt to warioman [7c Jd]
Player#9309: folds
Player#7986: raises $0.20 to $0.6
warioman: folds
Player#8221: folds
Player#8221: doesn't show hand
Player#9309: doesn't show hand
Player#7986: doesn't show hand
warioman: doesn't show hand
Uncalled bet ($0.60) returned to Player#7986
Player#7986 collected $0.30 from pot
*** SUMMARY ***
Total Pot $0.30 | Rake $0.00
Seat 1: Player#8221 (big blind) folded before the flop
Seat 2: Player#9309 folded before the flop
Seat 3: Player#7986 shows [] and won ($0.30) with 
Seat 4: warioman (small blind) folded before the flop

PokerStars Hand #48eda2dc-792a-4153-8537-91477be12211:  Hold'em No Limit ($0.1/$0.20 USD) - 2021/11/19 22:53:00 ET
Table 'Huntsville' 6-max Seat #3 is the button
Seat 1: Player#6171 ($20.94 in chips)
Seat 2: warioman ($47.88 in chips)
Seat 3: Player#3622 ($19.70 in chips)
Seat 4: Player#4323 ($45.63 in chips)
Seat 5: Player#7617 ($20.00 in chips)
Seat 6: Player#9475 ($11.40 in chips)
Player#4323: posts small blind $0.10
Player#7617: posts big blind $0.20
*** HOLE CARDS ***
Dealt to warioman [Jh Kh]
Player#9475: calls $0.20
Player#6171: raises $0.20 to $0.8
warioman: raises $0.80 to $2.9
Player#3622: folds
Player#4323: folds
Player#7617: folds
Player#9475: folds
Player#6171: folds
warioman: doesn't show hand
Uncalled bet ($2.90) returned to warioman
warioman collected $1.30 from pot
*** SUMMARY ***
Total Pot $1.30 | Rake $0.00
Seat 1: Player#6171 folded before the flop
Seat 2: warioman
Seat 3: Player#3622 (button) folded before the flop
Seat 4: Player#4323 (small blind) folded before the flop
Seat 5: Player#7617 (big blind) folded before the flop
Seat 6: Player#9475 folded before the flop

PokerStars Hand #f1c3c6e5-7c35-4b0d-a296-b9514ac2c169:  Hold'em No Limit ($0.1/$0.20 USD) - 2021/11/19 22:53:00 ET
Table 'Bel Air' 6-max Seat #2 is the button
Seat 1: Player#8148 ($40.34 in chips)
Seat 2: Player#8451 ($22.82 in chips)
Seat 3: Player#8268 ($32.53 in chips)
Seat 4: warioman ($24.17 in chips)
Player#8268: posts small blind $0.10
warioman: posts big blind $0.20
*** HOLE CARDS ***
Dealt to warioman [9s 9c]
Player#8148: folds
Player#8451: raises $0.20 to $0.6
Player#8268: folds
warioman: raises $0.60 to $2.3
Player#8451: folds
warioman: doesn't show hand
Uncalled bet ($2.30) returned to warioman
warioman collected $0.70 from pot
*** SUMMARY ***
Total Pot $0.70 | Rake $0.00
Seat 1: Player#8148 folded before the flop
Seat 2: Player#8451 (button) folded before the flop
Seat 3: Player#8268 (small blind) folded before the flop
Seat 4: warioman (big blind)

PokerStars Hand #93695271-6d1b-44f5-817b-9a7b04563d1a:  Hold'em No Limit ($0.1/$0.20 USD) - 2021/11/19 22:52:00 ET
Table 'Huntsville' 6-max Seat #2 is the button
Seat 1: Player#4638 ($20.94 in chips)
Seat 2: warioman ($47.88 in chips)
Seat 3: Player#7389 ($19.80 in chips)
Seat 4: Player#6725 ($45.83 in chips)
Seat 5: Player#9310 ($20.00 in chips)
Seat 6: Player#8986 ($11.12 in chips)
Player#7389: posts small blind $0.10
Player#6725: posts big blind $0.20
*** HOLE CARDS ***
Dealt to warioman [9s 7d]
Player#9310: folds
Player#8986: calls $0.20
Player#4638: folds
warioman: folds
Player#7389: folds
Player#6725: checks
*** FLOP *** [3d 5h 8s]
Player#6725: checks
Player#8986: bets $0.60
Player#6725: folds
Player#8986: doesn't show hand
Uncalled bet ($0.60) returned to Player#8986
Player#8986 collected $0.48 from pot
*** SUMMARY ***
Total Pot $0.50 | Rake $0.03
Board [3d 5h 8s]
Seat 1: Player#4638 folded before the flop
Seat 2: warioman (button) folded before the flop
Seat 3: Player#7389 (small blind) folded before the flop
Seat 4: Player#6725 (big blind) folded on the flop
Seat 5: Player#9310 folded before the flop
Seat 6: Player#8986 shows [] and won ($0.48) with 

PokerStars Hand #24980e45-2c3a-4b46-afd2-9507ea62b443:  Hold'em No Limit ($0.1/$0.20 USD) - 2021/11/19 22:52:00 ET
Table 'Bel Air' 6-max Seat #1 is the button
Seat 1: Player#8769 ($40.34 in chips)
Seat 2: Player#7222 ($22.18 in chips)
Seat 3: Player#2240 ($32.73 in chips)
Seat 4: warioman ($24.67 in chips)
Player#7222: posts small blind $0.10
Player#2240: posts big blind $0.20
*** HOLE CARDS ***
Dealt to warioman [Ac Qh]
warioman: raises $0.20 to $0.5
Player#8769: folds
Player#7222: calls $0.40
Player#2240: folds
*** FLOP *** [4c 5s 9c]
Player#7222: checks
warioman: checks
*** TURN *** [4c 5s 9c] [9s]
Player#7222: bets $0.80
warioman: folds
Player#7222: doesn't show hand
Uncalled bet ($0.80) returned to Player#7222
Player#7222 collected $1.14 from pot
*** SUMMARY ***
Total Pot $1.20 | Rake $0.06
Board [4c 5s 9c 9s]
Seat 1: Player#8769 (button) folded before the flop
Seat 2: Player#7222 shows [] and won ($1.14) with 
Seat 3: Player#2240 (big blind) folded before the flop
Seat 4: warioman folded on the turn

PokerStars Hand #95b62451-52a0-43ea-a503-6d5673a15b1b:  Hold'em No Limit ($0.1/$0.20 USD) - 2021/11/19 22:52:00 ET
Table 'Bel Air' 6-max Seat #6 is the button
Seat 1: Player#7451 ($40.44 in chips)
Seat 2: Player#1016 ($22.08 in chips)
Seat 3: Player#4302 ($32.73 in chips)
Seat 4: warioman ($24.67 in chips)
Player#7451: posts small blind $0.10
Player#1016: posts big blind $0.20
*** HOLE CARDS ***
Dealt to warioman [Jh 6d]
Player#4302: folds
warioman: folds
Player#7451: folds
Player#1016 collected $0.20 from pot
*** SUMMARY ***
Total Pot $0.20 | Rake $0.00
Seat 1: Player#7451 (small blind) folded before the flop
Seat 2: Player#1016 shows [] and won ($0.20) with 
Seat 3: Player#4302 folded before the flop
Seat 4: warioman folded before the flop

PokerStars Hand #799d6f31-d725-47b7-b7ca-f93d6784b6b5:  Hold'em No Limit ($0.1/$0.20 USD) - 2021/11/19 22:52:00 ET
Table 'Huntsville' 6-max Seat #1 is the button
Seat 1: Player#0937 ($20.47 in chips)
Seat 2: warioman ($47.98 in chips)
Seat 3: Player#9039 ($20.00 in chips)
Seat 4: Player#0298 ($45.83 in chips)
Seat 5: Player#2922 ($20.00 in chips)
Seat 6: Player#4883 ($11.32 in chips)
warioman: posts small blind $0.10
Player#9039: posts big blind $0.20
*** HOLE CARDS ***
Dealt to warioman [6s 4d]
Player#0298: folds
Player#2922: folds
Player#4883: calls $0.20
Player#0937: calls $0.20
warioman: folds
Player#9039: checks
*** FLOP *** [As 5d Qc]
Player#9039: checks
Player#4883: checks
Player#0937: bets $0.60
Player#9039: folds
Player#4883: folds
Player#0937: doesn't show hand
Uncalled bet ($0.60) returned to Player#0937
Player#0937 collected $0.66 from pot
*** SUMMARY ***
Total Pot $0.70 | Rake $0.03
Board [As 5d Qc]
Seat 1: Player#0937 shows [] and won ($0.66) with 
Seat 2: warioman (small blind) folded before the flop
Seat 3: Player#9039 (big blind) folded on the flop
Seat 4: Player#0298 folded before the flop
Seat 5: Player#2922 folded before the flop
Seat 6: Player#4883 folded on the flop

PokerStars Hand #d9cd6d6c-7095-4ddf-b899-690d46f78c57:  Hold'em No Limit ($0.1/$0.20 USD) - 2021/11/19 22:51:00 ET
Table 'Bel Air' 6-max Seat #3 is the button
Seat 1: Player#2879 ($41.89 in chips)
Seat 2: Player#6461 ($22.08 in chips)
Seat 3: Player#1115 ($31.33 in chips)
Seat 4: warioman ($24.77 in chips)
warioman: posts small blind $0.10
Player#2879: posts big blind $0.20
*** HOLE CARDS ***
Dealt to warioman [Kh 8d]
Player#6461: folds
Player#1115: raises $0.20 to $0.6
warioman: folds
Player#2879: calls $0.40
*** FLOP *** [Ts 9c 6c]
Player#2879: checks
Player#1115: bets $0.85
Player#2879: calls $0.85
*** TURN *** [Ts 9c 6c] [Ad]
Player#2879: checks
Player#1115: bets $2.45
Player#2879: folds
Player#1115: doesn't show hand
Uncalled bet ($2.45) returned to Player#1115
Player#1115 collected $2.85 from pot
*** SUMMARY ***
Total Pot $3.00 | Rake $0.15
Board [Ts 9c 6c Ad]
Seat 1: Player#2879 (big blind) folded on the turn
Seat 2: Player#6461 folded before the flop
Seat 3: Player#1115 shows [] and won ($2.85) with 
Seat 4: warioman (small blind) folded before the flop

PokerStars Hand #62bf7bfd-b77f-4734-ab43-ad1e66e04c5c:  Hold'em No Limit ($0.1/$0.20 USD) - 2021/11/19 22:51:00 ET
Table 'Bel Air' 6-max Seat #2 is the button
Seat 1: Player#5022 ($42.09 in chips)
Seat 2: Player#5540 ($22.08 in chips)
Seat 3: Player#3561 ($30.96 in chips)
Seat 4: warioman ($24.97 in chips)
Player#3561: posts small blind $0.10
warioman: posts big blind $0.20
*** HOLE CARDS ***
Dealt to warioman [Ac Jd]
Player#5022: calls $0.20
Player#5540: folds
Player#3561: calls $0.10
warioman: checks
*** FLOP *** [Qh 7s 2h]
Player#3561: bets $0.60
warioman: folds
Player#5022: folds
Player#3561: doesn't show hand
Uncalled bet ($0.60) returned to Player#3561
Player#3561 collected $0.57 from pot
*** SUMMARY ***
Total Pot $0.60 | Rake $0.03
Board [Qh 7s 2h]
Seat 1: Player#5022 folded on the flop
Seat 2: Player#5540 (button) folded before the flop
Seat 3: Player#3561 shows [] and won ($0.57) with 
Seat 4: warioman (big blind) folded on the flop

PokerStars Hand #04a05fde-3d58-4277-8bdb-8d513477b442:  Hold'em No Limit ($0.1/$0.20 USD) - 2021/11/19 22:51:00 ET
Table 'Huntsville' 6-max Seat #2 is the button
Seat 1: Player#5979 ($20.67 in chips)
Seat 2: warioman ($48.18 in chips)
Seat 3: Player#3998 ($20.00 in chips)
Seat 4: Player#8164 ($45.83 in chips)
Seat 5: Player#5784 ($20.00 in chips)
Seat 6: Player#6087 ($10.95 in chips)
Player#3998: posts small blind $0.10
Player#5979: posts big blind $0.20
*** HOLE CARDS ***
Dealt to warioman [2c Jd]
Player#3998 Waiting
Player#8164: folds
Player#5784: folds
Player#6087: calls $0.20
Player#5979: calls $0.10
warioman: checks
*** FLOP *** [Qs Ad 4s]
Player#5979: checks
warioman: checks
Player#6087: checks
*** TURN *** [Qs Ad 4s] [7d]
Player#5979: checks
warioman: checks
Player#6087: bets $0.60
Player#5979: folds
warioman: folds
Player#6087: doesn't show hand
Uncalled bet ($0.60) returned to Player#6087
Player#6087 collected $0.57 from pot
*** SUMMARY ***
Total Pot $0.60 | Rake $0.03
Board [Qs Ad 4s 7d]
Seat 1: Player#5979 (big blind) folded on the turn
Seat 2: warioman (button) folded on the turn
Seat 3: Player#3998 (small blind) mucked
Seat 4: Player#8164 folded before the flop
Seat 5: Player#5784 folded before the flop
Seat 6: Player#6087 shows [] and won ($0.57) with 

PokerStars Hand #5f4dd9f8-10b2-4f43-b512-a7fafe8b2ebf:  Hold'em No Limit ($0.1/$0.20 USD) - 2021/11/19 22:50:00 ET
Table 'Bel Air' 6-max Seat #1 is the button
Seat 1: Player#1360 ($42.09 in chips)
Seat 2: Player#8216 ($22.18 in chips)
Seat 3: Player#4457 ($31.46 in chips)
Seat 4: Player#0573 ($41.95 in chips)
Seat 5: warioman ($24.42 in chips)
Player#8216: posts small blind $0.10
Player#4457: posts big blind $0.20
*** HOLE CARDS ***
Dealt to warioman [Js Ac]
Player#0573: folds
warioman: raises $0.20 to $0.5
Player#1360: folds
Player#8216: folds
Player#4457: calls $0.30
*** FLOP *** [9c 7c Tc]
Player#4457: checks
warioman: bets $0.33
Player#4457: folds
warioman: doesn't show hand
Uncalled bet ($0.33) returned to warioman
warioman collected $1.05 from pot
*** SUMMARY ***
Total Pot $1.10 | Rake $0.06
Board [9c 7c Tc]
Seat 1: Player#1360 (button) folded before the flop
Seat 2: Player#8216 (small blind) folded before the flop
Seat 3: Player#4457 (big blind) folded on the flop
Seat 4: Player#0573 folded before the flop
Seat 5: warioman

PokerStars Hand #eb2fbcbf-ac12-4994-aade-4d06ba63faff:  Hold'em No Limit ($0.1/$0.20 USD) - 2021/11/19 22:50:00 ET
Table 'Bel Air' 6-max Seat #6 is the button
Seat 1: Player#1514 ($42.19 in chips)
Seat 2: Player#1227 ($22.38 in chips)
Seat 3: Player#7731 ($31.46 in chips)
Seat 4: Player#2979 ($41.95 in chips)
Seat 5: warioman ($24.12 in chips)
Player#1514: posts small blind $0.10
Player#1227: posts big blind $0.20
*** HOLE CARDS ***
Dealt to warioman [Ad 9s]
Player#7731: folds
Player#2979: folds
warioman: raises $0.20 to $0.5
Player#1514: folds
Player#1227: folds
warioman: doesn't show hand
Uncalled bet ($0.50) returned to warioman
warioman collected $0.30 from pot
*** SUMMARY ***
Total Pot $0.30 | Rake $0.00
Seat 1: Player#1514 (small blind) folded before the flop
Seat 2: Player#1227 (big blind) folded before the flop
Seat 3: Player#7731 folded before the flop
Seat 4: Player#2979 folded before the flop
Seat 5: warioman

PokerStars Hand #16ff466d-006f-4ef9-8685-39b44fa08aa7:  Hold'em No Limit ($0.1/$0.20 USD) - 2021/11/19 22:50:00 ET
Table 'Bel Air' 6-max Seat #4 is the button
Seat 1: Player#8991 ($42.39 in chips)
Seat 2: Player#2801 ($22.38 in chips)
Seat 3: Player#1431 ($31.46 in chips)
Seat 4: Player#7697 ($41.65 in chips)
Seat 5: warioman ($24.22 in chips)
warioman: posts small blind $0.10
Player#8991: posts big blind $0.20
*** HOLE CARDS ***
Dealt to warioman [Td 2h]
Player#2801: folds
Player#1431: folds
Player#7697: raises $0.20 to $0.5
warioman: folds
Player#8991: folds
Player#8991: doesn't show hand
Player#2801: doesn't show hand
Player#1431: doesn't show hand
Player#7697: doesn't show hand
warioman: doesn't show hand
Uncalled bet ($0.50) returned to Player#7697
Player#7697 collected $0.30 from pot
*** SUMMARY ***
Total Pot $0.30 | Rake $0.00
Seat 1: Player#8991 (big blind) folded before the flop
Seat 2: Player#2801 folded before the flop
Seat 3: Player#1431 folded before the flop
Seat 4: Player#7697 shows [] and won ($0.30) with 
Seat 5: warioman (small blind) folded before the flop

PokerStars Hand #5f2a2aee-e074-4113-a279-23322d493f30:  Hold'em No Limit ($0.1/$0.20 USD) - 2021/11/19 22:50:00 ET
Table 'Huntsville' 6-max Seat #4 is the button
Seat 1: Player#1490 ($21.17 in chips)
Seat 2: warioman ($48.68 in chips)
Seat 3: Player#4561 ($40.83 in chips)
Seat 4: Player#4558 ($20.00 in chips)
Seat 5: Player#8061 ($15.45 in chips)
Player#8061: posts small blind $0.10
Player#1490: posts big blind $0.20
*** HOLE CARDS ***
Dealt to warioman [3d Ad]
warioman: raises $0.20 to $0.5
Player#4561: calls $0.50
Player#4558: folds
Player#8061: calls $0.40
Player#1490: calls $0.30
*** FLOP *** [Qd 3h 5c]
Player#8061: checks
Player#1490: checks
warioman: checks
Player#4561: bets $1.50
Player#8061: calls $1.50
Player#1490: folds
warioman: folds
*** TURN *** [Qd 3h 5c] [9c]
Player#8061: bets $2.50
Player#4561: raises $2.50 to $6.25
Player#8061: folds
Player#4561: doesn't show hand
Uncalled bet ($6.25) returned to Player#4561
Player#4561 collected $7.12 from pot
*** SUMMARY ***
Total Pot $7.50 | Rake $0.38
Board [Qd 3h 5c 9c]
Seat 1: Player#1490 (big blind) folded on the flop
Seat 2: warioman folded on the flop
Seat 3: Player#4561 shows [] and won ($7.12) with 
Seat 4: Player#4558 (button) folded before the flop
Seat 5: Player#8061 (small blind) folded on the turn

PokerStars Hand #30e618fb-dfc0-42cc-87e6-d9098beca312:  Hold'em No Limit ($0.1/$0.20 USD) - 2021/11/19 22:49:00 ET
Table 'Bel Air' 6-max Seat #3 is the button
Seat 1: Player#4290 ($42.39 in chips)
Seat 2: Player#2721 ($22.38 in chips)
Seat 3: Player#4273 ($33.04 in chips)
Seat 4: Player#0593 ($41.75 in chips)
Seat 5: warioman ($22.70 in chips)
Player#0593: posts small blind $0.10
warioman: posts big blind $0.20
*** HOLE CARDS ***
Dealt to warioman [9s 8s]
Player#4290: folds
Player#2721: folds
Player#4273: raises $0.20 to $0.6
Player#0593: folds
warioman: calls $0.40
*** FLOP *** [4s 6s 5h]
warioman: checks
Player#4273: checks
*** TURN *** [4s 6s 5h] [5s]
warioman: bets $0.98
Player#4273: calls $0.98
*** RIVER *** [4s 6s 5h] [5s] [Ks]
warioman: bets $2.86
Player#4273: folds
warioman: doesn't show hand
Uncalled bet ($2.86) returned to warioman
warioman collected $3.10 from pot
*** SUMMARY ***
Total Pot $3.26 | Rake $0.16
Board [4s 6s 5h 5s Ks]
Seat 1: Player#4290 folded before the flop
Seat 2: Player#2721 folded before the flop
Seat 3: Player#4273 (button) folded on the river
Seat 4: Player#0593 (small blind) folded before the flop
Seat 5: warioman (big blind)

PokerStars Hand #5ae11b47-251c-4c0a-acdb-efbb58b79425:  Hold'em No Limit ($0.1/$0.20 USD) - 2021/11/19 22:49:00 ET
Table 'Bel Air' 6-max Seat #2 is the button
Seat 1: Player#2084 ($42.39 in chips)
Seat 2: Player#1500 ($22.38 in chips)
Seat 3: Player#5160 ($33.14 in chips)
Seat 4: Player#7147 ($41.95 in chips)
Seat 5: Player#6127 ($23.43 in chips)
Seat 6: warioman ($22.40 in chips)
Player#5160: posts small blind $0.10
Player#7147: posts big blind $0.20
*** HOLE CARDS ***
Dealt to warioman [Jd Qc]
Player#6127: folds
warioman: raises $0.20 to $0.5
Player#2084: folds
Player#1500: folds
Player#5160: folds
Player#7147: folds
warioman: doesn't show hand
Uncalled bet ($0.50) returned to warioman
warioman collected $0.30 from pot
*** SUMMARY ***
Total Pot $0.30 | Rake $0.00
Seat 1: Player#2084 folded before the flop
Seat 2: Player#1500 (button) folded before the flop
Seat 3: Player#5160 (small blind) folded before the flop
Seat 4: Player#7147 (big blind) folded before the flop
Seat 5: Player#6127 folded before the flop
Seat 6: warioman

PokerStars Hand #b270339e-655a-4903-abc2-8178d86b155e:  Hold'em No Limit ($0.1/$0.20 USD) - 2021/11/19 22:48:00 ET
Table 'Bel Air' 6-max Seat #1 is the button
Seat 1: Player#7475 ($45.49 in chips)
Seat 2: Player#1706 ($19.40 in chips)
Seat 3: Player#4961 ($33.34 in chips)
Seat 4: Player#4832 ($41.95 in chips)
Seat 5: Player#9485 ($23.43 in chips)
Seat 6: warioman ($22.40 in chips)
Player#1706: posts small blind $0.10
Player#4961: posts big blind $0.20
*** HOLE CARDS ***
Dealt to warioman [4c Ah]
Player#4832: folds
Player#9485: folds
warioman: folds
Player#7475: raises $0.20 to $0.4
Player#1706: raises $0.40 to $1.6
Player#4961: folds
Player#7475: calls $1.20
*** FLOP *** [3c Td Qc]
Player#1706: checks
Player#7475: checks
*** TURN *** [3c Td Qc] [2d]
Player#1706: bets $1.50
Player#7475: calls $1.50
*** RIVER *** [3c Td Qc] [2d] [6d]
Player#1706: bets $2.20
Player#7475: folds
Player#1706: doesn't show hand
Uncalled bet ($2.20) returned to Player#1706
Player#1706 collected $6.08 from pot
*** SUMMARY ***
Total Pot $6.40 | Rake $0.32
Board [3c Td Qc 2d 6d]
Seat 1: Player#7475 (button) folded on the river
Seat 2: Player#1706 shows [] and won ($6.08) with 
Seat 3: Player#4961 (big blind) folded before the flop
Seat 4: Player#4832 folded before the flop
Seat 5: Player#9485 folded before the flop
Seat 6: warioman folded before the flop

PokerStars Hand #c90482a0-e2f7-45ec-aa00-473200ef2d55:  Hold'em No Limit ($0.1/$0.20 USD) - 2021/11/19 22:48:00 ET
Table 'Huntsville' 6-max Seat #3 is the button
Seat 1: Player#9811 ($21.17 in chips)
Seat 2: warioman ($22.14 in chips)
Seat 3: Player#5774 ($62.97 in chips)
Seat 4: Player#1741 ($18.00 in chips)
Seat 5: Player#7900 ($21.75 in chips)
Player#1741: posts small blind $0.10
Player#7900: posts big blind $0.20
*** HOLE CARDS ***
Dealt to warioman [7h Th]
Player#9811: folds
warioman: raises $0.20 to $0.5
Player#5774: calls $0.50
Player#1741: folds
Player#7900: calls $0.30
*** FLOP *** [Td 7d 8d]
Player#7900: bets $0.80
warioman: calls $0.80
Player#5774: calls $0.80
*** TURN *** [Td 7d 8d] [Ks]
Player#7900: bets $2.00
warioman: calls $2.00
Player#5774: calls $2.00
*** RIVER *** [Td 7d 8d] [Ks] [7s]
Player#7900: bets $3.00
warioman: raises $3.00 to $9.4
Player#5774: raises $ 59.40 to $59.67
Player#7900: folds
warioman: calls $9.44
*** SHOW DOWN *** 
warioman collected $90.01 from pot
*** SUMMARY ***
Total Pot $91.51 | Rake $1.50
Board [Td 7d 8d Ks 7s]
Seat 1: Player#9811 folded before the flop
Seat 2: warioman
Seat 3: Player#5774 (button) mucked
Seat 4: Player#1741 (small blind) folded before the flop
Seat 5: Player#7900 (big blind) folded on the river

PokerStars Hand #e2e2caf1-864b-40dc-96da-d46171b5e267:  Hold'em No Limit ($0.1/$0.20 USD) - 2021/11/19 22:48:00 ET
Table 'Bel Air' 6-max Seat #6 is the button
Seat 1: Player#6979 ($45.59 in chips)
Seat 2: Player#3342 ($20.00 in chips)
Seat 3: Player#5495 ($33.34 in chips)
Seat 4: Player#9886 ($41.95 in chips)
Seat 5: Player#6931 ($22.79 in chips)
Seat 6: warioman ($22.40 in chips)
Player#6979: posts small blind $0.10
Player#3342: posts big blind $0.20
*** HOLE CARDS ***
Dealt to warioman [8h Qc]
Player#5495: folds
Player#9886: folds
Player#6931: raises $0.20 to $0.6
warioman: folds
Player#6979: folds
Player#3342: calls $0.40
*** FLOP *** [Qh 7h Qs]
Player#3342: checks
Player#6931: bets $1.00
Player#3342: folds
Player#6931: doesn't show hand
Uncalled bet ($1.00) returned to Player#6931
Player#6931 collected $1.23 from pot
*** SUMMARY ***
Total Pot $1.30 | Rake $0.06
Board [Qh 7h Qs]
Seat 1: Player#6979 (small blind) folded before the flop
Seat 2: Player#3342 (big blind) folded on the flop
Seat 3: Player#5495 folded before the flop
Seat 4: Player#9886 folded before the flop
Seat 5: Player#6931 shows [] and won ($1.23) with 
Seat 6: warioman (button) folded before the flop

PokerStars Hand #8ea1ce6f-1f3c-4b6e-8968-ac71d3546d30:  Hold'em No Limit ($0.1/$0.20 USD) - 2021/11/19 22:47:00 ET
Table 'Bel Air' 6-max Seat #5 is the button
Seat 1: Player#7794 ($45.49 in chips)
Seat 2: Player#2792 ($12.42 in chips)
Seat 3: Player#8300 ($33.34 in chips)
Seat 4: Player#8915 ($41.95 in chips)
Seat 5: Player#6544 ($22.79 in chips)
Seat 6: warioman ($22.50 in chips)
warioman: posts small blind $0.10
Player#7794: posts big blind $0.20
*** HOLE CARDS ***
Dealt to warioman [5d 4s]
Player#2792: folds
Player#8300: folds
Player#8915: folds
Player#6544: folds
warioman: folds
Player#7794 collected $0.20 from pot
*** SUMMARY ***
Total Pot $0.20 | Rake $0.00
Seat 1: Player#7794 shows [] and won ($0.20) with 
Seat 2: Player#2792 folded before the flop
Seat 3: Player#8300 folded before the flop
Seat 4: Player#8915 folded before the flop
Seat 5: Player#6544 (button) folded before the flop
Seat 6: warioman (small blind) folded before the flop

PokerStars Hand #265b990f-5b92-41cc-b8c0-403954c64c4c:  Hold'em No Limit ($0.1/$0.20 USD) - 2021/11/19 22:47:00 ET
Table 'Bel Air' 6-max Seat #4 is the button
Seat 1: Player#8236 ($45.49 in chips)
Seat 2: Player#7555 ($12.42 in chips)
Seat 3: Player#6223 ($33.04 in chips)
Seat 4: Player#6666 ($41.95 in chips)
Seat 5: Player#6445 ($22.89 in chips)
Seat 6: warioman ($22.70 in chips)
Player#6445: posts small blind $0.10
warioman: posts big blind $0.20
*** HOLE CARDS ***
Dealt to warioman [6d Qc]
Player#8236: folds
Player#7555: folds
Player#6223: raises $0.20 to $0.6
Player#6666: folds
Player#6445: folds
warioman: folds
Player#6223: doesn't show hand
Uncalled bet ($0.60) returned to Player#6223
Player#6223 collected $0.30 from pot
*** SUMMARY ***
Total Pot $0.30 | Rake $0.00
Seat 1: Player#8236 folded before the flop
Seat 2: Player#7555 folded before the flop
Seat 3: Player#6223 shows [] and won ($0.30) with 
Seat 4: Player#6666 (button) folded before the flop
Seat 5: Player#6445 (small blind) folded before the flop
Seat 6: warioman (big blind) folded before the flop

PokerStars Hand #b9ad9d9d-71ec-40f1-90a6-0a3bc4c0e9bb:  Hold'em No Limit ($0.1/$0.20 USD) - 2021/11/19 22:47:00 ET
Table 'Huntsville' 6-max Seat #3 is the button
Seat 1: Player#0412 ($21.17 in chips)
Seat 2: warioman ($22.14 in chips)
Seat 3: Player#4368 ($66.82 in chips)
Seat 4: Player#6233 ($60.79 in chips)
Seat 5: Player#9942 ($20.00 in chips)
Seat 6: Player#0650 ($21.95 in chips)
Player#6233: posts small blind $0.10
Player#9942: posts big blind $0.20
*** HOLE CARDS ***
Dealt to warioman [4h Qh]
Player#0650: calls $0.20
Player#0412: folds
warioman: folds
Player#4368: calls $0.20
Player#6233: calls $0.10
Player#9942: checks
*** FLOP *** [6c 9h 9s]
Player#6233: checks
Player#9942: bets $0.60
Player#0650: folds
Player#4368: folds
Player#6233: calls $0.60
*** TURN *** [6c 9h 9s] [Tc]
Player#6233: checks
Player#9942: bets $1.20
Player#6233: calls $1.20
*** RIVER *** [6c 9h 9s] [Tc] [8c]
Player#6233: checks
Player#9942: checks
*** SHOW DOWN *** 
Player#6233 collected $4.18 from pot
*** SUMMARY ***
Total Pot $4.40 | Rake $0.22
Board [6c 9h 9s Tc 8c]
Seat 1: Player#0412 folded before the flop
Seat 2: warioman folded before the flop
Seat 3: Player#4368 (button) folded on the flop
Seat 4: Player#6233 shows [Jd 9c] and won ($4.18) with 
Seat 5: Player#9942 (big blind) mucked
Seat 6: Player#0650 folded on the flop

PokerStars Hand #213b6631-ab7c-480e-85df-0c34e0daf00b:  Hold'em No Limit ($0.1/$0.20 USD) - 2021/11/19 22:47:00 ET
Table 'Huntsville' 6-max Seat #2 is the button
Seat 1: Player#9470 ($20.87 in chips)
Seat 2: warioman ($22.14 in chips)
Seat 3: Player#9942 ($66.92 in chips)
Seat 4: Player#3833 ($60.99 in chips)
Seat 5: Player#6976 ($20.00 in chips)
Seat 6: Player#7667 ($21.95 in chips)
Player#9942: posts small blind $0.10
Player#3833: posts big blind $0.20
*** HOLE CARDS ***
Dealt to warioman [Ts Kc]
Player#6976: folds
Player#7667: folds
Player#9470: raises $0.20 to $0.6
warioman: folds
Player#9942: folds
Player#3833: folds
Player#9470: doesn't show hand
Uncalled bet ($0.60) returned to Player#9470
Player#9470 collected $0.30 from pot
*** SUMMARY ***
Total Pot $0.30 | Rake $0.00
Seat 1: Player#9470 shows [] and won ($0.30) with 
Seat 2: warioman (button) folded before the flop
Seat 3: Player#9942 (small blind) folded before the flop
Seat 4: Player#3833 (big blind) folded before the flop
Seat 5: Player#6976 folded before the flop
Seat 6: Player#7667 folded before the flop

PokerStars Hand #569b1382-5c56-466e-8c99-d82eff7ecf60:  Hold'em No Limit ($0.1/$0.20 USD) - 2021/11/19 22:46:00 ET
Table 'Bel Air' 6-max Seat #3 is the button
Seat 1: Player#6612 ($47.97 in chips)
Seat 2: Player#7355 ($12.42 in chips)
Seat 3: Player#7164 ($33.04 in chips)
Seat 4: Player#2875 ($39.52 in chips)
Seat 5: Player#1726 ($23.09 in chips)
Seat 6: warioman ($22.70 in chips)
Player#2875: posts small blind $0.10
Player#1726: posts big blind $0.20
*** HOLE CARDS ***
Dealt to warioman [Kh 5c]
warioman: folds
Player#6612: raises $0.20 to $0.4
Player#7355: folds
Player#7164: folds
Player#2875: calls $0.30
Player#1726: folds
*** FLOP *** [8h 7h 3c]
Player#2875: checks
Player#6612: bets $0.50
Player#2875: raises $0.50 to $2.08
Player#6612: calls $1.58
*** TURN *** [8h 7h 3c] [7d]
Player#2875: bets $3.47
Player#6612: folds
Player#6612: doesn't show hand
Player#7355: doesn't show hand
Player#7164: doesn't show hand
Player#2875: doesn't show hand
Player#1726: doesn't show hand
warioman: doesn't show hand
Uncalled bet ($3.47) returned to Player#2875
Player#2875 collected $4.90 from pot
*** SUMMARY ***
Total Pot $5.16 | Rake $0.26
Board [8h 7h 3c 7d]
Seat 1: Player#6612 folded on the turn
Seat 2: Player#7355 folded before the flop
Seat 3: Player#7164 (button) folded before the flop
Seat 4: Player#2875 shows [] and won ($4.90) with 
Seat 5: Player#1726 (big blind) folded before the flop
Seat 6: warioman folded before the flop

PokerStars Hand #43415849-c729-4f96-a465-b15f3173693c:  Hold'em No Limit ($0.1/$0.20 USD) - 2021/11/19 22:46:00 ET
Table 'Huntsville' 6-max Seat #1 is the button
Seat 1: Player#2621 ($20.87 in chips)
Seat 2: warioman ($28.14 in chips)
Seat 3: Player#9508 ($55.82 in chips)
Seat 4: Player#8488 ($60.99 in chips)
Seat 5: Player#4281 ($20.00 in chips)
Seat 6: Player#5638 ($27.95 in chips)
warioman: posts small blind $0.10
Player#9508: posts big blind $0.20
*** HOLE CARDS ***
Dealt to warioman [7h 6h]
Player#8488: folds
Player#4281: folds
Player#5638: calls $0.20
Player#2621: folds
warioman: calls $0.10
Player#9508: raises $0.20 to $0.4
Player#5638: calls $0.20
warioman: calls $0.20
*** FLOP *** [7s Ac 8s]
warioman: checks
Player#9508: bets $0.20
Player#5638: calls $0.20
warioman: calls $0.20
*** TURN *** [7s Ac 8s] [6d]
warioman: checks
Player#9508: bets $1.80
Player#5638: calls $1.80
warioman: calls $1.80
*** RIVER *** [7s Ac 8s] [6d] [2d]
warioman: checks
Player#9508: checks
Player#5638: bets $3.60
warioman: calls $3.60
Player#9508: calls $3.60
*** SHOW DOWN *** 
warioman: doesn't show hand
Player#9508 collected $17.10 from pot
*** SUMMARY ***
Total Pot $18.00 | Rake $0.90
Board [7s Ac 8s 6d 2d]
Seat 1: Player#2621 (button) folded before the flop
Seat 2: warioman (small blind)
Seat 3: Player#9508 shows [8h Ah] and won ($17.10) with 
Seat 4: Player#8488 folded before the flop
Seat 5: Player#4281 folded before the flop
Seat 6: Player#5638 mucked

PokerStars Hand #45a299bb-a364-4e6c-9db6-136aa4ddda33:  Hold'em No Limit ($0.1/$0.20 USD) - 2021/11/19 22:45:00 ET
Table 'Bel Air' 6-max Seat #2 is the button
Seat 1: Player#1420 ($47.97 in chips)
Seat 2: Player#9874 ($16.02 in chips)
Seat 3: Player#5269 ($29.61 in chips)
Seat 4: Player#0236 ($39.72 in chips)
Seat 5: Player#1344 ($23.09 in chips)
Seat 6: warioman ($22.70 in chips)
Player#5269: posts small blind $0.10
Player#0236: posts big blind $0.20
*** HOLE CARDS ***
Dealt to warioman [Kd 2d]
Player#1344: folds
warioman: folds
Player#1420: folds
Player#9874: raises $0.20 to $0.6
Player#5269: calls $0.50
Player#0236: folds
*** FLOP *** [8d 9s Kh]
Player#5269: checks
Player#9874: bets $0.70
Player#5269: calls $0.70
*** TURN *** [8d 9s Kh] [5c]
Player#5269: checks
Player#9874: checks
*** RIVER *** [8d 9s Kh] [5c] [Qc]
Player#5269: bets $2.30
Player#9874: calls $2.30
*** SHOW DOWN *** 
Player#9874: doesn't show hand
Player#5269 collected $7.03 from pot
*** SUMMARY ***
Total Pot $7.40 | Rake $0.37
Board [8d 9s Kh 5c Qc]
Seat 1: Player#1420 folded before the flop
Seat 2: Player#9874 (button) mucked
Seat 3: Player#5269 shows [9d 9c] and won ($7.03) with 
Seat 4: Player#0236 (big blind) folded before the flop
Seat 5: Player#1344 folded before the flop
Seat 6: warioman folded before the flop

PokerStars Hand #37dcd847-d85e-4aa9-95dd-44f43347e774:  Hold'em No Limit ($0.1/$0.20 USD) - 2021/11/19 22:45:00 ET
Table 'Huntsville' 6-max Seat #6 is the button
Seat 1: Player#3899 ($18.74 in chips)
Seat 2: warioman ($28.34 in chips)
Seat 3: Player#1797 ($55.82 in chips)
Seat 4: Player#0226 ($63.14 in chips)
Seat 5: Player#9268 ($20.00 in chips)
Seat 6: Player#1280 ($27.95 in chips)
Player#3899: posts small blind $0.10
warioman: posts big blind $0.20
*** HOLE CARDS ***
Dealt to warioman [5h Qd]
Player#1797: folds
Player#0226: calls $0.20
Player#9268: folds
Player#1280: folds
Player#3899: raises $0.20 to $0.8
warioman: folds
Player#0226: calls $0.60
*** FLOP *** [6s 9h Kc]
Player#3899: bets $1.35
Player#0226: calls $1.35
*** TURN *** [6s 9h Kc] [4c]
Player#3899: bets $4.10
Player#0226: folds
Player#3899: doesn't show hand
Uncalled bet ($4.10) returned to Player#3899
Player#3899 collected $4.28 from pot
*** SUMMARY ***
Total Pot $4.50 | Rake $0.23
Board [6s 9h Kc 4c]
Seat 1: Player#3899 shows [] and won ($4.28) with 
Seat 2: warioman (big blind) folded before the flop
Seat 3: Player#1797 folded before the flop
Seat 4: Player#0226 folded on the turn
Seat 5: Player#9268 folded before the flop
Seat 6: Player#1280 (button) folded before the flop

PokerStars Hand #f3989b6f-f684-48cf-840f-297098d6ecaa:  Hold'em No Limit ($0.1/$0.20 USD) - 2021/11/19 22:45:00 ET
Table 'Bel Air' 6-max Seat #1 is the button
Seat 1: Player#6393 ($47.97 in chips)
Seat 2: Player#6011 ($15.32 in chips)
Seat 3: Player#6262 ($29.81 in chips)
Seat 4: Player#0875 ($39.72 in chips)
Seat 5: Player#4276 ($23.09 in chips)
Seat 6: warioman ($23.20 in chips)
Player#6011: posts small blind $0.10
Player#6262: posts big blind $0.20
*** HOLE CARDS ***
Dealt to warioman [2s 2d]
Player#0875: folds
Player#4276: folds
warioman: raises $0.20 to $0.5
Player#6393: folds
Player#6011: raises $0.50 to $1.6
Player#6262: folds
warioman: folds
Player#6011: doesn't show hand
Uncalled bet ($1.60) returned to Player#6011
Player#6011 collected $0.70 from pot
*** SUMMARY ***
Total Pot $0.70 | Rake $0.00
Seat 1: Player#6393 (button) folded before the flop
Seat 2: Player#6011 shows [] and won ($0.70) with 
Seat 3: Player#6262 (big blind) folded before the flop
Seat 4: Player#0875 folded before the flop
Seat 5: Player#4276 folded before the flop
Seat 6: warioman folded before the flop

PokerStars Hand #cd38d444-d12c-4035-aca8-891b5008ae96:  Hold'em No Limit ($0.1/$0.20 USD) - 2021/11/19 22:45:00 ET
Table 'Bel Air' 6-max Seat #6 is the button
Seat 1: Player#8525 ($48.07 in chips)
Seat 2: Player#5389 ($15.52 in chips)
Seat 3: Player#3861 ($29.81 in chips)
Seat 4: Player#1663 ($39.72 in chips)
Seat 5: Player#0528 ($23.09 in chips)
Seat 6: warioman ($22.90 in chips)
Player#8525: posts small blind $0.10
Player#5389: posts big blind $0.20
*** HOLE CARDS ***
Dealt to warioman [9c Th]
Player#3861: folds
Player#1663: folds
Player#0528: folds
warioman: raises $0.20 to $0.5
Player#8525: folds
Player#5389: folds
warioman: doesn't show hand
Uncalled bet ($0.50) returned to warioman
warioman collected $0.30 from pot
*** SUMMARY ***
Total Pot $0.30 | Rake $0.00
Seat 1: Player#8525 (small blind) folded before the flop
Seat 2: Player#5389 (big blind) folded before the flop
Seat 3: Player#3861 folded before the flop
Seat 4: Player#1663 folded before the flop
Seat 5: Player#0528 folded before the flop
Seat 6: warioman (button)

PokerStars Hand #2f7e6ee4-36d6-4a6b-8d4d-22b90648607c:  Hold'em No Limit ($0.1/$0.20 USD) - 2021/11/19 22:44:00 ET
Table 'Huntsville' 6-max Seat #5 is the button
Seat 1: Player#6464 ($19.34 in chips)
Seat 2: warioman ($28.34 in chips)
Seat 3: Player#9082 ($54.61 in chips)
Seat 4: Player#2649 ($63.74 in chips)
Seat 5: Player#3637 ($20.00 in chips)
Seat 6: Player#9109 ($28.05 in chips)
Player#9109: posts small blind $0.10
Player#6464: posts big blind $0.20
*** HOLE CARDS ***
Dealt to warioman [4s Kd]
warioman: folds
Player#9082: calls $0.20
Player#2649: raises $0.20 to $0.6
Player#3637: folds
Player#9109: folds
Player#6464: calls $0.40
Player#9082: calls $0.40
*** FLOP *** [Qc Jd Ks]
Player#6464: checks
Player#9082: checks
Player#2649: checks
*** TURN *** [Qc Jd Ks] [2s]
Player#6464: checks
Player#9082: bets $1.90
Player#2649: folds
Player#6464: folds
Player#9082: doesn't show hand
Uncalled bet ($1.90) returned to Player#9082
Player#9082 collected $1.81 from pot
*** SUMMARY ***
Total Pot $1.90 | Rake $0.10
Board [Qc Jd Ks 2s]
Seat 1: Player#6464 (big blind) folded on the turn
Seat 2: warioman folded before the flop
Seat 3: Player#9082 shows [] and won ($1.81) with 
Seat 4: Player#2649 folded on the turn
Seat 5: Player#3637 (button) folded before the flop
Seat 6: Player#9109 (small blind) folded before the flop

PokerStars Hand #8d4770e9-b806-4aef-b935-4a09b11a7a80:  Hold'em No Limit ($0.1/$0.20 USD) - 2021/11/19 22:44:00 ET
Table 'Huntsville' 6-max Seat #4 is the button
Seat 1: Player#4645 ($18.70 in chips)
Seat 2: warioman ($28.34 in chips)
Seat 3: Player#1305 ($54.61 in chips)
Seat 4: Player#9140 ($63.74 in chips)
Seat 5: Player#2980 ($14.16 in chips)
Seat 6: Player#4794 ($28.65 in chips)
Player#2980: posts small blind $0.10
Player#4794: posts big blind $0.20
*** HOLE CARDS ***
Dealt to warioman [Qs Kc]
Player#4645: raises $0.20 to $0.6
warioman: folds
Player#1305: folds
Player#9140: folds
Player#2980: folds
Player#4794: calls $0.40
*** FLOP *** [Qd 8h 9c]
Player#4794: checks
Player#4645: bets $0.80
Player#4794: folds
Player#4645: doesn't show hand
Uncalled bet ($0.80) returned to Player#4645
Player#4645 collected $1.24 from pot
*** SUMMARY ***
Total Pot $1.30 | Rake $0.07
Board [Qd 8h 9c]
Seat 1: Player#4645 shows [] and won ($1.24) with 
Seat 2: warioman folded before the flop
Seat 3: Player#1305 folded before the flop
Seat 4: Player#9140 (button) folded before the flop
Seat 5: Player#2980 (small blind) folded before the flop
Seat 6: Player#4794 (big blind) folded on the flop

PokerStars Hand #8ce0a488-3800-4b62-8e6e-bac6603ae3c5:  Hold'em No Limit ($0.1/$0.20 USD) - 2021/11/19 22:44:00 ET
Table 'Bel Air' 6-max Seat #5 is the button
Seat 1: Player#3554 ($48.27 in chips)
Seat 2: Player#8989 ($15.52 in chips)
Seat 3: Player#8488 ($29.81 in chips)
Seat 4: Player#0226 ($39.72 in chips)
Seat 5: Player#9137 ($23.09 in chips)
Seat 6: warioman ($22.72 in chips)
warioman: posts small blind $0.10
Player#3554: posts big blind $0.20
*** HOLE CARDS ***
Dealt to warioman [8h 7d]
Player#8989: folds
Player#8488: folds
Player#0226: folds
Player#9137: folds
warioman: calls $0.10
Player#3554: checks
*** FLOP *** [Kc 8d Jd]
warioman: checks
Player#3554: checks
*** TURN *** [Kc 8d Jd] [Js]
warioman: checks
Player#3554: checks
*** RIVER *** [Kc 8d Jd] [Js] [Ts]
warioman: checks
Player#3554: checks
*** SHOW DOWN *** 
warioman collected $0.38 from pot
*** SUMMARY ***
Total Pot $0.40 | Rake $0.02
Board [Kc 8d Jd Js Ts]
Seat 1: Player#3554 (big blind) mucked
Seat 2: Player#8989 folded before the flop
Seat 3: Player#8488 folded before the flop
Seat 4: Player#0226 folded before the flop
Seat 5: Player#9137 (button) folded before the flop
Seat 6: warioman (small blind)

PokerStars Hand #f6cf51bc-f2e9-4226-901f-a98547c21e18:  Hold'em No Limit ($0.1/$0.20 USD) - 2021/11/19 22:43:00 ET
Table 'Huntsville' 6-max Seat #3 is the button
Seat 1: Player#6752 ($19.90 in chips)
Seat 2: warioman ($28.34 in chips)
Seat 3: Player#4962 ($55.81 in chips)
Seat 4: Player#3265 ($56.36 in chips)
Seat 5: Player#9606 ($18.56 in chips)
Seat 6: Player#7225 ($29.85 in chips)
Player#3265: posts small blind $0.10
Player#9606: posts big blind $0.20
*** HOLE CARDS ***
Dealt to warioman [2s 2d]
Player#7225: calls $0.20
Player#6752: calls $0.20
warioman: folds
Player#4962: calls $0.20
Player#3265: raises $0.20 to $1.2
Player#9606: calls $1.00
Player#7225: calls $1.00
Player#6752: calls $1.00
Player#4962: calls $1.00
*** FLOP *** [6d Jh Td]
Player#3265: checks
Player#9606: checks
Player#7225: checks
Player#6752: checks
Player#4962: checks
*** TURN *** [6d Jh Td] [3h]
Player#3265: checks
Player#9606: bets $3.20
Player#7225: folds
Player#6752: folds
Player#4962: folds
Player#3265: calls $3.20
*** RIVER *** [6d Jh Td] [3h] [Jh]
Player#3265: checks
Player#9606: checks
*** SHOW DOWN *** 
Player#3265 collected $11.78 from pot
*** SUMMARY ***
Total Pot $12.40 | Rake $0.62
Board [6d Jh Td 3h Jh]
Seat 1: Player#6752 folded on the turn
Seat 2: warioman folded before the flop
Seat 3: Player#4962 (button) folded on the turn
Seat 4: Player#3265 shows [7h Ah] and won ($11.78) with 
Seat 5: Player#9606 (big blind) mucked
Seat 6: Player#7225 folded on the turn

PokerStars Hand #679b07a7-e264-4ff2-ab23-87ed5764a5cb:  Hold'em No Limit ($0.1/$0.20 USD) - 2021/11/19 22:43:00 ET
Table 'Bel Air' 6-max Seat #4 is the button
Seat 1: Player#7145 ($48.27 in chips)
Seat 2: Player#5619 ($16.77 in chips)
Seat 3: Player#3373 ($29.81 in chips)
Seat 4: Player#0835 ($39.72 in chips)
Seat 5: Player#9442 ($23.19 in chips)
Seat 6: warioman ($21.50 in chips)
Player#9442: posts small blind $0.10
warioman: posts big blind $0.20
*** HOLE CARDS ***
Dealt to warioman [7h 7s]
Player#7145: folds
Player#5619: raises $0.20 to $0.6
Player#3373: folds
Player#0835: folds
Player#9442: folds
warioman: calls $0.40
*** FLOP *** [3s Ts 3d]
warioman: checks
Player#5619: bets $0.65
warioman: calls $0.65
*** TURN *** [3s Ts 3d] [3c]
warioman: checks
Player#5619: checks
*** RIVER *** [3s Ts 3d] [3c] [Ac]
warioman: checks
Player#5619: checks
*** SHOW DOWN *** 
warioman collected $2.47 from pot
*** SUMMARY ***
Total Pot $2.60 | Rake $0.13
Board [3s Ts 3d 3c Ac]
Seat 1: Player#7145 folded before the flop
Seat 2: Player#5619 mucked
Seat 3: Player#3373 folded before the flop
Seat 4: Player#0835 (button) folded before the flop
Seat 5: Player#9442 (small blind) folded before the flop
Seat 6: warioman (big blind)

PokerStars Hand #bf45d9b0-0b2e-458e-97ee-af11d490892b:  Hold'em No Limit ($0.1/$0.20 USD) - 2021/11/19 22:42:00 ET
Table 'Huntsville' 6-max Seat #2 is the button
Seat 1: Player#9109 ($20.00 in chips)
Seat 2: warioman ($24.68 in chips)
Seat 3: Player#9944 ($55.91 in chips)
Seat 4: Player#1213 ($56.56 in chips)
Seat 5: Player#3159 ($20.00 in chips)
Seat 6: Player#8001 ($29.85 in chips)
Player#9944: posts small blind $0.10
Player#1213: posts big blind $0.20
*** HOLE CARDS ***
Dealt to warioman [Ad Ah]
Player#3159: raises $0.20 to $0.6
Player#8001: folds
Player#9109: folds
warioman: raises $0.60 to $2.2
Player#9944: folds
Player#1213: folds
Player#3159: calls $1.60
*** FLOP *** [As Qd 8c]
Player#3159: checks
warioman: checks
*** TURN *** [As Qd 8c] [Qc]
Player#3159: checks
warioman: checks
*** RIVER *** [As Qd 8c] [Qc] [Qc]
Player#3159: checks
warioman: bets $1.44
Player#3159: calls $1.44
*** SHOW DOWN *** 
Player#3159: doesn't show hand
warioman collected $7.30 from pot
*** SUMMARY ***
Total Pot $7.68 | Rake $0.38
Board [As Qd 8c Qc Qc]
Seat 1: Player#9109 folded before the flop
Seat 2: warioman (button)
Seat 3: Player#9944 (small blind) folded before the flop
Seat 4: Player#1213 (big blind) folded before the flop
Seat 5: Player#3159 mucked
Seat 6: Player#8001 folded before the flop

PokerStars Hand #f46665a7-7121-4a34-8eff-1b4173289d45:  Hold'em No Limit ($0.1/$0.20 USD) - 2021/11/19 22:42:00 ET
Table 'Bel Air' 6-max Seat #3 is the button
Seat 1: Player#6907 ($49.67 in chips)
Seat 2: Player#3737 ($16.77 in chips)
Seat 3: Player#7639 ($29.81 in chips)
Seat 4: Player#3857 ($41.12 in chips)
Seat 5: Player#9923 ($20.60 in chips)
Seat 6: warioman ($21.50 in chips)
Player#3857: posts small blind $0.10
Player#9923: posts big blind $0.20
*** HOLE CARDS ***
Dealt to warioman [6h Ts]
warioman: folds
Player#6907: raises $0.20 to $0.4
Player#3737: folds
Player#7639: folds
Player#3857: calls $0.30
Player#9923: calls $0.20
*** FLOP *** [5c 9s Th]
Player#3857: checks
Player#9923: checks
Player#6907: checks
*** TURN *** [5c 9s Th] [Js]
Player#3857: checks
Player#9923: bets $1.00
Player#6907: calls $1.00
Player#3857: calls $1.00
*** RIVER *** [5c 9s Th] [Js] [6s]
Player#3857: checks
Player#9923: checks
Player#6907: checks
*** SHOW DOWN *** 
Player#9923 collected $3.99 from pot
*** SUMMARY ***
Total Pot $4.20 | Rake $0.21
Board [5c 9s Th Js 6s]
Seat 1: Player#6907 mucked
Seat 2: Player#3737 folded before the flop
Seat 3: Player#7639 (button) folded before the flop
Seat 4: Player#3857 (small blind) mucked
Seat 5: Player#9923 shows [Kh 9h] and won ($3.99) with 
Seat 6: warioman folded before the flop

PokerStars Hand #c388eacc-d9c9-4158-9b6e-4f0880589007:  Hold'em No Limit ($0.1/$0.20 USD) - 2021/11/19 22:42:00 ET
Table 'Bel Air' 6-max Seat #2 is the button
Seat 1: Player#7873 ($49.67 in chips)
Seat 2: Player#2699 ($16.77 in chips)
Seat 3: Player#4324 ($29.91 in chips)
Seat 4: Player#1379 ($41.32 in chips)
Seat 5: Player#9557 ($20.30 in chips)
Seat 6: warioman ($21.50 in chips)
Player#4324: posts small blind $0.10
Player#1379: posts big blind $0.20
*** HOLE CARDS ***
Dealt to warioman [2h 2s]
Player#9557: raises $0.20 to $0.6
warioman: folds
Player#7873: folds
Player#2699: folds
Player#4324: folds
Player#1379: folds
Player#9557: doesn't show hand
Uncalled bet ($0.60) returned to Player#9557
Player#9557 collected $0.30 from pot
*** SUMMARY ***
Total Pot $0.30 | Rake $0.00
Seat 1: Player#7873 folded before the flop
Seat 2: Player#2699 (button) folded before the flop
Seat 3: Player#4324 (small blind) folded before the flop
Seat 4: Player#1379 (big blind) folded before the flop
Seat 5: Player#9557 shows [] and won ($0.30) with 
Seat 6: warioman folded before the flop

PokerStars Hand #194bace3-e417-47f2-ab02-01466d1f103b:  Hold'em No Limit ($0.1/$0.20 USD) - 2021/11/19 22:41:00 ET
Table 'Huntsville' 6-max Seat #1 is the button
Seat 1: Player#3536 ($20.00 in chips)
Seat 2: warioman ($24.78 in chips)
Seat 3: Player#7662 ($57.61 in chips)
Seat 4: Player#4749 ($56.96 in chips)
Seat 5: Player#0607 ($20.00 in chips)
Seat 6: Player#4006 ($27.84 in chips)
warioman: posts small blind $0.10
Player#7662: posts big blind $0.20
*** HOLE CARDS ***
Dealt to warioman [Kc 6d]
Player#4749: raises $0.20 to $0.4
Player#0607: folds
Player#4006: calls $0.40
warioman: folds
Player#7662: calls $0.20
*** FLOP *** [Jd 7s 2d]
Player#7662: checks
Player#4749: checks
Player#4006: checks
*** TURN *** [Jd 7s 2d] [Qs]
Player#7662: checks
Player#4749: checks
Player#4006: bets $1.30
Player#7662: calls $1.30
Player#4749: folds
*** RIVER *** [Jd 7s 2d] [Qs] [8s]
Player#7662: checks
Player#4006: bets $3.90
Player#7662: folds
Player#4006: doesn't show hand
Uncalled bet ($3.90) returned to Player#4006
Player#4006 collected $3.71 from pot
*** SUMMARY ***
Total Pot $3.90 | Rake $0.20
Board [Jd 7s 2d Qs 8s]
Seat 1: Player#3536 (button) mucked
Seat 2: warioman (small blind) folded before the flop
Seat 3: Player#7662 (big blind) folded on the river
Seat 4: Player#4749 folded on the turn
Seat 5: Player#0607 folded before the flop
Seat 6: Player#4006 shows [] and won ($3.71) with 

PokerStars Hand #ab9d9b1b-0bb3-4c5f-9d4b-649c631819a5:  Hold'em No Limit ($0.1/$0.20 USD) - 2021/11/19 22:41:00 ET
Table 'Bel Air' 6-max Seat #1 is the button
Seat 1: Player#9145 ($52.97 in chips)
Seat 2: Player#9706 ($16.87 in chips)
Seat 3: Player#4200 ($26.37 in chips)
Seat 4: Player#9444 ($41.32 in chips)
Seat 5: Player#5962 ($20.30 in chips)
Seat 6: warioman ($22.00 in chips)
Player#9706: posts small blind $0.10
Player#4200: posts big blind $0.20
*** HOLE CARDS ***
Dealt to warioman [7d Qd]
Player#9444: folds
Player#5962: folds
warioman: raises $0.20 to $0.5
Player#9145: calls $0.50
Player#9706: folds
Player#4200: calls $0.30
*** FLOP *** [9h 8c 8h]
Player#4200: checks
warioman: checks
Player#9145: bets $0.80
Player#4200: calls $0.80
warioman: folds
*** TURN *** [9h 8c 8h] [9d]
Player#4200: checks
Player#9145: bets $2.00
Player#4200: calls $2.00
*** RIVER *** [9h 8c 8h] [9d] [Td]
Player#4200: checks
Player#9145: checks
*** SHOW DOWN *** 
Player#4200 collected $6.84 from pot
*** SUMMARY ***
Total Pot $7.20 | Rake $0.36
Board [9h 8c 8h 9d Td]
Seat 1: Player#9145 (button) mucked
Seat 2: Player#9706 (small blind) folded before the flop
Seat 3: Player#4200 shows [8d 6d] and won ($6.84) with 
Seat 4: Player#9444 folded before the flop
Seat 5: Player#5962 folded before the flop
Seat 6: warioman folded on the flop

PokerStars Hand #7aa1c0d2-aaaf-4df4-b34f-2b078def70ef:  Hold'em No Limit ($0.1/$0.20 USD) - 2021/11/19 22:40:00 ET
Table 'Bel Air' 6-max Seat #6 is the button
Seat 1: Player#5144 ($53.17 in chips)
Seat 2: Player#3146 ($16.67 in chips)
Seat 3: Player#4446 ($26.37 in chips)
Seat 4: Player#7636 ($41.32 in chips)
Seat 5: Player#4557 ($20.30 in chips)
Seat 6: warioman ($22.00 in chips)
Player#5144: posts small blind $0.10
Player#3146: posts big blind $0.20
*** HOLE CARDS ***
Dealt to warioman [3h Jh]
Player#4446: folds
Player#7636: folds
Player#4557: folds
warioman: folds
Player#5144: calls $0.10
Player#3146: raises $0.20 to $0.8
Player#5144: folds
Player#5144: doesn't show hand
Player#3146: doesn't show hand
Player#4446: doesn't show hand
Player#7636: doesn't show hand
Player#4557: doesn't show hand
warioman: doesn't show hand
Uncalled bet ($0.80) returned to Player#3146
Player#3146 collected $0.20 from pot
*** SUMMARY ***
Total Pot $0.20 | Rake $0.00
Seat 1: Player#5144 (small blind) folded before the flop
Seat 2: Player#3146 shows [] and won ($0.20) with 
Seat 3: Player#4446 folded before the flop
Seat 4: Player#7636 folded before the flop
Seat 5: Player#4557 folded before the flop
Seat 6: warioman (button) folded before the flop

PokerStars Hand #eb175b7b-1ba1-424f-b8b5-445f1f0e1fe4:  Hold'em No Limit ($0.1/$0.20 USD) - 2021/11/19 22:40:00 ET
Table 'Huntsville' 6-max Seat #6 is the button
Seat 1: warioman ($24.98 in chips)
Seat 2: Player#2088 ($54.51 in chips)
Seat 3: Player#1833 ($56.96 in chips)
Seat 4: Player#9228 ($18.50 in chips)
Seat 5: Player#3750 ($30.44 in chips)
warioman: posts small blind $0.10
Player#2088: posts big blind $0.20
*** HOLE CARDS ***
Dealt to warioman [Ac 2c]
Player#2088: calls $0.20
Player#1833: folds
Player#9228: raises $0.20 to $0.6
Player#3750: calls $0.60
warioman: folds
Player#2088: calls $0.40
*** FLOP *** [Qs Ad 9s]
Player#2088: checks
Player#9228: checks
Player#3750: checks
*** TURN *** [Qs Ad 9s] [7c]
Player#2088: checks
Player#9228: checks
Player#3750: bets $2.00
Player#2088: calls $2.00
Player#9228: folds
*** RIVER *** [Qs Ad 9s] [7c] [Kc]
Player#2088: checks
Player#3750: checks
*** SHOW DOWN *** 
Player#2088 collected $5.70 from pot
*** SUMMARY ***
Total Pot $6.00 | Rake $0.30
Board [Qs Ad 9s 7c Kc]
Seat 1: warioman (small blind) folded before the flop
Seat 2: Player#2088 shows [Js 7s] and won ($5.70) with 
Seat 3: Player#1833 folded before the flop
Seat 4: Player#9228 folded on the turn
Seat 5: Player#3750 mucked

PokerStars Hand #eafa1ca6-a1e7-4078-8925-c1c9d790d34d:  Hold'em No Limit ($0.1/$0.20 USD) - 2021/11/19 22:40:00 ET
Table 'Bel Air' 6-max Seat #4 is the button
Seat 1: Player#6467 ($53.37 in chips)
Seat 2: Player#1794 ($26.37 in chips)
Seat 3: Player#7020 ($41.02 in chips)
Seat 4: Player#3090 ($20.30 in chips)
Seat 5: warioman ($22.10 in chips)
warioman: posts small blind $0.10
Player#6467: posts big blind $0.20
*** HOLE CARDS ***
Dealt to warioman [3h 7d]
Player#1794: folds
Player#7020: raises $0.20 to $0.5
Player#3090: folds
warioman: folds
Player#6467: folds
Player#6467: doesn't show hand
Player#1794: doesn't show hand
Player#7020: doesn't show hand
Player#3090: doesn't show hand
warioman: doesn't show hand
Uncalled bet ($0.50) returned to Player#7020
Player#7020 collected $0.30 from pot
*** SUMMARY ***
Total Pot $0.30 | Rake $0.00
Seat 1: Player#6467 (big blind) folded before the flop
Seat 2: Player#1794 folded before the flop
Seat 3: Player#7020 shows [] and won ($0.30) with 
Seat 4: Player#3090 (button) folded before the flop
Seat 5: warioman (small blind) folded before the flop

PokerStars Hand #755f573a-1f15-4815-82b2-9e119fdd4cb8:  Hold'em No Limit ($0.1/$0.20 USD) - 2021/11/19 22:40:00 ET
Table 'Bel Air' 6-max Seat #3 is the button
Seat 1: Player#9988 ($53.07 in chips)
Seat 2: Player#4044 ($26.37 in chips)
Seat 3: Player#8231 ($41.02 in chips)
Seat 4: Player#5198 ($20.40 in chips)
Seat 5: warioman ($22.30 in chips)
Player#5198: posts small blind $0.10
warioman: posts big blind $0.20
*** HOLE CARDS ***
Dealt to warioman [2c 6d]
Player#9988: raises $0.20 to $0.4
Player#4044: folds
Player#8231: folds
Player#5198: folds
warioman: folds
Player#9988: doesn't show hand
Uncalled bet ($0.40) returned to Player#9988
Player#9988 collected $0.30 from pot
*** SUMMARY ***
Total Pot $0.30 | Rake $0.00
Seat 1: Player#9988 shows [] and won ($0.30) with 
Seat 2: Player#4044 folded before the flop
Seat 3: Player#8231 (button) folded before the flop
Seat 4: Player#5198 (small blind) folded before the flop
Seat 5: warioman (big blind) folded before the flop

PokerStars Hand #c824d041-6c19-4182-9eb7-fc1f59604267:  Hold'em No Limit ($0.1/$0.20 USD) - 2021/11/19 22:39:00 ET
Table 'Bel Air' 6-max Seat #2 is the button
Seat 1: Player#5056 ($53.07 in chips)
Seat 2: Player#3099 ($26.97 in chips)
Seat 3: Player#1210 ($40.22 in chips)
Seat 4: Player#6019 ($20.60 in chips)
Seat 5: warioman ($22.30 in chips)
Player#1210: posts small blind $0.10
Player#6019: posts big blind $0.20
*** HOLE CARDS ***
Dealt to warioman [8h As]
warioman: folds
Player#5056: folds
Player#3099: raises $0.20 to $0.6
Player#1210: raises0.60 to $2
Player#6019: folds
Player#3099: folds
Player#5056: doesn't show hand
Player#3099: doesn't show hand
Player#1210: doesn't show hand
Player#6019: doesn't show hand
warioman: doesn't show hand
Uncalled bet ($2.00) returned to Player#1210
Player#1210 collected $0.80 from pot
*** SUMMARY ***
Total Pot $0.80 | Rake $0.00
Seat 1: Player#5056 folded before the flop
Seat 2: Player#3099 (button) folded before the flop
Seat 3: Player#1210 shows [] and won ($0.80) with 
Seat 4: Player#6019 (big blind) folded before the flop
Seat 5: warioman folded before the flop

PokerStars Hand #400c67e1-718a-4f1e-823a-c04958ab1699:  Hold'em No Limit ($0.1/$0.20 USD) - 2021/11/19 22:39:00 ET
Table 'Bel Air' 6-max Seat #1 is the button
Seat 1: Player#5847 ($53.07 in chips)
Seat 2: Player#7403 ($27.07 in chips)
Seat 3: Player#3433 ($40.42 in chips)
Seat 4: Player#8665 ($20.30 in chips)
Seat 5: warioman ($22.30 in chips)
Player#7403: posts small blind $0.10
Player#3433: posts big blind $0.20
*** HOLE CARDS ***
Dealt to warioman [Ts 9h]
Player#8665: raises $0.20 to $0.6
warioman: folds
Player#5847: folds
Player#7403: folds
Player#3433: folds
Player#8665: doesn't show hand
Uncalled bet ($0.60) returned to Player#8665
Player#8665 collected $0.30 from pot
*** SUMMARY ***
Total Pot $0.30 | Rake $0.00
Seat 1: Player#5847 (button) folded before the flop
Seat 2: Player#7403 (small blind) folded before the flop
Seat 3: Player#3433 (big blind) folded before the flop
Seat 4: Player#8665 shows [] and won ($0.30) with 
Seat 5: warioman folded before the flop

PokerStars Hand #e8749616-a26d-4137-ae3b-cb27b42f401d:  Hold'em No Limit ($0.1/$0.20 USD) - 2021/11/19 22:39:00 ET
Table 'Bel Air' 6-max Seat #6 is the button
Seat 1: Player#8693 ($53.17 in chips)
Seat 2: Player#8237 ($27.27 in chips)
Seat 3: Player#6709 ($40.42 in chips)
Seat 4: Player#8486 ($20.00 in chips)
Seat 5: warioman ($22.30 in chips)
Player#8693: posts small blind $0.10
Player#8237: posts big blind $0.20
*** HOLE CARDS ***
Dealt to warioman [5h 9h]
Player#6709: folds
Player#8486: raises $0.20 to $0.6
warioman: folds
Player#8693: folds
Player#8237: folds
Player#8486: doesn't show hand
Uncalled bet ($0.60) returned to Player#8486
Player#8486 collected $0.30 from pot
*** SUMMARY ***
Total Pot $0.30 | Rake $0.00
Seat 1: Player#8693 (small blind) folded before the flop
Seat 2: Player#8237 (big blind) folded before the flop
Seat 3: Player#6709 folded before the flop
Seat 4: Player#8486 shows [] and won ($0.30) with 
Seat 5: warioman folded before the flop

PokerStars Hand #859bc2ef-0f0e-4bc0-aacf-59ec0180bac8:  Hold'em No Limit ($0.1/$0.20 USD) - 2021/11/19 22:38:00 ET
Table 'Bel Air' 6-max Seat #4 is the button
Seat 1: Player#0011 ($53.37 in chips)
Seat 2: Player#4302 ($27.87 in chips)
Seat 3: Player#2794 ($40.42 in chips)
Seat 4: Player#1176 ($19.05 in chips)
Seat 5: warioman ($19.70 in chips)
warioman: posts small blind $0.10
Player#0011: posts big blind $0.20
*** HOLE CARDS ***
Dealt to warioman [Qh Qd]
Player#4302: raises $0.20 to $0.6
Player#2794: folds
Player#1176: raises $0.60 to $1.8
warioman: raises $1.80 to $4.6
Player#0011: folds
Player#4302: folds
Player#1176: folds
warioman: doesn't show hand
Uncalled bet ($4.60) returned to warioman
warioman collected $2.60 from pot
*** SUMMARY ***
Total Pot $2.60 | Rake $0.00
Seat 1: Player#0011 (big blind) folded before the flop
Seat 2: Player#4302 folded before the flop
Seat 3: Player#2794 folded before the flop
Seat 4: Player#1176 (button) folded before the flop
Seat 5: warioman (small blind)

PokerStars Hand #d11853a8-5bec-4b76-be02-1d5bf0b36d95:  Hold'em No Limit ($0.1/$0.20 USD) - 2021/11/19 22:38:00 ET
Table 'Huntsville' 6-max Seat #5 is the button
Seat 1: Player#2024 ($3.21 in chips)
Seat 2: warioman ($24.98 in chips)
Seat 3: Player#8966 ($54.51 in chips)
Seat 4: Player#6708 ($44.00 in chips)
Seat 5: Player#4826 ($18.50 in chips)
Seat 6: Player#5696 ($41.44 in chips)
Player#5696: posts small blind $0.10
Player#2024: posts big blind $0.20
*** HOLE CARDS ***
Dealt to warioman [Ts 4d]
warioman: folds
Player#8966: folds
Player#6708: calls $0.20
Player#4826: folds
Player#5696: calls $0.10
Player#2024: raises $0.20 to $0.8
Player#6708: calls $0.60
Player#5696: calls $0.60
*** FLOP *** [2s Tc 8h]
Player#5696: checks
Player#2024: bets $2.40
Player#6708: calls $2.40
Player#5696: calls $2.40
*** TURN *** [2s Tc 8h] [Qh]
Player#5696: bets $4.80
Player#2024: calls $0.01
Player#6708: calls $4.80
*** RIVER *** [2s Tc 8h] [Qh] [3h]
Player#5696: bets $3.00
Player#6708: raises3.00 to $36
Player#5696: folds
*** SHOW DOWN *** 
Player#2024: doesn't show hand
Uncalled bet ($36.00) returned to Player#6708
Player#6708 collected $21.10 from pot
*** SUMMARY ***
Total Pot $22.21 | Rake $1.11
Board [2s Tc 8h Qh 3h]
Seat 1: Player#2024 (big blind) mucked
Seat 2: warioman folded before the flop
Seat 3: Player#8966 folded before the flop
Seat 4: Player#6708 shows [2h 2d] and won ($21.10) with 
Seat 5: Player#4826 (button) folded before the flop
Seat 6: Player#5696 (small blind) folded on the river

PokerStars Hand #d4c833a2-22ab-41d7-bfc6-2d4fe4e319cf:  Hold'em No Limit ($0.1/$0.20 USD) - 2021/11/19 22:38:00 ET
Table 'Bel Air' 6-max Seat #3 is the button
Seat 1: Player#8938 ($53.37 in chips)
Seat 2: Player#4305 ($27.87 in chips)
Seat 3: Player#0470 ($39.96 in chips)
Seat 4: Player#6735 ($19.15 in chips)
Seat 5: warioman ($20.10 in chips)
Player#6735: posts small blind $0.10
warioman: posts big blind $0.20
*** HOLE CARDS ***
Dealt to warioman [7s Qs]
Player#8938: folds
Player#4305: folds
Player#0470: raises $0.20 to $0.4
Player#6735: folds
warioman: calls $0.20
*** FLOP *** [Jd Ac 6d]
warioman: checks
Player#0470: bets $0.35
warioman: folds
Player#8938: doesn't show hand
Player#4305: doesn't show hand
Player#0470: doesn't show hand
Player#6735: doesn't show hand
warioman: doesn't show hand
Uncalled bet ($0.35) returned to Player#0470
Player#0470 collected $0.85 from pot
*** SUMMARY ***
Total Pot $0.90 | Rake $0.05
Board [Jd Ac 6d]
Seat 1: Player#8938 folded before the flop
Seat 2: Player#4305 folded before the flop
Seat 3: Player#0470 shows [] and won ($0.85) with 
Seat 4: Player#6735 (small blind) folded before the flop
Seat 5: warioman (big blind) folded on the flop

PokerStars Hand #66f7bec9-1e42-4963-aea3-aece63cfebfc:  Hold'em No Limit ($0.1/$0.20 USD) - 2021/11/19 22:37:00 ET
Table 'Bel Air' 6-max Seat #2 is the button
Seat 1: Player#4543 ($53.37 in chips)
Seat 2: Player#6674 ($25.03 in chips)
Seat 3: Player#5687 ($40.06 in chips)
Seat 4: Player#1719 ($22.20 in chips)
Seat 5: warioman ($20.10 in chips)
Player#5687: posts small blind $0.10
Player#1719: posts big blind $0.20
*** HOLE CARDS ***
Dealt to warioman [Qd 7s]
warioman: folds
Player#4543: folds
Player#6674: raises $0.20 to $0.6
Player#5687: folds
Player#1719: calls $0.40
*** FLOP *** [2c 8s 9h]
Player#1719: checks
Player#6674: bets $0.85
Player#1719: calls $0.85
*** TURN *** [2c 8s 9h] [Tc]
Player#1719: checks
Player#6674: checks
*** RIVER *** [2c 8s 9h] [Tc] [6c]
Player#1719: bets $1.60
Player#6674: calls $1.60
*** SHOW DOWN *** 
Player#6674 collected $5.89 from pot
*** SUMMARY ***
Total Pot $6.20 | Rake $0.31
Board [2c 8s 9h Tc 6c]
Seat 1: Player#4543 folded before the flop
Seat 2: Player#6674 shows [Th 5s] and won ($5.89) with 
Seat 3: Player#5687 (small blind) folded before the flop
Seat 4: Player#1719 (big blind) mucked
Seat 5: warioman folded before the flop

PokerStars Hand #efd25da3-f51b-4a72-b151-c0e30b34483c:  Hold'em No Limit ($0.1/$0.20 USD) - 2021/11/19 22:37:00 ET
Table 'Huntsville' 6-max Seat #4 is the button
Seat 1: Player#7020 ($24.88 in chips)
Seat 2: warioman ($24.98 in chips)
Seat 3: Player#0331 ($54.51 in chips)
Seat 4: Player#6458 ($44.00 in chips)
Seat 5: Player#0084 ($18.60 in chips)
Seat 6: Player#6218 ($21.67 in chips)
Player#0084: posts small blind $0.10
Player#6218: posts big blind $0.20
*** HOLE CARDS ***
Dealt to warioman [5s 8h]
Player#7020: raises $0.20 to $0.6
warioman: folds
Player#0331: folds
Player#6458: folds
Player#0084: folds
Player#6218: raises $0.60 to $1.9
Player#7020: raises $1.90 to $5.8
Player#6218: calls $3.90
*** FLOP *** [9s 6d 8d]
Player#6218: bets $15.87
Player#7020: calls $15.87
Player#6218 Showing Pocket Cards KK
Player#7020 Showing Pocket Cards TT
*** TURN *** [9s 6d 8d] [3h]
*** RIVER *** [9s 6d 8d] [3h] [6h]
Player#6218 collected $41.94 from pot
*** SUMMARY ***
Total Pot $43.44 | Rake $1.50
Board [9s 6d 8d 3h 6h]
Seat 1: Player#7020 mucked
Seat 2: warioman folded before the flop
Seat 3: Player#0331 folded before the flop
Seat 4: Player#6458 (button) folded before the flop
Seat 5: Player#0084 (small blind) folded before the flop
Seat 6: Player#6218 shows [Kh Kd] and won ($41.94) with 

PokerStars Hand #83ebad9c-772f-4421-b634-29185cbb69a6:  Hold'em No Limit ($0.1/$0.20 USD) - 2021/11/19 22:37:00 ET
Table 'Bel Air' 6-max Seat #1 is the button
Seat 1: Player#1690 ($53.37 in chips)
Seat 2: Player#0593 ($24.83 in chips)
Seat 3: Player#8561 ($40.26 in chips)
Seat 4: Player#3035 ($22.20 in chips)
Seat 5: warioman ($20.10 in chips)
Player#0593: posts small blind $0.10
Player#8561: posts big blind $0.20
*** HOLE CARDS ***
Dealt to warioman [Jc 8d]
Player#3035: folds
warioman: folds
Player#1690: folds
Player#0593: raises $0.20 to $0.6
Player#8561: folds
Player#0593: doesn't show hand
Uncalled bet ($0.60) returned to Player#0593
Player#0593 collected $0.20 from pot
*** SUMMARY ***
Total Pot $0.20 | Rake $0.00
Seat 1: Player#1690 (button) folded before the flop
Seat 2: Player#0593 shows [] and won ($0.20) with 
Seat 3: Player#8561 (big blind) folded before the flop
Seat 4: Player#3035 folded before the flop
Seat 5: warioman folded before the flop

PokerStars Hand #2a70a7dc-21b2-47ce-95d6-555c968b7dbf:  Hold'em No Limit ($0.1/$0.20 USD) - 2021/11/19 22:37:00 ET
Table 'Huntsville' 6-max Seat #3 is the button
Seat 1: Player#8788 ($24.88 in chips)
Seat 2: warioman ($24.98 in chips)
Seat 3: Player#0227 ($54.01 in chips)
Seat 4: Player#5140 ($44.10 in chips)
Seat 5: Player#3507 ($18.80 in chips)
Seat 6: Player#0347 ($21.87 in chips)
Player#5140: posts small blind $0.10
Player#3507: posts big blind $0.20
*** HOLE CARDS ***
Dealt to warioman [Jh 4h]
Player#0347: calls $0.20
Player#8788: folds
warioman: folds
Player#0227: raises $0.20 to $0.9
Player#5140: folds
Player#3507: folds
Player#0347: folds
Player#0227: doesn't show hand
Uncalled bet ($0.90) returned to Player#0227
Player#0227 collected $0.50 from pot
*** SUMMARY ***
Total Pot $0.50 | Rake $0.00
Seat 1: Player#8788 folded before the flop
Seat 2: warioman folded before the flop
Seat 3: Player#0227 shows [] and won ($0.50) with 
Seat 4: Player#5140 (small blind) folded before the flop
Seat 5: Player#3507 (big blind) folded before the flop
Seat 6: Player#0347 folded before the flop

PokerStars Hand #6931f328-2b4e-49ae-ad69-5902e79caaa9:  Hold'em No Limit ($0.1/$0.20 USD) - 2021/11/19 22:37:00 ET
Table 'Bel Air' 6-max Seat #6 is the button
Seat 1: Player#1540 ($53.19 in chips)
Seat 2: Player#0404 ($25.03 in chips)
Seat 3: Player#6680 ($40.26 in chips)
Seat 4: Player#0347 ($22.20 in chips)
Seat 5: warioman ($20.10 in chips)
Player#1540: posts small blind $0.10
Player#0404: posts big blind $0.20
*** HOLE CARDS ***
Dealt to warioman [5c 4d]
Player#6680: folds
Player#0347: folds
warioman: folds
Player#1540: calls $0.10
Player#0404: checks
*** FLOP *** [2h 3d Tc]
Player#1540: bets $0.20
Player#0404: folds
Player#1540: doesn't show hand
Uncalled bet ($0.20) returned to Player#1540
Player#1540 collected $0.38 from pot
*** SUMMARY ***
Total Pot $0.40 | Rake $0.02
Board [2h 3d Tc]
Seat 1: Player#1540 shows [] and won ($0.38) with 
Seat 2: Player#0404 (big blind) folded on the flop
Seat 3: Player#6680 folded before the flop
Seat 4: Player#0347 folded before the flop
Seat 5: warioman folded before the flop

PokerStars Hand #a187310c-2b8d-4f3b-85cb-6c8dd4128a0d:  Hold'em No Limit ($0.1/$0.20 USD) - 2021/11/19 22:36:00 ET
Table 'Bel Air' 6-max Seat #4 is the button
Seat 1: Player#3580 ($53.09 in chips)
Seat 2: Player#6475 ($25.03 in chips)
Seat 3: Player#5570 ($40.26 in chips)
Seat 4: Player#7796 ($22.20 in chips)
Seat 5: warioman ($20.20 in chips)
warioman: posts small blind $0.10
Player#3580: posts big blind $0.20
*** HOLE CARDS ***
Dealt to warioman [6d 4h]
Player#6475: folds
Player#5570: folds
Player#7796: folds
warioman: folds
Player#3580 collected $0.20 from pot
*** SUMMARY ***
Total Pot $0.20 | Rake $0.00
Seat 1: Player#3580 shows [] and won ($0.20) with 
Seat 2: Player#6475 folded before the flop
Seat 3: Player#5570 folded before the flop
Seat 4: Player#7796 (button) folded before the flop
Seat 5: warioman (small blind) folded before the flop

PokerStars Hand #4988fcd1-6e0b-4460-b48f-e0fddd88603c:  Hold'em No Limit ($0.1/$0.20 USD) - 2021/11/19 22:36:00 ET
Table 'Huntsville' 6-max Seat #2 is the button
Seat 1: Player#3558 ($25.48 in chips)
Seat 2: warioman ($24.98 in chips)
Seat 3: Player#9270 ($52.61 in chips)
Seat 4: Player#7934 ($44.30 in chips)
Seat 5: Player#5090 ($19.40 in chips)
Seat 6: Player#2263 ($21.87 in chips)
Player#9270: posts small blind $0.10
Player#7934: posts big blind $0.20
*** HOLE CARDS ***
Dealt to warioman [5h 3c]
Player#5090: raises $0.20 to $0.6
Player#2263: folds
Player#3558: calls $0.60
warioman: folds
Player#9270: raises $0.60 to $2.6
Player#7934: folds
Player#5090: folds
Player#3558: folds
Player#9270: doesn't show hand
Uncalled bet ($2.60) returned to Player#9270
Player#9270 collected $1.40 from pot
*** SUMMARY ***
Total Pot $1.40 | Rake $0.00
Seat 1: Player#3558 folded before the flop
Seat 2: warioman (button) folded before the flop
Seat 3: Player#9270 shows [] and won ($1.40) with 
Seat 4: Player#7934 (big blind) folded before the flop
Seat 5: Player#5090 folded before the flop
Seat 6: Player#2263 folded before the flop

PokerStars Hand #0a6dc360-125c-49d1-a2f0-67a64f94563e:  Hold'em No Limit ($0.1/$0.20 USD) - 2021/11/19 22:36:00 ET
Table 'Bel Air' 6-max Seat #3 is the button
Seat 1: Player#1465 ($53.09 in chips)
Seat 2: Player#4197 ($25.03 in chips)
Seat 3: Player#2776 ($40.26 in chips)
Seat 4: Player#5609 ($22.30 in chips)
Seat 5: warioman ($20.10 in chips)
Player#5609: posts small blind $0.10
warioman: posts big blind $0.20
*** HOLE CARDS ***
Dealt to warioman [4s Qd]
Player#1465: folds
Player#4197: folds
Player#2776: folds
Player#5609: folds
warioman collected $0.20 from pot
*** SUMMARY ***
Total Pot $0.20 | Rake $0.00
Seat 1: Player#1465 folded before the flop
Seat 2: Player#4197 folded before the flop
Seat 3: Player#2776 (button) folded before the flop
Seat 4: Player#5609 (small blind) folded before the flop
Seat 5: warioman (big blind)

PokerStars Hand #e7b66d73-8573-449e-a921-10692bc3094d:  Hold'em No Limit ($0.1/$0.20 USD) - 2021/11/19 22:36:00 ET
Table 'Bel Air' 6-max Seat #2 is the button
Seat 1: Player#7631 ($53.09 in chips)
Seat 2: Player#9844 ($24.73 in chips)
Seat 3: Player#3484 ($40.36 in chips)
Seat 4: Player#7972 ($22.50 in chips)
Seat 5: warioman ($20.10 in chips)
Player#3484: posts small blind $0.10
Player#7972: posts big blind $0.20
*** HOLE CARDS ***
Dealt to warioman [8s 2h]
warioman: folds
Player#7631: folds
Player#9844: raises $0.20 to $0.6
Player#3484: folds
Player#7972: folds
Player#7631: doesn't show hand
Player#9844: doesn't show hand
Player#3484: doesn't show hand
Player#7972: doesn't show hand
warioman: doesn't show hand
Uncalled bet ($0.60) returned to Player#9844
Player#9844 collected $0.30 from pot
*** SUMMARY ***
Total Pot $0.30 | Rake $0.00
Seat 1: Player#7631 folded before the flop
Seat 2: Player#9844 shows [] and won ($0.30) with 
Seat 3: Player#3484 (small blind) folded before the flop
Seat 4: Player#7972 (big blind) folded before the flop
Seat 5: warioman folded before the flop

PokerStars Hand #e10d3033-dc76-4c1f-8831-7b7cad263ffe:  Hold'em No Limit ($0.1/$0.20 USD) - 2021/11/19 22:36:00 ET
Table 'Bel Air' 6-max Seat #1 is the button
Seat 1: Player#7967 ($52.26 in chips)
Seat 2: Player#1352 ($24.83 in chips)
Seat 3: Player#4811 ($40.56 in chips)
Seat 4: Player#5032 ($23.10 in chips)
Seat 5: warioman ($20.10 in chips)
Player#1352: posts small blind $0.10
Player#4811: posts big blind $0.20
*** HOLE CARDS ***
Dealt to warioman [Kc 6d]
Player#5032: raises $0.20 to $0.6
warioman: folds
Player#7967: calls $0.60
Player#1352: folds
Player#4811: folds
*** FLOP *** [9s Ac 7d]
Player#5032: checks
Player#7967: bets $0.75
Player#5032: folds
Player#7967: doesn't show hand
Uncalled bet ($0.75) returned to Player#7967
Player#7967 collected $1.43 from pot
*** SUMMARY ***
Total Pot $1.50 | Rake $0.08
Board [9s Ac 7d]
Seat 1: Player#7967 shows [] and won ($1.43) with 
Seat 2: Player#1352 (small blind) folded before the flop
Seat 3: Player#4811 (big blind) folded before the flop
Seat 4: Player#5032 folded on the flop
Seat 5: warioman folded before the flop

PokerStars Hand #defdcc6c-1bc6-48e2-a2e1-e8654bcb0c24:  Hold'em No Limit ($0.1/$0.20 USD) - 2021/11/19 22:35:00 ET
Table 'Huntsville' 6-max Seat #1 is the button
Seat 1: Player#7819 ($25.48 in chips)
Seat 2: warioman ($19.80 in chips)
Seat 3: Player#1063 ($58.36 in chips)
Seat 4: Player#1245 ($44.30 in chips)
Seat 5: Player#2696 ($19.40 in chips)
Seat 6: Player#8770 ($21.87 in chips)
warioman: posts small blind $0.10
Player#1063: posts big blind $0.20
*** HOLE CARDS ***
Dealt to warioman [6c Ad]
Player#1245: folds
Player#2696: folds
Player#8770: folds
Player#7819: folds
warioman: raises $0.20 to $0.6
Player#1063: raises0.60 to $1
warioman: calls $0.40
*** FLOP *** [As 8h 6h]
warioman: checks
Player#1063: checks
*** TURN *** [As 8h 6h] [5d]
warioman: bets $1.30
Player#1063: calls $1.30
*** RIVER *** [As 8h 6h] [5d] [Ad]
warioman: bets $3.45
Player#1063: calls $3.45
*** SHOW DOWN *** 
Player#1063: doesn't show hand
warioman collected $10.93 from pot
*** SUMMARY ***
Total Pot $11.50 | Rake $0.58
Board [As 8h 6h 5d Ad]
Seat 1: Player#7819 (button) folded before the flop
Seat 2: warioman (small blind)
Seat 3: Player#1063 (big blind) mucked
Seat 4: Player#1245 folded before the flop
Seat 5: Player#2696 folded before the flop
Seat 6: Player#8770 folded before the flop

PokerStars Hand #c0db9487-bd99-4c4f-867c-b63c2453986f:  Hold'em No Limit ($0.1/$0.20 USD) - 2021/11/19 22:35:00 ET
Table 'Bel Air' 6-max Seat #6 is the button
Seat 1: Player#4062 ($52.36 in chips)
Seat 2: Player#0531 ($24.73 in chips)
Seat 3: Player#1702 ($40.56 in chips)
Seat 4: Player#6453 ($23.10 in chips)
Seat 5: warioman ($20.10 in chips)
Player#4062: posts small blind $0.10
Player#0531: posts big blind $0.20
*** HOLE CARDS ***
Dealt to warioman [6s 8c]
Player#1702: folds
Player#6453: folds
warioman: folds
Player#4062: folds
Player#0531 collected $0.20 from pot
*** SUMMARY ***
Total Pot $0.20 | Rake $0.00
Seat 1: Player#4062 (small blind) folded before the flop
Seat 2: Player#0531 shows [] and won ($0.20) with 
Seat 3: Player#1702 folded before the flop
Seat 4: Player#6453 folded before the flop
Seat 5: warioman folded before the flop

PokerStars Hand #b0eb939d-ed4e-4e08-8128-d3e5fb9139de:  Hold'em No Limit ($0.1/$0.20 USD) - 2021/11/19 22:35:00 ET
Table 'Bel Air' 6-max Seat #5 is the button
Seat 1: Player#0083 ($52.56 in chips)
Seat 2: Player#5309 ($16.67 in chips)
Seat 3: Player#7176 ($24.43 in chips)
Seat 4: Player#5015 ($40.56 in chips)
Seat 5: Player#4038 ($23.10 in chips)
Seat 6: warioman ($20.20 in chips)
warioman: posts small blind $0.10
Player#0083: posts big blind $0.20
*** HOLE CARDS ***
Dealt to warioman [5h Ac]
Player#5309: folds
Player#7176: raises $0.20 to $0.6
Player#5015: folds
Player#4038: folds
warioman: folds
Player#0083: folds
Player#7176: doesn't show hand
Uncalled bet ($0.60) returned to Player#7176
Player#7176 collected $0.30 from pot
*** SUMMARY ***
Total Pot $0.30 | Rake $0.00
Seat 1: Player#0083 (big blind) folded before the flop
Seat 2: Player#5309 folded before the flop
Seat 3: Player#7176 shows [] and won ($0.30) with 
Seat 4: Player#5015 folded before the flop
Seat 5: Player#4038 (button) folded before the flop
Seat 6: warioman (small blind) folded before the flop

PokerStars Hand #fff3d4b6-6f44-4954-a55d-8a2e1d1be31b:  Hold'em No Limit ($0.1/$0.20 USD) - 2021/11/19 22:35:00 ET
Table 'Bel Air' 6-max Seat #4 is the button
Seat 1: Player#7320 ($52.56 in chips)
Seat 2: Player#2660 ($16.37 in chips)
Seat 3: Player#5293 ($24.43 in chips)
Seat 4: Player#9641 ($40.56 in chips)
Seat 5: Player#9221 ($23.20 in chips)
Seat 6: warioman ($20.40 in chips)
Player#9221: posts small blind $0.10
warioman: posts big blind $0.20
*** HOLE CARDS ***
Dealt to warioman [9c Qd]
Player#7320: folds
Player#2660: raises $0.20 to $0.7
Player#5293: folds
Player#9641: folds
Player#9221: folds
warioman: folds
Player#2660: doesn't show hand
Uncalled bet ($0.70) returned to Player#2660
Player#2660 collected $0.30 from pot
*** SUMMARY ***
Total Pot $0.30 | Rake $0.00
Seat 1: Player#7320 folded before the flop
Seat 2: Player#2660 shows [] and won ($0.30) with 
Seat 3: Player#5293 folded before the flop
Seat 4: Player#9641 (button) folded before the flop
Seat 5: Player#9221 (small blind) folded before the flop
Seat 6: warioman (big blind) folded before the flop

PokerStars Hand #f980dd97-b210-4a27-87a8-b54d7572ee53:  Hold'em No Limit ($0.1/$0.20 USD) - 2021/11/19 22:34:00 ET
Table 'Bel Air' 6-max Seat #3 is the button
Seat 1: Player#7678 ($52.56 in chips)
Seat 2: Player#9397 ($15.57 in chips)
Seat 3: Player#7080 ($24.43 in chips)
Seat 4: Player#1892 ($40.66 in chips)
Seat 5: Player#2730 ($23.40 in chips)
Seat 6: warioman ($20.90 in chips)
Player#1892: posts small blind $0.10
Player#2730: posts big blind $0.20
*** HOLE CARDS ***
Dealt to warioman [As 3s]
warioman: raises $0.20 to $0.5
Player#7678: folds
Player#9397: raises $0.50 to $1.6
Player#7080: folds
Player#1892: folds
Player#2730: folds
warioman: folds
Player#9397: doesn't show hand
Uncalled bet ($1.60) returned to Player#9397
Player#9397 collected $0.80 from pot
*** SUMMARY ***
Total Pot $0.80 | Rake $0.00
Seat 1: Player#7678 folded before the flop
Seat 2: Player#9397 shows [] and won ($0.80) with 
Seat 3: Player#7080 (button) folded before the flop
Seat 4: Player#1892 (small blind) folded before the flop
Seat 5: Player#2730 (big blind) folded before the flop
Seat 6: warioman folded before the flop

PokerStars Hand #f37856be-0984-4f95-b15f-edb88f32c004:  Hold'em No Limit ($0.1/$0.20 USD) - 2021/11/19 22:34:00 ET
Table 'Huntsville' 6-max Seat #6 is the button
Seat 1: Player#0402 ($28.88 in chips)
Seat 2: warioman ($20.00 in chips)
Seat 3: Player#4199 ($61.76 in chips)
Seat 4: Player#6495 ($44.30 in chips)
Seat 5: Player#9135 ($19.40 in chips)
Seat 6: Player#0117 ($15.39 in chips)
Player#0402: posts small blind $0.10
warioman: posts big blind $0.20
*** HOLE CARDS ***
Dealt to warioman [6c 3h]
Player#4199: calls $0.20
Player#6495: folds
Player#9135: folds
Player#0117: calls $0.20
Player#0402: raises0.20 to $1
warioman: folds
Player#4199: calls $0.80
Player#0117: calls $0.80
*** FLOP *** [4h 5h 6d]
Player#0402: bets $2.40
Player#4199: calls $2.40
Player#0117: calls $2.40
*** TURN *** [4h 5h 6d] [9d]
Player#0402: checks
Player#4199: checks
Player#0117: checks
*** RIVER *** [4h 5h 6d] [9d] [Td]
Player#0402: checks
Player#4199: checks
Player#0117: bets $5.20
Player#0402: folds
Player#4199: folds
Player#0117: doesn't show hand
Uncalled bet ($5.20) returned to Player#0117
Player#0117 collected $9.88 from pot
*** SUMMARY ***
Total Pot $10.40 | Rake $0.52
Board [4h 5h 6d 9d Td]
Seat 1: Player#0402 (small blind) folded on the river
Seat 2: warioman (big blind) folded before the flop
Seat 3: Player#4199 folded on the river
Seat 4: Player#6495 folded before the flop
Seat 5: Player#9135 folded before the flop
Seat 6: Player#0117 shows [] and won ($9.88) with 

PokerStars Hand #17c5b6b9-41ec-4948-8f7e-f38ef5ac9a8a:  Hold'em No Limit ($0.1/$0.20 USD) - 2021/11/19 22:34:00 ET
Table 'Bel Air' 6-max Seat #2 is the button
Seat 1: Player#1736 ($52.56 in chips)
Seat 2: Player#8515 ($15.27 in chips)
Seat 3: Player#4443 ($24.53 in chips)
Seat 4: Player#3448 ($40.86 in chips)
Seat 5: Player#3413 ($23.40 in chips)
Seat 6: warioman ($20.90 in chips)
Player#4443: posts small blind $0.10
Player#3448: posts big blind $0.20
*** HOLE CARDS ***
Dealt to warioman [6h 4c]
Player#3413: folds
warioman: folds
Player#1736: folds
Player#8515: raises $0.20 to $0.7
Player#4443: folds
Player#3448: folds
Player#8515: doesn't show hand
Uncalled bet ($0.70) returned to Player#8515
Player#8515 collected $0.30 from pot
*** SUMMARY ***
Total Pot $0.30 | Rake $0.00
Seat 1: Player#1736 folded before the flop
Seat 2: Player#8515 shows [] and won ($0.30) with 
Seat 3: Player#4443 (small blind) folded before the flop
Seat 4: Player#3448 (big blind) folded before the flop
Seat 5: Player#3413 folded before the flop
Seat 6: warioman folded before the flop

PokerStars Hand #2a641460-a21f-42cb-8018-59b5f7ce17b3:  Hold'em No Limit ($0.1/$0.20 USD) - 2021/11/19 22:34:00 ET
Table 'Huntsville' 6-max Seat #5 is the button
Seat 1: Player#3913 ($27.97 in chips)
Seat 2: warioman ($20.00 in chips)
Seat 3: Player#9773 ($62.66 in chips)
Seat 4: Player#0117 ($44.30 in chips)
Seat 5: Player#4255 ($19.40 in chips)
Seat 6: Player#8724 ($15.49 in chips)
Player#8724: posts small blind $0.10
Player#3913: posts big blind $0.20
*** HOLE CARDS ***
Dealt to warioman [2c 3c]
warioman: folds
Player#9773: calls $0.20
Player#0117: folds
Player#4255: folds
Player#8724: folds
Player#3913: raises $0.20 to $0.9
Player#9773: calls $0.70
*** FLOP *** [Ac 6h 3d]
Player#3913: bets $1.20
Player#9773: folds
Player#3913: doesn't show hand
Uncalled bet ($1.20) returned to Player#3913
Player#3913 collected $1.80 from pot
*** SUMMARY ***
Total Pot $1.90 | Rake $0.09
Board [Ac 6h 3d]
Seat 1: Player#3913 shows [] and won ($1.80) with 
Seat 2: warioman folded before the flop
Seat 3: Player#9773 folded on the flop
Seat 4: Player#0117 folded before the flop
Seat 5: Player#4255 (button) folded before the flop
Seat 6: Player#8724 (small blind) folded before the flop

PokerStars Hand #9e44a802-226a-4390-9173-56c2e982c1cb:  Hold'em No Limit ($0.1/$0.20 USD) - 2021/11/19 22:34:00 ET
Table 'Bel Air' 6-max Seat #1 is the button
Seat 1: Player#7811 ($52.56 in chips)
Seat 2: Player#8483 ($15.09 in chips)
Seat 3: Player#7540 ($24.73 in chips)
Seat 4: Player#6050 ($40.86 in chips)
Seat 5: Player#4320 ($23.40 in chips)
Seat 6: warioman ($20.90 in chips)
Player#8483: posts small blind $0.10
Player#7540: posts big blind $0.20
*** HOLE CARDS ***
Dealt to warioman [Qc 2h]
Player#6050: folds
Player#4320: folds
warioman: folds
Player#7811: folds
Player#8483: calls $0.10
Player#7540: checks
*** FLOP *** [9h Ac 4c]
Player#8483: bets $0.40
Player#7540: folds
Player#8483: doesn't show hand
Uncalled bet ($0.40) returned to Player#8483
Player#8483 collected $0.38 from pot
*** SUMMARY ***
Total Pot $0.40 | Rake $0.02
Board [9h Ac 4c]
Seat 1: Player#7811 (button) folded before the flop
Seat 2: Player#8483 shows [] and won ($0.38) with 
Seat 3: Player#7540 (big blind) folded on the flop
Seat 4: Player#6050 folded before the flop
Seat 5: Player#4320 folded before the flop
Seat 6: warioman folded before the flop

PokerStars Hand #d3f5fc4c-fe18-4faf-bb0c-09e5eae39fdd:  Hold'em No Limit ($0.1/$0.20 USD) - 2021/11/19 22:33:00 ET
Table 'Bel Air' 6-max Seat #6 is the button
Seat 1: Player#7984 ($52.66 in chips)
Seat 2: Player#0583 ($15.29 in chips)
Seat 3: Player#9077 ($25.33 in chips)
Seat 4: Player#3209 ($40.86 in chips)
Seat 5: Player#4266 ($23.40 in chips)
Seat 6: warioman ($20.07 in chips)
Player#7984: posts small blind $0.10
Player#0583: posts big blind $0.20
*** HOLE CARDS ***
Dealt to warioman [5d 6d]
Player#9077: raises $0.20 to $0.6
Player#3209: folds
Player#4266: folds
warioman: calls $0.60
Player#7984: folds
Player#0583: folds
*** FLOP *** [Jc Th Kc]
Player#9077: checks
warioman: checks
*** TURN *** [Jc Th Kc] [7h]
Player#9077: checks
warioman: checks
*** RIVER *** [Jc Th Kc] [7h] [5h]
Player#9077: checks
warioman: checks
*** SHOW DOWN *** 
warioman collected $1.43 from pot
*** SUMMARY ***
Total Pot $1.50 | Rake $0.08
Board [Jc Th Kc 7h 5h]
Seat 1: Player#7984 (small blind) folded before the flop
Seat 2: Player#0583 (big blind) folded before the flop
Seat 3: Player#9077 mucked
Seat 4: Player#3209 folded before the flop
Seat 5: Player#4266 folded before the flop
Seat 6: warioman (button)

PokerStars Hand #0b9a7652-3804-4425-b699-f944e5a45153:  Hold'em No Limit ($0.1/$0.20 USD) - 2021/11/19 22:33:00 ET
Table 'Huntsville' 6-max Seat #4 is the button
Seat 1: Player#2831 ($35.22 in chips)
Seat 2: warioman ($20.00 in chips)
Seat 3: Player#7644 ($63.26 in chips)
Seat 4: Player#6989 ($44.90 in chips)
Seat 5: Player#6967 ($20.00 in chips)
Seat 6: Player#7213 ($7.25 in chips)
Player#6967: posts small blind $0.10
Player#7213: posts big blind $0.20
*** HOLE CARDS ***
Dealt to warioman [4h Js]
Player#2831: raises $0.20 to $0.6
warioman: folds
Player#7644: calls $0.60
Player#6989: calls $0.60
Player#6967: calls $0.50
Player#7213: calls $0.40
*** FLOP *** [Qd 5s 8h]
Player#6967: checks
Player#7213: checks
Player#2831: bets $2.20
Player#7644: folds
Player#6989: folds
Player#6967: folds
Player#7213: calls $2.20
*** TURN *** [Qd 5s 8h] [Jh]
Player#7213: bets $4.45
Player#2831: calls $4.45
Player#7213 Showing Pocket Cards 88
Player#2831 Showing Pocket Cards QT
*** RIVER *** [Qd 5s 8h] [Jh] [2h]
Player#7213 collected $15.49 from pot
*** SUMMARY ***
Total Pot $16.30 | Rake $0.82
Board [Qd 5s 8h Jh 2h]
Seat 1: Player#2831 mucked
Seat 2: warioman folded before the flop
Seat 3: Player#7644 folded on the flop
Seat 4: Player#6989 (button) folded on the flop
Seat 5: Player#6967 (small blind) folded on the flop
Seat 6: Player#7213 shows [8s 8d] and won ($15.49) with 

PokerStars Hand #38862edb-4cb3-4076-9522-8d28ff0bd23f:  Hold'em No Limit ($0.1/$0.20 USD) - 2021/11/19 22:32:00 ET
Table 'Bel Air' 6-max Seat #5 is the button
Seat 1: Player#2970 ($52.86 in chips)
Seat 2: Player#9151 ($15.29 in chips)
Seat 3: Player#2516 ($25.03 in chips)
Seat 4: Player#2379 ($40.86 in chips)
Seat 5: Player#5448 ($23.40 in chips)
Seat 6: warioman ($20.17 in chips)
warioman: posts small blind $0.10
Player#2970: posts big blind $0.20
*** HOLE CARDS ***
Dealt to warioman [9d Ts]
Player#9151: folds
Player#2516: raises $0.20 to $0.6
Player#2379: folds
Player#5448: folds
warioman: folds
Player#2970: folds
Player#2970: doesn't show hand
Player#9151: doesn't show hand
Player#2516: doesn't show hand
Player#2379: doesn't show hand
Player#5448: doesn't show hand
warioman: doesn't show hand
Uncalled bet ($0.60) returned to Player#2516
Player#2516 collected $0.30 from pot
*** SUMMARY ***
Total Pot $0.30 | Rake $0.00
Seat 1: Player#2970 (big blind) folded before the flop
Seat 2: Player#9151 folded before the flop
Seat 3: Player#2516 shows [] and won ($0.30) with 
Seat 4: Player#2379 folded before the flop
Seat 5: Player#5448 (button) folded before the flop
Seat 6: warioman (small blind) folded before the flop

PokerStars Hand #2966cf8f-516a-4aca-8a91-cb9d8fdd1240:  Hold'em No Limit ($0.1/$0.20 USD) - 2021/11/19 22:32:00 ET
Table 'Bel Air' 6-max Seat #4 is the button
Seat 1: Player#8065 ($52.86 in chips)
Seat 2: Player#2874 ($15.29 in chips)
Seat 3: Player#7374 ($25.03 in chips)
Seat 4: Player#5062 ($40.86 in chips)
Seat 5: Player#0031 ($23.50 in chips)
Seat 6: warioman ($20.07 in chips)
Player#0031: posts small blind $0.10
warioman: posts big blind $0.20
*** HOLE CARDS ***
Dealt to warioman [Kh 8d]
Player#8065: folds
Player#2874: folds
Player#7374: folds
Player#5062: folds
Player#0031: folds
warioman collected $0.20 from pot
*** SUMMARY ***
Total Pot $0.20 | Rake $0.00
Seat 1: Player#8065 folded before the flop
Seat 2: Player#2874 folded before the flop
Seat 3: Player#7374 folded before the flop
Seat 4: Player#5062 (button) folded before the flop
Seat 5: Player#0031 (small blind) folded before the flop
Seat 6: warioman (big blind)

PokerStars Hand #b26ffd02-3091-4afa-b9cb-d87e89b3ac4c:  Hold'em No Limit ($0.1/$0.20 USD) - 2021/11/19 22:32:00 ET
Table 'Bel Air' 6-max Seat #3 is the button
Seat 1: Player#3597 ($52.86 in chips)
Seat 2: Player#2856 ($15.29 in chips)
Seat 3: Player#7660 ($24.73 in chips)
Seat 4: Player#5509 ($40.96 in chips)
Seat 5: Player#4639 ($23.70 in chips)
Seat 6: warioman ($20.07 in chips)
Player#5509: posts small blind $0.10
Player#4639: posts big blind $0.20
*** HOLE CARDS ***
Dealt to warioman [Td 6d]
warioman: folds
Player#3597: folds
Player#2856: folds
Player#7660: raises $0.20 to $0.6
Player#5509: folds
Player#4639: folds
Player#7660: doesn't show hand
Uncalled bet ($0.60) returned to Player#7660
Player#7660 collected $0.30 from pot
*** SUMMARY ***
Total Pot $0.30 | Rake $0.00
Seat 1: Player#3597 folded before the flop
Seat 2: Player#2856 folded before the flop
Seat 3: Player#7660 shows [] and won ($0.30) with 
Seat 4: Player#5509 (small blind) folded before the flop
Seat 5: Player#4639 (big blind) folded before the flop
Seat 6: warioman folded before the flop

PokerStars Hand #d26c3f3d-9472-4716-a4fc-af25118c452a:  Hold'em No Limit ($0.1/$0.20 USD) - 2021/11/19 22:31:00 ET
Table 'Huntsville' 6-max Seat #3 is the button
Seat 1: Player#1037 ($35.22 in chips)
Seat 2: warioman ($20.38 in chips)
Seat 3: Player#3951 ($63.26 in chips)
Seat 4: Player#4957 ($45.00 in chips)
Seat 5: Player#9122 ($18.20 in chips)
Seat 6: Player#0367 ($5.21 in chips)
Player#4957: posts small blind $0.10
Player#9122: posts big blind $0.20
*** HOLE CARDS ***
Dealt to warioman [Qh As]
Player#0367: calls $0.20
Player#1037: folds
warioman: raises $0.20 to $0.9
Player#3951: folds
Player#4957: folds
Player#9122: folds
Player#0367: calls $0.70
*** FLOP *** [6h Jd 5h]
Player#0367: checks
warioman: checks
*** TURN *** [6h Jd 5h] [9s]
Player#0367: bets $1.05
warioman: calls $1.05
*** RIVER *** [6h Jd 5h] [9s] [4s]
Player#0367: bets $3.26
warioman: folds
Player#0367: doesn't show hand
Uncalled bet ($3.26) returned to Player#0367
Player#0367 collected $3.99 from pot
*** SUMMARY ***
Total Pot $4.20 | Rake $0.21
Board [6h Jd 5h 9s 4s]
Seat 1: Player#1037 folded before the flop
Seat 2: warioman folded on the river
Seat 3: Player#3951 (button) folded before the flop
Seat 4: Player#4957 (small blind) folded before the flop
Seat 5: Player#9122 (big blind) folded before the flop
Seat 6: Player#0367 shows [] and won ($3.99) with 

PokerStars Hand #47e74669-c289-4e9e-ba12-a157cbf14b85:  Hold'em No Limit ($0.1/$0.20 USD) - 2021/11/19 22:31:00 ET
Table 'Huntsville' 6-max Seat #2 is the button
Seat 1: Player#6736 ($35.22 in chips)
Seat 2: warioman ($19.88 in chips)
Seat 3: Player#4169 ($63.36 in chips)
Seat 4: Player#9130 ($45.20 in chips)
Seat 5: Player#8072 ($18.20 in chips)
Seat 6: Player#1710 ($5.41 in chips)
Player#4169: posts small blind $0.10
Player#9130: posts big blind $0.20
*** HOLE CARDS ***
Dealt to warioman [Td Tc]
Player#8072: folds
Player#1710: calls $0.20
Player#6736: folds
warioman: raises $0.20 to $0.9
Player#4169: folds
Player#9130: folds
Player#1710: folds
warioman: doesn't show hand
Uncalled bet ($0.90) returned to warioman
warioman collected $0.50 from pot
*** SUMMARY ***
Total Pot $0.50 | Rake $0.00
Seat 1: Player#6736 folded before the flop
Seat 2: warioman (button)
Seat 3: Player#4169 (small blind) folded before the flop
Seat 4: Player#9130 (big blind) folded before the flop
Seat 5: Player#8072 folded before the flop
Seat 6: Player#1710 folded before the flop

PokerStars Hand #a48d5777-f42a-4869-9fac-494f054e0437:  Hold'em No Limit ($0.1/$0.20 USD) - 2021/11/19 22:31:00 ET
Table 'Huntsville' 6-max Seat #1 is the button
Seat 1: Player#7385 ($35.22 in chips)
Seat 2: warioman ($19.98 in chips)
Seat 3: Player#6912 ($63.56 in chips)
Seat 4: Player#5395 ($45.20 in chips)
Seat 5: Player#5323 ($18.20 in chips)
Seat 6: Player#0698 ($5.13 in chips)
warioman: posts small blind $0.10
Player#6912: posts big blind $0.20
*** HOLE CARDS ***
Dealt to warioman [7h 4s]
Player#5395: folds
Player#5323: folds
Player#0698: calls $0.20
Player#7385: folds
warioman: folds
Player#6912: checks
*** FLOP *** [5h Tc Qh]
Player#6912: checks
Player#0698: bets $0.60
Player#6912: folds
Player#0698: doesn't show hand
Uncalled bet ($0.60) returned to Player#0698
Player#0698 collected $0.48 from pot
*** SUMMARY ***
Total Pot $0.50 | Rake $0.03
Board [5h Tc Qh]
Seat 1: Player#7385 (button) folded before the flop
Seat 2: warioman (small blind) folded before the flop
Seat 3: Player#6912 (big blind) folded on the flop
Seat 4: Player#5395 folded before the flop
Seat 5: Player#5323 folded before the flop
Seat 6: Player#0698 shows [] and won ($0.48) with 

PokerStars Hand #a285fdc4-6a21-417e-8aeb-6daf9613402f:  Hold'em No Limit ($0.1/$0.20 USD) - 2021/11/19 22:31:00 ET
Table 'Bel Air' 6-max Seat #2 is the button
Seat 1: Player#6915 ($51.52 in chips)
Seat 2: Player#9976 ($15.29 in chips)
Seat 3: Player#3804 ($24.83 in chips)
Seat 4: Player#7868 ($42.34 in chips)
Seat 5: Player#4392 ($23.70 in chips)
Seat 6: warioman ($20.07 in chips)
Player#3804: posts small blind $0.10
Player#7868: posts big blind $0.20
*** HOLE CARDS ***
Dealt to warioman [Ks 7c]
Player#4392: folds
warioman: folds
Player#6915: raises $0.20 to $0.6
Player#9976: folds
Player#3804: folds
Player#7868: calls $0.40
*** FLOP *** [6c Jh 4d]
Player#7868: checks
Player#6915: checks
*** TURN *** [6c Jh 4d] [2c]
Player#7868: bets $0.78
Player#6915: calls $0.78
*** RIVER *** [6c Jh 4d] [2c] [Qc]
Player#7868: checks
Player#6915: checks
*** SHOW DOWN *** 
Player#6915 collected $2.72 from pot
*** SUMMARY ***
Total Pot $2.86 | Rake $0.14
Board [6c Jh 4d 2c Qc]
Seat 1: Player#6915 shows [5s 5d] and won ($2.72) with 
Seat 2: Player#9976 (button) folded before the flop
Seat 3: Player#3804 (small blind) folded before the flop
Seat 4: Player#7868 (big blind) mucked
Seat 5: Player#4392 folded before the flop
Seat 6: warioman folded before the flop

PokerStars Hand #4a88d131-951d-47d3-b37d-c4c726b290f5:  Hold'em No Limit ($0.1/$0.20 USD) - 2021/11/19 22:30:00 ET
Table 'Huntsville' 6-max Seat #6 is the button
Seat 1: Player#1458 ($33.99 in chips)
Seat 2: warioman ($20.18 in chips)
Seat 3: Player#2282 ($63.56 in chips)
Seat 4: Player#4301 ($46.35 in chips)
Seat 5: Player#3859 ($18.20 in chips)
Seat 6: Player#4767 ($5.13 in chips)
Player#1458: posts small blind $0.10
warioman: posts big blind $0.20
*** HOLE CARDS ***
Dealt to warioman [Td 5d]
Player#2282: folds
Player#4301: raises $0.20 to $0.4
Player#3859: folds
Player#4767: folds
Player#1458: calls $0.30
warioman: folds
*** FLOP *** [9c 8d Qs]
Player#1458: checks
Player#4301: checks
*** TURN *** [9c 8d Qs] [As]
Player#1458: checks
Player#4301: bets $0.75
Player#1458: calls $0.75
*** RIVER *** [9c 8d Qs] [As] [6s]
Player#1458: checks
Player#4301: checks
*** SHOW DOWN *** 
Player#1458 collected $2.38 from pot
*** SUMMARY ***
Total Pot $2.50 | Rake $0.12
Board [9c 8d Qs As 6s]
Seat 1: Player#1458 shows [3c Ad] and won ($2.38) with 
Seat 2: warioman (big blind) folded before the flop
Seat 3: Player#2282 folded before the flop
Seat 4: Player#4301 mucked
Seat 5: Player#3859 folded before the flop
Seat 6: Player#4767 (button) folded before the flop

PokerStars Hand #dda95dd2-f78b-41c7-b2e0-c3317064c03c:  Hold'em No Limit ($0.1/$0.20 USD) - 2021/11/19 22:30:00 ET
Table 'Bel Air' 6-max Seat #1 is the button
Seat 1: Player#5286 ($51.52 in chips)
Seat 2: Player#7783 ($15.49 in chips)
Seat 3: Player#1454 ($25.03 in chips)
Seat 4: Player#6275 ($42.34 in chips)
Seat 5: Player#8442 ($23.70 in chips)
Seat 6: warioman ($19.70 in chips)
Player#7783: posts small blind $0.10
Player#1454: posts big blind $0.20
*** HOLE CARDS ***
Dealt to warioman [Ac 2s]
warioman BB + Dead Small 0.3
Player#6275: folds
Player#8442: folds
warioman: checks
Player#5286: folds
Player#7783: calls $0.10
Player#1454: checks
*** FLOP *** [2h Ad 3c]
Player#7783: checks
Player#1454: checks
warioman: bets $0.60
Player#7783: folds
Player#1454: folds
warioman: doesn't show hand
Uncalled bet ($0.60) returned to warioman
warioman collected $0.38 from pot
*** SUMMARY ***
Total Pot $0.40 | Rake $0.02
Board [2h Ad 3c]
Seat 1: Player#5286 (button) folded before the flop
Seat 2: Player#7783 (small blind) folded on the flop
Seat 3: Player#1454 (big blind) folded on the flop
Seat 4: Player#6275 folded before the flop
Seat 5: Player#8442 folded before the flop
Seat 6: warioman

PokerStars Hand #64ded881-c4a1-4847-8535-deb5242b315a:  Hold'em No Limit ($0.1/$0.20 USD) - 2021/11/19 22:29:00 ET
Table 'Huntsville' 6-max Seat #5 is the button
Seat 1: Player#2931 ($32.07 in chips)
Seat 2: warioman ($20.18 in chips)
Seat 3: Player#7414 ($63.56 in chips)
Seat 4: Player#6697 ($46.95 in chips)
Seat 5: Player#7434 ($18.20 in chips)
Seat 6: Player#3081 ($6.63 in chips)
Player#3081: posts small blind $0.10
Player#2931: posts big blind $0.20
*** HOLE CARDS ***
Dealt to warioman [5c Jh]
warioman: folds
Player#7414: folds
Player#6697: raises $0.20 to $0.6
Player#7434: folds
Player#3081: calls $0.50
Player#2931: calls $0.40
*** FLOP *** [9h Tc Kd]
Player#3081: checks
Player#2931: checks
Player#6697: checks
*** TURN *** [9h Tc Kd] [Qs]
Player#3081: bets $0.90
Player#2931: calls $0.90
Player#6697: folds
*** RIVER *** [9h Tc Kd] [Qs] [3s]
Player#3081: checks
Player#2931: bets $2.70
Player#3081: folds
Player#2931: doesn't show hand
Uncalled bet ($2.70) returned to Player#2931
Player#2931 collected $3.42 from pot
*** SUMMARY ***
Total Pot $3.60 | Rake $0.18
Board [9h Tc Kd Qs 3s]
Seat 1: Player#2931 shows [] and won ($3.42) with 
Seat 2: warioman folded before the flop
Seat 3: Player#7414 folded before the flop
Seat 4: Player#6697 folded on the turn
Seat 5: Player#7434 (button) folded before the flop
Seat 6: Player#3081 (small blind) folded on the river

PokerStars Hand #d1c5b6b9-f524-4cfe-93f6-a9d54dfdf592:  Hold'em No Limit ($0.1/$0.20 USD) - 2021/11/19 22:29:00 ET
Table 'Huntsville' 6-max Seat #4 is the button
Seat 1: Player#8197 ($32.07 in chips)
Seat 2: warioman ($20.18 in chips)
Seat 3: Player#5784 ($63.56 in chips)
Seat 4: Player#9433 ($46.31 in chips)
Seat 5: Player#6102 ($18.30 in chips)
Seat 6: Player#1241 ($7.23 in chips)
Player#6102: posts small blind $0.10
Player#1241: posts big blind $0.20
*** HOLE CARDS ***
Dealt to warioman [6d 8d]
Player#8197: folds
warioman: folds
Player#5784: folds
Player#9433: raises $0.20 to $0.6
Player#6102: folds
Player#1241: calls $0.40
*** FLOP *** [2s 4s Kc]
Player#1241: checks
Player#9433: bets $0.65
Player#1241: folds
Player#9433: doesn't show hand
Uncalled bet ($0.65) returned to Player#9433
Player#9433 collected $1.24 from pot
*** SUMMARY ***
Total Pot $1.30 | Rake $0.07
Board [2s 4s Kc]
Seat 1: Player#8197 folded before the flop
Seat 2: warioman folded before the flop
Seat 3: Player#5784 folded before the flop
Seat 4: Player#9433 shows [] and won ($1.24) with 
Seat 5: Player#6102 (small blind) folded before the flop
Seat 6: Player#1241 (big blind) folded on the flop

PokerStars Hand #2ea12ddf-e091-4b9f-99d1-1146f83bcf2e:  Hold'em No Limit ($0.1/$0.20 USD) - 2021/11/19 22:28:00 ET
Table 'Bel Air' 6-max Seat #3 is the button
Seat 1: Player#0781 ($51.82 in chips)
Seat 2: Player#2631 ($20.64 in chips)
Seat 3: Player#7672 ($19.70 in chips)
Seat 4: Player#8980 ($42.44 in chips)
Seat 5: Player#8747 ($24.00 in chips)
Seat 6: warioman ($19.70 in chips)
Player#8980: posts small blind $0.10
Player#8747: posts big blind $0.20
*** HOLE CARDS ***
Dealt to warioman [2d 6s]
warioman: folds
Player#0781: folds
Player#2631: folds
Player#7672: raises $0.20 to $0.6
Player#8980: folds
Player#8747: folds
Player#7672: doesn't show hand
Uncalled bet ($0.60) returned to Player#7672
Player#7672 collected $0.30 from pot
*** SUMMARY ***
Total Pot $0.30 | Rake $0.00
Seat 1: Player#0781 folded before the flop
Seat 2: Player#2631 folded before the flop
Seat 3: Player#7672 shows [] and won ($0.30) with 
Seat 4: Player#8980 (small blind) folded before the flop
Seat 5: Player#8747 (big blind) folded before the flop
Seat 6: warioman folded before the flop

PokerStars Hand #77fd136e-1056-4983-bf9f-1382ff96ec5d:  Hold'em No Limit ($0.1/$0.20 USD) - 2021/11/19 22:28:00 ET
Table 'Bel Air' 6-max Seat #2 is the button
Seat 1: Player#5112 ($51.82 in chips)
Seat 2: Player#7320 ($20.00 in chips)
Seat 3: Player#9101 ($19.80 in chips)
Seat 4: Player#4059 ($43.04 in chips)
Seat 5: Player#7648 ($24.00 in chips)
Seat 6: warioman ($19.70 in chips)
Player#9101: posts small blind $0.10
Player#4059: posts big blind $0.20
*** HOLE CARDS ***
Dealt to warioman [2h 3h]
Player#7648: folds
warioman: folds
Player#5112: folds
Player#7320: raises $0.20 to $0.6
Player#9101: folds
Player#4059: calls $0.40
*** FLOP *** [7c 2c Ks]
Player#4059: checks
Player#7320: bets $0.65
Player#4059: folds
Player#7320: doesn't show hand
Uncalled bet ($0.65) returned to Player#7320
Player#7320 collected $1.24 from pot
*** SUMMARY ***
Total Pot $1.30 | Rake $0.07
Board [7c 2c Ks]
Seat 1: Player#5112 folded before the flop
Seat 2: Player#7320 shows [] and won ($1.24) with 
Seat 3: Player#9101 (small blind) folded before the flop
Seat 4: Player#4059 (big blind) folded on the flop
Seat 5: Player#7648 folded before the flop
Seat 6: warioman folded before the flop

PokerStars Hand #a035d64f-8abf-40a8-a670-49084611e0a4:  Hold'em No Limit ($0.1/$0.20 USD) - 2021/11/19 22:28:00 ET
Table 'Bel Air' 6-max Seat #1 is the button
Seat 1: Player#3156 ($51.82 in chips)
Seat 2: Player#3395 ($20.10 in chips)
Seat 3: Player#7042 ($20.00 in chips)
Seat 4: Player#7659 ($43.04 in chips)
Seat 5: Player#5512 ($23.70 in chips)
Seat 6: warioman ($19.70 in chips)
Player#3395: posts small blind $0.10
Player#7042: posts big blind $0.20
*** HOLE CARDS ***
Dealt to warioman [8s 6c]
Player#7659: folds
Player#5512: raises $0.20 to $0.6
warioman: folds
Player#3156: folds
Player#3395: folds
Player#7042: folds
Player#5512: doesn't show hand
Uncalled bet ($0.60) returned to Player#5512
Player#5512 collected $0.30 from pot
*** SUMMARY ***
Total Pot $0.30 | Rake $0.00
Seat 1: Player#3156 (button) folded before the flop
Seat 2: Player#3395 (small blind) folded before the flop
Seat 3: Player#7042 (big blind) folded before the flop
Seat 4: Player#7659 folded before the flop
Seat 5: Player#5512 shows [] and won ($0.30) with 
Seat 6: warioman folded before the flop

PokerStars Hand #b87c7ab3-39ae-46bc-b664-3249798902e8:  Hold'em No Limit ($0.1/$0.20 USD) - 2021/11/19 22:28:00 ET
Table 'Huntsville' 6-max Seat #3 is the button
Seat 1: Player#1394 ($32.07 in chips)
Seat 2: warioman ($20.18 in chips)
Seat 3: Player#5854 ($61.34 in chips)
Seat 4: Player#5881 ($46.92 in chips)
Seat 5: Player#8040 ($18.50 in chips)
Seat 6: Player#8174 ($8.84 in chips)
Player#5881: posts small blind $0.10
Player#8040: posts big blind $0.20
*** HOLE CARDS ***
Dealt to warioman [4s 3s]
Player#8174: calls $0.20
Player#1394: folds
warioman: folds
Player#5854: calls $0.20
Player#5881: calls $0.10
Player#8040: checks
*** FLOP *** [Ah 5c 8d]
Player#5881: bets $0.41
Player#8040: folds
Player#8174: calls $0.41
Player#5854: calls $0.41
*** TURN *** [Ah 5c 8d] [6c]
Player#5881: checks
Player#8174: checks
Player#5854: checks
*** RIVER *** [Ah 5c 8d] [6c] [2c]
Player#5881: checks
Player#8174: bets $1.00
Player#5854: calls $1.00
Player#5881: folds
*** SHOW DOWN *** 
Player#5854 collected $3.83 from pot
*** SUMMARY ***
Total Pot $4.03 | Rake $0.20
Board [Ah 5c 8d 6c 2c]
Seat 1: Player#1394 folded before the flop
Seat 2: warioman folded before the flop
Seat 3: Player#5854 shows [9h 9c] and won ($3.83) with 
Seat 4: Player#5881 (small blind) folded on the river
Seat 5: Player#8040 (big blind) folded on the flop
Seat 6: Player#8174 mucked

PokerStars Hand #b443f70d-f38b-4f69-a20b-6aa4314e5cca:  Hold'em No Limit ($0.1/$0.20 USD) - 2021/11/19 22:27:00 ET
Table 'Bel Air' 6-max Seat #2 is the button
Seat 1: Player#8428 ($51.92 in chips)
Seat 2: Player#8838 ($20.30 in chips)
Seat 3: Player#7469 ($20.00 in chips)
Seat 4: Player#0940 ($43.04 in chips)
Seat 5: Player#5545 ($23.40 in chips)
Seat 6: warioman ($19.70 in chips)
Player#7469: posts small blind $0.10
Player#8428: posts big blind $0.20
*** HOLE CARDS ***
Dealt to warioman [Jc Qh]
Player#7469 Waiting
Player#0940: folds
Player#5545: raises $0.20 to $0.6
warioman: folds
Player#8428: folds
Player#8838: folds
Player#5545: doesn't show hand
Uncalled bet ($0.60) returned to Player#5545
Player#5545 collected $0.30 from pot
*** SUMMARY ***
Total Pot $0.30 | Rake $0.00
Seat 1: Player#8428 (big blind) folded before the flop
Seat 2: Player#8838 (button) folded before the flop
Seat 3: Player#7469 (small blind) mucked
Seat 4: Player#0940 folded before the flop
Seat 5: Player#5545 shows [] and won ($0.30) with 
Seat 6: warioman folded before the flop

PokerStars Hand #d6efcf7d-e1c0-4071-b8fc-40376edaa5c4:  Hold'em No Limit ($0.1/$0.20 USD) - 2021/11/19 22:27:00 ET
Table 'Bel Air' 6-max Seat #2 is the button
Seat 1: Player#3928 ($52.12 in chips)
Seat 2: Player#7242 ($20.30 in chips)
Seat 3: Player#9552 ($20.00 in chips)
Seat 4: Player#9602 ($42.74 in chips)
Seat 5: Player#7777 ($23.40 in chips)
Seat 6: warioman ($19.80 in chips)
Player#9552: posts small blind $0.10
warioman: posts big blind $0.20
*** HOLE CARDS ***
Dealt to warioman [Js Ad]
Player#9552 Waiting
Player#7242: folds
Player#9602: raises $0.20 to $0.5
Player#7777: folds
warioman: folds
Player#3928: folds
Player#3928: doesn't show hand
Player#7242: doesn't show hand
Player#9602: doesn't show hand
Player#7777: doesn't show hand
warioman: doesn't show hand
Uncalled bet ($0.50) returned to Player#9602
Player#9602 collected $0.30 from pot
*** SUMMARY ***
Total Pot $0.30 | Rake $0.00
Seat 1: Player#3928 folded before the flop
Seat 2: Player#7242 (button) folded before the flop
Seat 3: Player#9552 (small blind) mucked
Seat 4: Player#9602 shows [] and won ($0.30) with 
Seat 5: Player#7777 folded before the flop
Seat 6: warioman (big blind) folded before the flop

PokerStars Hand #ccff5b43-f6f9-491a-8482-3a1e1d4d11be:  Hold'em No Limit ($0.1/$0.20 USD) - 2021/11/19 22:27:00 ET
Table 'Huntsville' 6-max Seat #2 is the button
Seat 1: Player#9690 ($32.07 in chips)
Seat 2: warioman ($20.18 in chips)
Seat 3: Player#1169 ($61.94 in chips)
Seat 4: Player#8331 ($45.81 in chips)
Seat 5: Player#8581 ($19.10 in chips)
Seat 6: Player#8537 ($8.84 in chips)
Player#1169: posts small blind $0.10
Player#8331: posts big blind $0.20
*** HOLE CARDS ***
Dealt to warioman [Qd 6h]
Player#8581: raises $0.20 to $0.6
Player#8537: folds
Player#9690: folds
warioman: folds
Player#1169: calls $0.50
Player#8331: calls $0.40
*** FLOP *** [7h 2s Js]
Player#1169: checks
Player#8331: checks
Player#8581: checks
*** TURN *** [7h 2s Js] [5c]
Player#1169: checks
Player#8331: bets $1.35
Player#8581: folds
Player#1169: folds
Player#8331: doesn't show hand
Uncalled bet ($1.35) returned to Player#8331
Player#8331 collected $1.71 from pot
*** SUMMARY ***
Total Pot $1.80 | Rake $0.09
Board [7h 2s Js 5c]
Seat 1: Player#9690 folded before the flop
Seat 2: warioman (button) folded before the flop
Seat 3: Player#1169 (small blind) folded on the turn
Seat 4: Player#8331 shows [] and won ($1.71) with 
Seat 5: Player#8581 folded on the turn
Seat 6: Player#8537 folded before the flop

PokerStars Hand #df6e816e-383d-4170-99e1-17e930144d89:  Hold'em No Limit ($0.1/$0.20 USD) - 2021/11/19 22:26:00 ET
Table 'Bel Air' 6-max Seat #2 is the button
Seat 1: Player#4233 ($52.12 in chips)
Seat 2: Player#9161 ($20.30 in chips)
Seat 3: Player#6053 ($20.00 in chips)
Seat 4: Player#9723 ($46.64 in chips)
Seat 5: Player#2649 ($19.70 in chips)
Seat 6: warioman ($20.00 in chips)
Player#6053: posts small blind $0.10
Player#2649: posts big blind $0.20
*** HOLE CARDS ***
Dealt to warioman [6s 9c]
Player#6053 Waiting
Player#4233: folds
Player#9161: folds
Player#9723: raises $0.20 to $0.5
Player#2649: raises $0.50 to $1.5
warioman: folds
Player#9723: calls $1.00
*** FLOP *** [Qc Ad Jd]
Player#2649: bets $2.40
Player#9723: calls $2.40
*** TURN *** [Qc Ad Jd] [Td]
Player#2649: bets $6.00
Player#9723: folds
Player#2649: doesn't show hand
Uncalled bet ($6.00) returned to Player#2649
Player#2649 collected $7.60 from pot
*** SUMMARY ***
Total Pot $8.00 | Rake $0.40
Board [Qc Ad Jd Td]
Seat 1: Player#4233 folded before the flop
Seat 2: Player#9161 (button) folded before the flop
Seat 3: Player#6053 (small blind) mucked
Seat 4: Player#9723 folded on the turn
Seat 5: Player#2649 shows [] and won ($7.60) with 
Seat 6: warioman folded before the flop

PokerStars Hand #22071f2d-8659-445d-9d63-2da58c075603:  Hold'em No Limit ($0.1/$0.20 USD) - 2021/11/19 22:26:00 ET
Table 'Bel Air' 6-max Seat #3 is the button
Seat 1: Player#0829 ($52.12 in chips)
Seat 2: Player#3673 ($20.30 in chips)
Seat 3: Player#8012 ($20.00 in chips)
Seat 4: Player#4729 ($46.44 in chips)
Seat 5: Player#4877 ($19.90 in chips)
Seat 6: warioman ($20.00 in chips)
Player#4729: posts small blind $0.10
Player#4877: posts big blind $0.20
*** HOLE CARDS ***
Dealt to warioman [6h 7h]
warioman: folds
Player#0829: folds
Player#3673: folds
Player#4729: raises $0.20 to $0.6
Player#4877: folds
Player#0829: doesn't show hand
Player#3673: doesn't show hand
Player#4729: doesn't show hand
Player#4877: doesn't show hand
warioman: doesn't show hand
Uncalled bet ($0.60) returned to Player#4729
Player#4729 collected $0.20 from pot
*** SUMMARY ***
Total Pot $0.20 | Rake $0.00
Seat 1: Player#0829 folded before the flop
Seat 2: Player#3673 folded before the flop
Seat 3: Player#8012 (button) mucked
Seat 4: Player#4729 shows [] and won ($0.20) with 
Seat 5: Player#4877 (big blind) folded before the flop
Seat 6: warioman folded before the flop

PokerStars Hand #6ffe6774-50f4-4ab5-b6c6-c484ea7b6ba1:  Hold'em No Limit ($0.1/$0.20 USD) - 2021/11/19 22:26:00 ET
Table 'Huntsville' 6-max Seat #1 is the button
Seat 1: Player#8173 ($32.07 in chips)
Seat 2: warioman ($20.00 in chips)
Seat 3: Player#6244 ($62.14 in chips)
Seat 4: Player#5308 ($45.81 in chips)
Seat 5: Player#2464 ($19.10 in chips)
Seat 6: Player#7746 ($8.84 in chips)
warioman: posts small blind $0.10
Player#6244: posts big blind $0.20
*** HOLE CARDS ***
Dealt to warioman [9h Ac]
Player#5308: folds
Player#2464: folds
Player#7746: folds
Player#8173: folds
warioman: calls $0.10
Player#6244: checks
*** FLOP *** [6h Kh Ks]
warioman: checks
Player#6244: checks
*** TURN *** [6h Kh Ks] [3s]
warioman: checks
Player#6244: checks
*** RIVER *** [6h Kh Ks] [3s] [7s]
warioman: checks
Player#6244: checks
*** SHOW DOWN *** 
warioman collected $0.38 from pot
*** SUMMARY ***
Total Pot $0.40 | Rake $0.02
Board [6h Kh Ks 3s 7s]
Seat 1: Player#8173 (button) folded before the flop
Seat 2: warioman (small blind)
Seat 3: Player#6244 (big blind) mucked
Seat 4: Player#5308 folded before the flop
Seat 5: Player#2464 folded before the flop
Seat 6: Player#7746 folded before the flop

PokerStars Hand #8c0076e3-70ec-42f9-a972-d17a31ae291d:  Hold'em No Limit ($0.1/$0.20 USD) - 2021/11/19 22:25:00 ET
Table 'Bel Air' 6-max Seat #1 is the button
Seat 1: Player#9398 ($52.12 in chips)
Seat 2: Player#0450 ($20.10 in chips)
Seat 3: Player#7205 ($46.64 in chips)
Seat 4: Player#2101 ($19.90 in chips)
Seat 5: warioman ($20.00 in chips)
Player#0450: posts small blind $0.10
Player#7205: posts big blind $0.20
*** HOLE CARDS ***
Dealt to warioman [9h Ad]
Player#2101: folds
warioman: folds
Player#9398: folds
Player#0450: raises $0.20 to $0.6
Player#7205: folds
Player#9398: doesn't show hand
Player#0450: doesn't show hand
Player#7205: doesn't show hand
Player#2101: doesn't show hand
warioman: doesn't show hand
Uncalled bet ($0.60) returned to Player#0450
Player#0450 collected $0.20 from pot
*** SUMMARY ***
Total Pot $0.20 | Rake $0.00
Seat 1: Player#9398 (button) folded before the flop
Seat 2: Player#0450 shows [] and won ($0.20) with 
Seat 3: Player#7205 (big blind) folded before the flop
Seat 4: Player#2101 folded before the flop
Seat 5: warioman folded before the flop

PokerStars Hand #b1534653-1726-488f-a3dc-77e5d060a328:  Hold'em No Limit ($0.1/$0.20 USD) - 2021/11/19 22:25:00 ET
Table 'Bel Air' 6-max Seat #6 is the button
Seat 1: Player#5239 ($52.22 in chips)
Seat 2: Player#1671 ($20.00 in chips)
Seat 3: Player#2288 ($46.64 in chips)
Seat 4: Player#2301 ($19.90 in chips)
Seat 5: warioman ($20.00 in chips)
Player#5239: posts small blind $0.10
Player#1671: posts big blind $0.20
*** HOLE CARDS ***
Dealt to warioman [9d 4s]
Player#2288: folds
Player#2301: folds
warioman: folds
Player#5239: folds
Player#1671 collected $0.20 from pot
*** SUMMARY ***
Total Pot $0.20 | Rake $0.00
Seat 1: Player#5239 (small blind) folded before the flop
Seat 2: Player#1671 shows [] and won ($0.20) with 
Seat 3: Player#2288 folded before the flop
Seat 4: Player#2301 folded before the flop
Seat 5: warioman folded before the flop

PokerStars Hand #369472a9-fc75-4f9f-ad60-21326041cfa1:  Hold'em No Limit ($0.1/$0.20 USD) - 2021/11/19 22:25:00 ET
Table 'Bel Air' 6-max Seat #1 is the button
Seat 1: Player#5046 ($52.12 in chips)
Seat 2: Player#0408 ($20.00 in chips)
Seat 3: Player#4867 ($46.64 in chips)
Seat 4: Player#6718 ($19.90 in chips)
Seat 5: warioman ($20.10 in chips)
Player#0408: posts small blind $0.10
warioman: posts big blind $0.20
*** HOLE CARDS ***
Dealt to warioman [Qs 5d]
Player#0408 Waiting
Player#4867: folds
Player#6718: folds
warioman: folds
Player#5046 collected $0.20 from pot
*** SUMMARY ***
Total Pot $0.20 | Rake $0.00
Seat 1: Player#5046 shows [] and won ($0.20) with 
Seat 2: Player#0408 (small blind) mucked
Seat 3: Player#4867 folded before the flop
Seat 4: Player#6718 folded before the flop
Seat 5: warioman (big blind) folded before the flop

PokerStars Hand #24ea5c5e-52b7-41dd-9988-c66bdb9c249f:  Hold'em No Limit ($0.1/$0.20 USD) - 2021/11/19 22:25:00 ET
Table 'Huntsville' 6-max Seat #6 is the button
Seat 1: Player#0460 ($32.17 in chips)
Seat 2: warioman ($19.70 in chips)
Seat 3: Player#4566 ($62.14 in chips)
Seat 4: Player#2518 ($46.41 in chips)
Seat 5: Player#5466 ($19.70 in chips)
Seat 6: Player#6192 ($4.00 in chips)
Player#0460: posts small blind $0.10
warioman: posts big blind $0.20
*** HOLE CARDS ***
Dealt to warioman [Qs Qh]
Player#4566: folds
Player#2518: raises $0.20 to $0.6
Player#5466: calls $0.60
Player#6192: raises $0.60 to $1.2
Player#0460: folds
warioman: raises $1.20 to $4.9
Player#2518: folds
Player#5466: folds
Player#6192: calls $2.80
warioman Showing Pocket Cards QQ
Player#6192 Showing Pocket Cards AK
*** FLOP *** [Ts 2h Kd]
*** TURN *** [Ts 2h Kd] [Jh]
*** RIVER *** [Ts 2h Kd] [Jh] [6h]
Player#6192 collected $9.69 from pot
*** SUMMARY ***
Total Pot $10.20 | Rake $0.51
Board [Ts 2h Kd Jh 6h]
Seat 1: Player#0460 (small blind) folded before the flop
Seat 2: warioman (big blind)
Seat 3: Player#4566 folded before the flop
Seat 4: Player#2518 folded before the flop
Seat 5: Player#5466 folded before the flop
Seat 6: Player#6192 shows [Ad Ks] and won ($9.69) with 

PokerStars Hand #9ae1a999-ed29-4dca-a9c9-ef4f8e84c643:  Hold'em No Limit ($0.1/$0.20 USD) - 2021/11/19 22:25:00 ET
Table 'Bel Air' 6-max Seat #1 is the button
Seat 1: Player#5572 ($52.12 in chips)
Seat 2: Player#0594 ($20.00 in chips)
Seat 3: Player#9575 ($46.64 in chips)
Seat 4: Player#7239 ($20.00 in chips)
Seat 5: warioman ($20.00 in chips)
Player#0594: posts small blind $0.10
Player#7239: posts big blind $0.20
*** HOLE CARDS ***
Dealt to warioman [7h 3c]
Player#0594 Waiting
Player#5572: folds
Player#9575: folds
Player#7239: folds
warioman collected $0.20 from pot
*** SUMMARY ***
Total Pot $0.20 | Rake $0.00
Seat 1: Player#5572 (button) folded before the flop
Seat 2: Player#0594 (small blind) mucked
Seat 3: Player#9575 folded before the flop
Seat 4: Player#7239 (big blind) folded before the flop
Seat 5: warioman

PokerStars Hand #b37b164b-5ac5-49f2-9b33-4192432c7737:  Hold'em No Limit ($0.1/$0.20 USD) - 2021/11/19 22:25:00 ET
Table 'Huntsville' 6-max Seat #5 is the button
Seat 1: Player#5835 ($32.37 in chips)
Seat 2: warioman ($19.70 in chips)
Seat 3: Player#6431 ($62.14 in chips)
Seat 4: Player#7708 ($46.41 in chips)
Seat 5: Player#4247 ($19.70 in chips)
Seat 6: Player#8492 ($3.82 in chips)
Player#8492: posts small blind $0.10
Player#5835: posts big blind $0.20
*** HOLE CARDS ***
Dealt to warioman [4c 9s]
warioman: folds
Player#6431: folds
Player#7708: folds
Player#4247: folds
Player#8492: calls $0.10
Player#5835: checks
*** FLOP *** [6h Ts Kc]
Player#8492: bets $0.20
Player#5835: folds
Player#8492: doesn't show hand
Uncalled bet ($0.20) returned to Player#8492
Player#8492 collected $0.38 from pot
*** SUMMARY ***
Total Pot $0.40 | Rake $0.02
Board [6h Ts Kc]
Seat 1: Player#5835 (big blind) folded on the flop
Seat 2: warioman folded before the flop
Seat 3: Player#6431 folded before the flop
Seat 4: Player#7708 folded before the flop
Seat 5: Player#4247 (button) folded before the flop
Seat 6: Player#8492 shows [] and won ($0.38) with 

PokerStars Hand #f8aa2be2-16cc-4657-a26f-9d8b21ea2ea3:  Hold'em No Limit ($0.1/$0.20 USD) - 2021/11/19 22:24:00 ET
Table 'Bel Air' 6-max Seat #2 is the button
Seat 1: Player#1096 ($42.14 in chips)
Seat 2: Player#8677 ($10.77 in chips)
Seat 3: Player#8919 ($46.74 in chips)
Seat 4: Player#6341 ($19.08 in chips)
Seat 5: warioman ($20.00 in chips)
Player#8919: posts small blind $0.10
Player#6341: posts big blind $0.20
*** HOLE CARDS ***
Dealt to warioman [2h 8h]
warioman: folds
Player#1096: calls $0.20
Player#8677: raises $0.20 to $0.4
Player#8919: folds
Player#6341: folds
Player#1096: raises $0.40 to $2.5
Player#8677: raises $ 12.50 to $10.77
Player#1096: calls $8.27
Player#1096 Showing Pocket Cards KK
Player#8677 Showing Pocket Cards QA
*** FLOP *** [4s Td 8h]
*** TURN *** [4s Td 8h] [Td]
*** RIVER *** [4s Td 8h] [Td] [5h]
Player#1096 collected $20.75 from pot
*** SUMMARY ***
Total Pot $21.84 | Rake $1.09
Board [4s Td 8h Td 5h]
Seat 1: Player#1096 shows [Ks Kd] and won ($20.75) with 
Seat 2: Player#8677 (button) mucked
Seat 3: Player#8919 (small blind) folded before the flop
Seat 4: Player#6341 (big blind) folded before the flop
Seat 5: warioman folded before the flop

PokerStars Hand #3157a1de-1b74-4f9c-be1d-55bb3ec85986:  Hold'em No Limit ($0.1/$0.20 USD) - 2021/11/19 22:24:00 ET
Table 'Huntsville' 6-max Seat #4 is the button
Seat 1: Player#9032 ($32.37 in chips)
Seat 2: warioman ($19.70 in chips)
Seat 3: Player#5478 ($61.32 in chips)
Seat 4: Player#0661 ($46.41 in chips)
Seat 5: Player#8877 ($19.80 in chips)
Seat 6: Player#9395 ($4.62 in chips)
Player#8877: posts small blind $0.10
Player#9395: posts big blind $0.20
*** HOLE CARDS ***
Dealt to warioman [7h Th]
Player#9032: folds
warioman: folds
Player#5478: calls $0.20
Player#0661: folds
Player#8877: folds
Player#9395: checks
*** FLOP *** [3c 8s 3d]
Player#9395: checks
Player#5478: checks
*** TURN *** [3c 8s 3d] [Ks]
Player#9395: bets $0.60
Player#5478: raises $0.60 to $1.2
Player#9395: folds
Player#5478: doesn't show hand
Uncalled bet ($1.20) returned to Player#5478
Player#5478 collected $1.04 from pot
*** SUMMARY ***
Total Pot $1.10 | Rake $0.05
Board [3c 8s 3d Ks]
Seat 1: Player#9032 folded before the flop
Seat 2: warioman folded before the flop
Seat 3: Player#5478 shows [] and won ($1.04) with 
Seat 4: Player#0661 (button) folded before the flop
Seat 5: Player#8877 (small blind) folded before the flop
Seat 6: Player#9395 (big blind) folded on the turn

PokerStars Hand #22c7f3e2-879e-4b4d-b4d4-4d49fdb880c0:  Hold'em No Limit ($0.1/$0.20 USD) - 2021/11/19 22:23:00 ET
Table 'Bel Air' 6-max Seat #2 is the button
Seat 1: Player#9595 ($36.21 in chips)
Seat 2: Player#9907 ($18.77 in chips)
Seat 3: Player#7769 ($10.87 in chips)
Seat 4: Player#7859 ($46.94 in chips)
Seat 5: Player#0814 ($19.08 in chips)
Seat 6: warioman ($22.07 in chips)
Player#7769: posts small blind $0.10
Player#7859: posts big blind $0.20
*** HOLE CARDS ***
Dealt to warioman [Kc Qc]
Player#0814: folds
warioman: raises $0.20 to $0.5
Player#9595: calls $0.50
Player#9907: folds
Player#7769: folds
Player#7859: folds
*** FLOP *** [7h 3h 4c]
warioman: checks
Player#9595: bets $0.60
warioman: raises0.60 to $2
Player#9595: calls $1.40
*** TURN *** [7h 3h 4c] [Jc]
warioman: bets $3.77
Player#9595: calls $3.77
*** RIVER *** [7h 3h 4c] [Jc] [Ac]
warioman: checks
Player#9595: checks
*** SHOW DOWN *** 
Player#9595 collected $12.20 from pot
*** SUMMARY ***
Total Pot $12.84 | Rake $0.64
Board [7h 3h 4c Jc Ac]
Seat 1: Player#9595 shows [2c Ac] and won ($12.20) with 
Seat 2: Player#9907 (button) folded before the flop
Seat 3: Player#7769 (small blind) folded before the flop
Seat 4: Player#7859 (big blind) folded before the flop
Seat 5: Player#0814 folded before the flop
Seat 6: warioman

PokerStars Hand #8482efdc-7b33-4148-b2f5-f5b49d3d7313:  Hold'em No Limit ($0.1/$0.20 USD) - 2021/11/19 22:23:00 ET
Table 'Huntsville' 6-max Seat #3 is the button
Seat 1: Player#8446 ($34.77 in chips)
Seat 2: warioman ($19.70 in chips)
Seat 3: Player#9937 ($58.11 in chips)
Seat 4: Player#4750 ($46.51 in chips)
Seat 5: Player#5698 ($20.00 in chips)
Seat 6: Player#3261 ($5.42 in chips)
Player#4750: posts small blind $0.10
Player#5698: posts big blind $0.20
*** HOLE CARDS ***
Dealt to warioman [5d Js]
Player#3261: calls $0.20
Player#8446: raises $0.20 to $0.8
warioman: folds
Player#9937: calls $0.80
Player#4750: folds
Player#5698: folds
Player#3261: calls $0.60
*** FLOP *** [7h Th Jd]
Player#3261: checks
Player#8446: bets $1.60
Player#9937: calls $1.60
Player#3261: folds
*** TURN *** [7h Th Jd] [Qd]
Player#8446: checks
Player#9937: bets $5.90
Player#8446: folds
Player#9937: doesn't show hand
Uncalled bet ($5.90) returned to Player#9937
Player#9937 collected $5.61 from pot
*** SUMMARY ***
Total Pot $5.90 | Rake $0.30
Board [7h Th Jd Qd]
Seat 1: Player#8446 folded on the turn
Seat 2: warioman folded before the flop
Seat 3: Player#9937 shows [] and won ($5.61) with 
Seat 4: Player#4750 (small blind) folded before the flop
Seat 5: Player#5698 (big blind) folded before the flop
Seat 6: Player#3261 folded on the flop

PokerStars Hand #ab804803-f395-4c30-862c-aebfe48dc547:  Hold'em No Limit ($0.1/$0.20 USD) - 2021/11/19 22:23:00 ET
Table 'Huntsville' 6-max Seat #4 is the button
Seat 1: Player#9069 ($34.77 in chips)
Seat 2: warioman ($19.70 in chips)
Seat 3: Player#1440 ($57.20 in chips)
Seat 4: Player#4717 ($46.71 in chips)
Seat 5: Player#7315 ($20.00 in chips)
Seat 6: Player#4344 ($6.22 in chips)
Player#7315: posts small blind $0.10
Player#1440: posts big blind $0.20
*** HOLE CARDS ***
Dealt to warioman [3s 7h]
Player#7315 Waiting
Player#4344: calls $0.20
Player#9069: folds
warioman: folds
Player#1440: raises $0.20 to $0.8
Player#4717: folds
Player#4344: calls $0.60
*** FLOP *** [4d Jh 5d]
Player#1440: bets $1.80
Player#4344: folds
Player#1440: doesn't show hand
Uncalled bet ($1.80) returned to Player#1440
Player#1440 collected $1.71 from pot
*** SUMMARY ***
Total Pot $1.80 | Rake $0.09
Board [4d Jh 5d]
Seat 1: Player#9069 folded before the flop
Seat 2: warioman folded before the flop
Seat 3: Player#1440 shows [] and won ($1.71) with 
Seat 4: Player#4717 (button) folded before the flop
Seat 5: Player#7315 (small blind) mucked
Seat 6: Player#4344 folded on the flop

PokerStars Hand #ae2da838-029b-4ca9-b52a-cccb9d25e0d2:  Hold'em No Limit ($0.1/$0.20 USD) - 2021/11/19 22:23:00 ET
Table 'Bel Air' 6-max Seat #1 is the button
Seat 1: Player#7962 ($36.21 in chips)
Seat 2: Player#9042 ($17.14 in chips)
Seat 3: Player#1728 ($11.07 in chips)
Seat 4: Player#5415 ($46.94 in chips)
Seat 5: Player#4967 ($20.68 in chips)
Seat 6: warioman ($22.07 in chips)
Player#9042: posts small blind $0.10
Player#1728: posts big blind $0.20
*** HOLE CARDS ***
Dealt to warioman [2d 4c]
Player#5415: folds
Player#4967: raises $0.20 to $0.6
warioman: folds
Player#7962: folds
Player#9042: calls $0.50
Player#1728: folds
*** FLOP *** [9d 2c Qc]
Player#9042: checks
Player#4967: bets $1.00
Player#9042: calls $1.00
*** TURN *** [9d 2c Qc] [Kh]
Player#9042: checks
Player#4967: checks
*** RIVER *** [9d 2c Qc] [Kh] [5h]
Player#9042: bets $1.00
Player#4967: folds
Player#9042: doesn't show hand
Uncalled bet ($1.00) returned to Player#9042
Player#9042 collected $3.23 from pot
*** SUMMARY ***
Total Pot $3.40 | Rake $0.17
Board [9d 2c Qc Kh 5h]
Seat 1: Player#7962 (button) folded before the flop
Seat 2: Player#9042 shows [] and won ($3.23) with 
Seat 3: Player#1728 (big blind) folded before the flop
Seat 4: Player#5415 folded before the flop
Seat 5: Player#4967 folded on the river
Seat 6: warioman folded before the flop

PokerStars Hand #e5f5e270-9ffc-424e-b502-9ce62e99fe5a:  Hold'em No Limit ($0.1/$0.20 USD) - 2021/11/19 22:23:00 ET
Table 'Bel Air' 6-max Seat #6 is the button
Seat 1: Player#5756 ($36.31 in chips)
Seat 2: Player#3290 ($17.04 in chips)
Seat 3: Player#6867 ($11.07 in chips)
Seat 4: Player#8567 ($46.94 in chips)
Seat 5: Player#6246 ($20.68 in chips)
Seat 6: warioman ($22.07 in chips)
Player#5756: posts small blind $0.10
Player#3290: posts big blind $0.20
*** HOLE CARDS ***
Dealt to warioman [8d 9c]
Player#6867: folds
Player#8567: folds
Player#6246: folds
warioman: folds
Player#5756: folds
Player#3290 collected $0.20 from pot
*** SUMMARY ***
Total Pot $0.20 | Rake $0.00
Seat 1: Player#5756 (small blind) folded before the flop
Seat 2: Player#3290 shows [] and won ($0.20) with 
Seat 3: Player#6867 folded before the flop
Seat 4: Player#8567 folded before the flop
Seat 5: Player#6246 folded before the flop
Seat 6: warioman (button) folded before the flop

PokerStars Hand #8e27fe29-ea59-48ee-8912-80758ac8bbd3:  Hold'em No Limit ($0.1/$0.20 USD) - 2021/11/19 22:22:00 ET
Table 'Huntsville' 6-max Seat #1 is the button
Seat 1: Player#1332 ($33.76 in chips)
Seat 2: warioman ($19.80 in chips)
Seat 3: Player#4097 ($58.00 in chips)
Seat 4: Player#2714 ($46.71 in chips)
Seat 5: Player#7927 ($6.42 in chips)
warioman: posts small blind $0.10
Player#4097: posts big blind $0.20
*** HOLE CARDS ***
Dealt to warioman [8h 4c]
Player#2714: folds
Player#7927: calls $0.20
Player#1332: raises $0.20 to $0.8
warioman: folds
Player#4097: calls $0.60
Player#7927: folds
*** FLOP *** [Qs 6d 7c]
Player#4097: checks
Player#1332: bets $1.20
Player#4097: folds
Player#1332: doesn't show hand
Uncalled bet ($1.20) returned to Player#1332
Player#1332 collected $1.81 from pot
*** SUMMARY ***
Total Pot $1.90 | Rake $0.10
Board [Qs 6d 7c]
Seat 1: Player#1332 shows [] and won ($1.81) with 
Seat 2: warioman (small blind) folded before the flop
Seat 3: Player#4097 (big blind) folded on the flop
Seat 4: Player#2714 folded before the flop
Seat 5: Player#7927 folded before the flop

PokerStars Hand #31560cd4-5a41-4c14-a35e-5e871ad4a52d:  Hold'em No Limit ($0.1/$0.20 USD) - 2021/11/19 22:22:00 ET
Table 'Bel Air' 6-max Seat #5 is the button
Seat 1: Player#6312 ($36.51 in chips)
Seat 2: Player#9075 ($17.04 in chips)
Seat 3: Player#0650 ($11.07 in chips)
Seat 4: Player#1564 ($46.94 in chips)
Seat 5: Player#4294 ($20.68 in chips)
Seat 6: warioman ($21.89 in chips)
warioman: posts small blind $0.10
Player#6312: posts big blind $0.20
*** HOLE CARDS ***
Dealt to warioman [Qs 7c]
Player#9075: folds
Player#0650: folds
Player#1564: folds
Player#4294: folds
warioman: calls $0.10
Player#6312: checks
*** FLOP *** [Qd 2s Ts]
warioman: bets $0.20
Player#6312: folds
warioman: doesn't show hand
Uncalled bet ($0.20) returned to warioman
warioman collected $0.38 from pot
*** SUMMARY ***
Total Pot $0.40 | Rake $0.02
Board [Qd 2s Ts]
Seat 1: Player#6312 (big blind) folded on the flop
Seat 2: Player#9075 folded before the flop
Seat 3: Player#0650 folded before the flop
Seat 4: Player#1564 folded before the flop
Seat 5: Player#4294 (button) folded before the flop
Seat 6: warioman (small blind)

PokerStars Hand #4fa9a19a-7bf9-499b-89bb-e1148d659d42:  Hold'em No Limit ($0.1/$0.20 USD) - 2021/11/19 22:22:00 ET
Table 'Huntsville' 6-max Seat #6 is the button
Seat 1: Player#3704 ($33.56 in chips)
Seat 2: warioman ($20.00 in chips)
Seat 3: Player#9909 ($58.00 in chips)
Seat 4: Player#7166 ($46.71 in chips)
Seat 5: Player#1769 ($0.35 in chips)
Seat 6: Player#0382 ($6.42 in chips)
Player#3704: posts small blind $0.10
warioman: posts big blind $0.20
*** HOLE CARDS ***
Dealt to warioman [Qs 2h]
Player#9909: folds
Player#7166: folds
Player#1769: folds
Player#0382: folds
Player#3704: raises $0.20 to $0.6
warioman: folds
Player#3704: doesn't show hand
Uncalled bet ($0.60) returned to Player#3704
Player#3704 collected $0.20 from pot
*** SUMMARY ***
Total Pot $0.20 | Rake $0.00
Seat 1: Player#3704 shows [] and won ($0.20) with 
Seat 2: warioman (big blind) folded before the flop
Seat 3: Player#9909 folded before the flop
Seat 4: Player#7166 folded before the flop
Seat 5: Player#1769 folded before the flop
Seat 6: Player#0382 (button) folded before the flop

PokerStars Hand #f2653178-0afb-4d6f-a0bb-56b06f6ae86e:  Hold'em No Limit ($0.1/$0.20 USD) - 2021/11/19 22:22:00 ET
Table 'Bel Air' 6-max Seat #3 is the button
Seat 1: Player#9510 ($15.49 in chips)
Seat 2: Player#4274 ($12.47 in chips)
Seat 3: Player#9554 ($46.94 in chips)
Seat 4: Player#4360 ($20.78 in chips)
Seat 5: warioman ($22.09 in chips)
Player#4360: posts small blind $0.10
warioman: posts big blind $0.20
*** HOLE CARDS ***
Dealt to warioman [8c 3d]
Player#9510: calls $0.20
Player#4274: raises $0.20 to $0.6
Player#9554: folds
Player#4360: folds
warioman: folds
Player#9510: calls $0.40
*** FLOP *** [2h 9h 3c]
Player#9510: checks
Player#4274: bets $0.80
Player#9510: calls $0.80
*** TURN *** [2h 9h 3c] [Th]
Player#9510: checks
Player#4274: checks
*** RIVER *** [2h 9h 3c] [Th] [7h]
Player#9510: bets $1.40
Player#4274: folds
Player#9510 Show
*** SHOW DOWN *** 
Uncalled bet ($1.40) returned to Player#9510
Player#9510 collected $2.95 from pot
*** SUMMARY ***
Total Pot $3.10 | Rake $0.16
Board [2h 9h 3c Th 7h]
Seat 1: Player#9510 shows [Td Ts] and won ($2.95) with 
Seat 2: Player#4274 folded on the river
Seat 3: Player#9554 (button) folded before the flop
Seat 4: Player#4360 (small blind) folded before the flop
Seat 5: warioman (big blind) folded before the flop

PokerStars Hand #c016b9af-b384-4dd0-b450-0902276eb002:  Hold'em No Limit ($0.1/$0.20 USD) - 2021/11/19 22:21:00 ET
Table 'Huntsville' 6-max Seat #5 is the button
Seat 1: Player#6399 ($43.66 in chips)
Seat 2: warioman ($20.00 in chips)
Seat 3: Player#4447 ($58.00 in chips)
Seat 4: Player#4900 ($27.93 in chips)
Seat 5: Player#7786 ($10.45 in chips)
Seat 6: Player#6486 ($6.52 in chips)
Player#6486: posts small blind $0.10
Player#6399: posts big blind $0.20
*** HOLE CARDS ***
Dealt to warioman [3d 4c]
warioman: folds
Player#4447: folds
Player#4900: raises $0.20 to $0.6
Player#7786: calls $0.60
Player#6486: folds
Player#6399: calls $0.40
*** FLOP *** [9c 3s 6s]
Player#6399: checks
Player#4900: checks
Player#7786: bets $1.90
Player#6399: calls $1.90
Player#4900: calls $1.90
*** TURN *** [9c 3s 6s] [Ts]
Player#6399: checks
Player#4900: checks
Player#7786: checks
*** RIVER *** [9c 3s 6s] [Ts] [4s]
Player#6399: checks
Player#4900: bets $7.60
Player#7786: calls $7.60
Player#6399: calls $7.60
*** SHOW DOWN *** 
Player#7786: doesn't show hand
Player#6399: doesn't show hand
Player#4900 collected $28.90 from pot
*** SUMMARY ***
Total Pot $30.40 | Rake $1.50
Board [9c 3s 6s Ts 4s]
Seat 1: Player#6399 (big blind) mucked
Seat 2: warioman folded before the flop
Seat 3: Player#4447 folded before the flop
Seat 4: Player#4900 shows [Ks 5s] and won ($28.90) with 
Seat 5: Player#7786 (button) mucked
Seat 6: Player#6486 (small blind) folded before the flop

PokerStars Hand #61ca2c71-d819-4ad7-b65e-23a37ee532d9:  Hold'em No Limit ($0.1/$0.20 USD) - 2021/11/19 22:21:00 ET
Table 'Bel Air' 6-max Seat #3 is the button
Seat 1: Player#8138 ($36.51 in chips)
Seat 2: Player#7531 ($14.84 in chips)
Seat 3: Player#8289 ($12.87 in chips)
Seat 4: Player#4409 ($47.04 in chips)
Seat 5: Player#8733 ($20.98 in chips)
Seat 6: warioman ($22.09 in chips)
Player#4409: posts small blind $0.10
Player#8733: posts big blind $0.20
*** HOLE CARDS ***
Dealt to warioman [Ts 5d]
warioman: folds
Player#8138: folds
Player#7531: raises $0.20 to $0.4
Player#8289: calls $0.40
Player#4409: folds
Player#8733: folds
*** FLOP *** [8h 4s 3d]
Player#7531: checks
Player#8289: checks
*** TURN *** [8h 4s 3d] [5c]
Player#7531: checks
Player#8289: checks
*** RIVER *** [8h 4s 3d] [5c] [8c]
Player#7531: checks
Player#8289: checks
*** SHOW DOWN *** 
Player#7531 collected $1.05 from pot
*** SUMMARY ***
Total Pot $1.10 | Rake $0.06
Board [8h 4s 3d 5c 8c]
Seat 1: Player#8138 folded before the flop
Seat 2: Player#7531 shows [Kh Td] and won ($1.05) with 
Seat 3: Player#8289 (button) mucked
Seat 4: Player#4409 (small blind) folded before the flop
Seat 5: Player#8733 (big blind) folded before the flop
Seat 6: warioman folded before the flop

PokerStars Hand #f0dcc277-197b-48b3-8ed7-d0fa84b7a2ad:  Hold'em No Limit ($0.1/$0.20 USD) - 2021/11/19 22:20:00 ET
Table 'Huntsville' 6-max Seat #4 is the button
Seat 1: Player#9641 ($43.66 in chips)
Seat 2: warioman ($20.00 in chips)
Seat 3: Player#3936 ($58.20 in chips)
Seat 4: Player#6462 ($28.93 in chips)
Seat 5: Player#1142 ($10.65 in chips)
Seat 6: Player#5583 ($5.24 in chips)
Player#1142: posts small blind $0.10
Player#5583: posts big blind $0.20
*** HOLE CARDS ***
Dealt to warioman [5s Js]
Player#9641: folds
warioman: folds
Player#3936: calls $0.20
Player#6462: calls $0.20
Player#1142: calls $0.10
Player#5583: checks
*** FLOP *** [4c 2c 6s]
Player#1142: checks
Player#5583: checks
Player#3936: checks
Player#6462: checks
*** TURN *** [4c 2c 6s] [9h]
Player#1142: checks
Player#5583: bets $0.80
Player#3936: folds
Player#6462: calls $0.80
Player#1142: folds
*** RIVER *** [4c 2c 6s] [9h] [6h]
Player#5583: bets $2.40
Player#6462: folds
Player#5583: doesn't show hand
Uncalled bet ($2.40) returned to Player#5583
Player#5583 collected $2.28 from pot
*** SUMMARY ***
Total Pot $2.40 | Rake $0.12
Board [4c 2c 6s 9h 6h]
Seat 1: Player#9641 folded before the flop
Seat 2: warioman folded before the flop
Seat 3: Player#3936 folded on the turn
Seat 4: Player#6462 (button) folded on the river
Seat 5: Player#1142 (small blind) folded on the turn
Seat 6: Player#5583 shows [] and won ($2.28) with 

PokerStars Hand #ad0b7664-ab15-4d45-9e47-61de1b52a8ba:  Hold'em No Limit ($0.1/$0.20 USD) - 2021/11/19 22:20:00 ET
Table 'Bel Air' 6-max Seat #2 is the button
Seat 1: Player#0085 ($38.51 in chips)
Seat 2: Player#7179 ($6.46 in chips)
Seat 3: Player#2603 ($19.33 in chips)
Seat 4: Player#5444 ($47.24 in chips)
Seat 5: Player#0905 ($20.98 in chips)
Seat 6: warioman ($22.59 in chips)
Player#2603: posts small blind $0.10
Player#5444: posts big blind $0.20
*** HOLE CARDS ***
Dealt to warioman [Ac Td]
Player#0905: folds
warioman: raises $0.20 to $0.5
Player#0085: calls $0.50
Player#7179: calls $0.50
Player#2603: raises0.50 to $2
Player#5444: folds
warioman: folds
Player#0085: calls $1.50
Player#7179: calls $1.50
*** FLOP *** [6c 2d 5h]
Player#2603: bets $17.33
Player#0085: folds
Player#7179: calls $4.46
Player#2603 Showing Pocket Cards QQ
Player#7179 Showing Pocket Cards K3
*** TURN *** [6c 2d 5h] [Ks]
*** RIVER *** [6c 2d 5h] [Ks] [5h]
Player#7179 collected $27.07 from pot
*** SUMMARY ***
Total Pot $28.49 | Rake $1.42
Board [6c 2d 5h Ks 5h]
Seat 1: Player#0085 folded on the flop
Seat 2: Player#7179 shows [Ks 3s] and won ($27.07) with 
Seat 3: Player#2603 (small blind) mucked
Seat 4: Player#5444 (big blind) folded before the flop
Seat 5: Player#0905 folded before the flop
Seat 6: warioman folded before the flop

PokerStars Hand #c43270aa-5b30-4a6b-81da-56a0ed0501b4:  Hold'em No Limit ($0.1/$0.20 USD) - 2021/11/19 22:19:00 ET
Table 'Huntsville' 6-max Seat #3 is the button
Seat 1: Player#4190 ($43.66 in chips)
Seat 2: warioman ($20.00 in chips)
Seat 3: Player#5884 ($56.20 in chips)
Seat 4: Player#4197 ($29.13 in chips)
Seat 5: Player#8903 ($10.85 in chips)
Seat 6: Player#6027 ($7.04 in chips)
Player#4197: posts small blind $0.10
Player#8903: posts big blind $0.20
*** HOLE CARDS ***
Dealt to warioman [2c 5s]
Player#6027: calls $0.20
Player#4190: folds
warioman: folds
Player#5884: calls $0.20
Player#4197: calls $0.10
Player#8903: checks
*** FLOP *** [Ks 9c 8d]
Player#4197: checks
Player#8903: checks
Player#6027: bets $0.60
Player#5884: calls $0.60
Player#4197: folds
Player#8903: folds
*** TURN *** [Ks 9c 8d] [7s]
Player#6027: bets $1.00
Player#5884: raises1.00 to $5
Player#6027: folds
Player#5884: doesn't show hand
Uncalled bet ($5.00) returned to Player#5884
Player#5884 collected $2.85 from pot
*** SUMMARY ***
Total Pot $3.00 | Rake $0.15
Board [Ks 9c 8d 7s]
Seat 1: Player#4190 folded before the flop
Seat 2: warioman folded before the flop
Seat 3: Player#5884 shows [] and won ($2.85) with 
Seat 4: Player#4197 (small blind) folded on the flop
Seat 5: Player#8903 (big blind) folded on the flop
Seat 6: Player#6027 folded on the turn

PokerStars Hand #4dfb633f-e844-4016-b8f8-755775afca11:  Hold'em No Limit ($0.1/$0.20 USD) - 2021/11/19 22:19:00 ET
Table 'Huntsville' 6-max Seat #2 is the button
Seat 1: Player#3377 ($43.66 in chips)
Seat 2: warioman ($20.00 in chips)
Seat 3: Player#5993 ($56.30 in chips)
Seat 4: Player#8340 ($29.33 in chips)
Seat 5: Player#1361 ($10.85 in chips)
Seat 6: Player#6578 ($6.74 in chips)
Player#5993: posts small blind $0.10
Player#8340: posts big blind $0.20
*** HOLE CARDS ***
Dealt to warioman [8d 9h]
Player#1361: folds
Player#6578: raises0.20 to $1
Player#3377: folds
warioman: folds
Player#5993: folds
Player#8340: folds
Player#6578: doesn't show hand
Uncalled bet ($1.00) returned to Player#6578
Player#6578 collected $0.30 from pot
*** SUMMARY ***
Total Pot $0.30 | Rake $0.00
Seat 1: Player#3377 folded before the flop
Seat 2: warioman (button) folded before the flop
Seat 3: Player#5993 (small blind) folded before the flop
Seat 4: Player#8340 (big blind) folded before the flop
Seat 5: Player#1361 folded before the flop
Seat 6: Player#6578 shows [] and won ($0.30) with 

PokerStars Hand #35cc622f-3433-4bcf-927d-f3ec32d9a235:  Hold'em No Limit ($0.1/$0.20 USD) - 2021/11/19 22:19:00 ET
Table 'Bel Air' 6-max Seat #1 is the button
Seat 1: Player#6896 ($34.97 in chips)
Seat 2: Player#3516 ($9.76 in chips)
Seat 3: Player#4455 ($19.93 in chips)
Seat 4: Player#9845 ($47.24 in chips)
Seat 5: Player#1191 ($20.98 in chips)
Seat 6: warioman ($22.59 in chips)
Player#3516: posts small blind $0.10
Player#4455: posts big blind $0.20
*** HOLE CARDS ***
Dealt to warioman [2s Jh]
Player#9845: folds
Player#1191: folds
warioman: folds
Player#6896: raises $0.20 to $0.6
Player#3516: calls $0.50
Player#4455: calls $0.40
*** FLOP *** [2c 8h 7d]
Player#3516: checks
Player#4455: checks
Player#6896: checks
*** TURN *** [2c 8h 7d] [Ks]
Player#3516: checks
Player#4455: checks
Player#6896: checks
*** RIVER *** [2c 8h 7d] [Ks] [4s]
Player#3516: bets $0.60
Player#4455: folds
Player#6896: raises $0.60 to $2.7
Player#3516: calls $2.10
*** SHOW DOWN *** 
Player#3516: doesn't show hand
Player#6896 collected $6.84 from pot
*** SUMMARY ***
Total Pot $7.20 | Rake $0.36
Board [2c 8h 7d Ks 4s]
Seat 1: Player#6896 shows [4d 4c] and won ($6.84) with 
Seat 2: Player#3516 (small blind) mucked
Seat 3: Player#4455 (big blind) folded on the river
Seat 4: Player#9845 folded before the flop
Seat 5: Player#1191 folded before the flop
Seat 6: warioman folded before the flop

PokerStars Hand #7017e838-460f-4fc2-819e-8775de87dccc:  Hold'em No Limit ($0.1/$0.20 USD) - 2021/11/19 22:19:00 ET
Table 'Bel Air' 6-max Seat #6 is the button
Seat 1: Player#7358 ($35.07 in chips)
Seat 2: Player#8792 ($9.66 in chips)
Seat 3: Player#1794 ($19.93 in chips)
Seat 4: Player#8203 ($47.24 in chips)
Seat 5: Player#5309 ($20.98 in chips)
Seat 6: warioman ($22.59 in chips)
Player#7358: posts small blind $0.10
Player#8792: posts big blind $0.20
*** HOLE CARDS ***
Dealt to warioman [4c 8h]
Player#1794: folds
Player#8203: folds
Player#5309: folds
warioman: folds
Player#7358: folds
Player#8792 collected $0.20 from pot
*** SUMMARY ***
Total Pot $0.20 | Rake $0.00
Seat 1: Player#7358 (small blind) folded before the flop
Seat 2: Player#8792 shows [] and won ($0.20) with 
Seat 3: Player#1794 folded before the flop
Seat 4: Player#8203 folded before the flop
Seat 5: Player#5309 folded before the flop
Seat 6: warioman (button) folded before the flop

PokerStars Hand #598dc224-f88e-48e3-96ca-141f0cfaef72:  Hold'em No Limit ($0.1/$0.20 USD) - 2021/11/19 22:18:00 ET
Table 'Huntsville' 6-max Seat #1 is the button
Seat 1: Player#2631 ($43.66 in chips)
Seat 2: warioman ($19.30 in chips)
Seat 3: Player#3763 ($56.90 in chips)
Seat 4: Player#7736 ($29.33 in chips)
Seat 5: Player#7271 ($10.85 in chips)
Seat 6: Player#8513 ($4.82 in chips)
warioman: posts small blind $0.10
Player#3763: posts big blind $0.20
*** HOLE CARDS ***
Dealt to warioman [Jh Th]
Player#7736: folds
Player#7271: folds
Player#8513: raises $0.20 to $0.6
Player#2631: folds
warioman: calls $0.50
Player#3763: calls $0.40
*** FLOP *** [5d Kc 9h]
warioman: checks
Player#3763: checks
Player#8513: bets $0.90
warioman: calls $0.90
Player#3763: folds
*** TURN *** [5d Kc 9h] [4d]
warioman: checks
Player#8513: checks
*** RIVER *** [5d Kc 9h] [4d] [5d]
warioman: checks
Player#8513: checks
*** SHOW DOWN *** 
Player#8513 collected $3.42 from pot
*** SUMMARY ***
Total Pot $3.60 | Rake $0.18
Board [5d Kc 9h 4d 5d]
Seat 1: Player#2631 (button) folded before the flop
Seat 2: warioman (small blind)
Seat 3: Player#3763 (big blind) folded on the flop
Seat 4: Player#7736 folded before the flop
Seat 5: Player#7271 folded before the flop
Seat 6: Player#8513 shows [Ah Jc] and won ($3.42) with 

PokerStars Hand #36bc7f7c-cc60-4cfa-abee-14e870eefcf1:  Hold'em No Limit ($0.1/$0.20 USD) - 2021/11/19 22:18:00 ET
Table 'Bel Air' 6-max Seat #5 is the button
Seat 1: Player#5639 ($35.27 in chips)
Seat 2: Player#3516 ($9.66 in chips)
Seat 3: Player#7411 ($19.93 in chips)
Seat 4: Player#6494 ($47.24 in chips)
Seat 5: Player#1270 ($20.98 in chips)
Seat 6: warioman ($22.39 in chips)
warioman: posts small blind $0.10
Player#5639: posts big blind $0.20
*** HOLE CARDS ***
Dealt to warioman [Td Jd]
Player#3516: folds
Player#7411: folds
Player#6494: folds
Player#1270: folds
warioman: raises $0.20 to $0.6
Player#5639: folds
warioman: doesn't show hand
Uncalled bet ($0.60) returned to warioman
warioman collected $0.20 from pot
*** SUMMARY ***
Total Pot $0.20 | Rake $0.00
Seat 1: Player#5639 (big blind) folded before the flop
Seat 2: Player#3516 folded before the flop
Seat 3: Player#7411 folded before the flop
Seat 4: Player#6494 folded before the flop
Seat 5: Player#1270 (button) folded before the flop
Seat 6: warioman (small blind)

PokerStars Hand #84976ab3-6e50-453b-90ff-3661ab89d546:  Hold'em No Limit ($0.1/$0.20 USD) - 2021/11/19 22:18:00 ET
Table 'Bel Air' 6-max Seat #4 is the button
Seat 1: Player#1500 ($35.27 in chips)
Seat 2: Player#4083 ($9.66 in chips)
Seat 3: Player#7235 ($19.93 in chips)
Seat 4: Player#7438 ($47.24 in chips)
Seat 5: Player#1539 ($21.08 in chips)
Seat 6: warioman ($22.29 in chips)
Player#1539: posts small blind $0.10
warioman: posts big blind $0.20
*** HOLE CARDS ***
Dealt to warioman [5d 8c]
Player#1500: folds
Player#4083: folds
Player#7235: folds
Player#7438: folds
Player#1539: folds
warioman collected $0.20 from pot
*** SUMMARY ***
Total Pot $0.20 | Rake $0.00
Seat 1: Player#1500 folded before the flop
Seat 2: Player#4083 folded before the flop
Seat 3: Player#7235 folded before the flop
Seat 4: Player#7438 (button) folded before the flop
Seat 5: Player#1539 (small blind) folded before the flop
Seat 6: warioman (big blind)

PokerStars Hand #06ee57c9-b749-49ab-ab5e-47437e25be9b:  Hold'em No Limit ($0.1/$0.20 USD) - 2021/11/19 22:18:00 ET
Table 'Bel Air' 6-max Seat #3 is the button
Seat 1: Player#1353 ($35.27 in chips)
Seat 2: Player#8920 ($9.66 in chips)
Seat 3: Player#7067 ($20.13 in chips)
Seat 4: Player#4659 ($46.84 in chips)
Seat 5: Player#6694 ($21.28 in chips)
Seat 6: warioman ($22.29 in chips)
Player#4659: posts small blind $0.10
Player#6694: posts big blind $0.20
*** HOLE CARDS ***
Dealt to warioman [Jd 3d]
warioman: folds
Player#1353: folds
Player#8920: folds
Player#7067: calls $0.20
Player#4659: raises $0.20 to $0.8
Player#6694: folds
Player#7067: folds
Player#1353: doesn't show hand
Player#8920: doesn't show hand
Player#7067: doesn't show hand
Player#4659: doesn't show hand
Player#6694: doesn't show hand
warioman: doesn't show hand
Uncalled bet ($0.80) returned to Player#4659
Player#4659 collected $0.40 from pot
*** SUMMARY ***
Total Pot $0.40 | Rake $0.00
Seat 1: Player#1353 folded before the flop
Seat 2: Player#8920 folded before the flop
Seat 3: Player#7067 (button) folded before the flop
Seat 4: Player#4659 shows [] and won ($0.40) with 
Seat 5: Player#6694 (big blind) folded before the flop
Seat 6: warioman folded before the flop

PokerStars Hand #68f5d770-6b44-47af-80df-610baad677c5:  Hold'em No Limit ($0.1/$0.20 USD) - 2021/11/19 22:17:00 ET
Table 'Bel Air' 6-max Seat #2 is the button
Seat 1: Player#6225 ($35.27 in chips)
Seat 2: Player#5510 ($9.36 in chips)
Seat 3: Player#0441 ($20.23 in chips)
Seat 4: Player#9341 ($47.04 in chips)
Seat 5: Player#4571 ($21.28 in chips)
Seat 6: warioman ($22.29 in chips)
Player#0441: posts small blind $0.10
Player#9341: posts big blind $0.20
*** HOLE CARDS ***
Dealt to warioman [5h Th]
Player#4571: folds
warioman: folds
Player#6225: folds
Player#5510: raises $0.20 to $0.4
Player#0441: folds
Player#9341: folds
Player#5510: doesn't show hand
Uncalled bet ($0.40) returned to Player#5510
Player#5510 collected $0.30 from pot
*** SUMMARY ***
Total Pot $0.30 | Rake $0.00
Seat 1: Player#6225 folded before the flop
Seat 2: Player#5510 shows [] and won ($0.30) with 
Seat 3: Player#0441 (small blind) folded before the flop
Seat 4: Player#9341 (big blind) folded before the flop
Seat 5: Player#4571 folded before the flop
Seat 6: warioman folded before the flop

PokerStars Hand #4b41c5d6-b9fb-4e3e-b511-bac2c21dac11:  Hold'em No Limit ($0.1/$0.20 USD) - 2021/11/19 22:17:00 ET
Table 'Huntsville' 6-max Seat #6 is the button
Seat 1: Player#9316 ($50.56 in chips)
Seat 2: warioman ($19.70 in chips)
Seat 3: Player#5986 ($56.90 in chips)
Seat 4: Player#7911 ($21.98 in chips)
Seat 5: Player#4436 ($11.25 in chips)
Seat 6: Player#9471 ($5.22 in chips)
Player#9316: posts small blind $0.10
warioman: posts big blind $0.20
*** HOLE CARDS ***
Dealt to warioman [6h Th]
Player#5986: folds
Player#7911: raises $0.20 to $0.4
Player#4436: calls $0.40
Player#9471: calls $0.40
Player#9316: calls $0.30
warioman: calls $0.20
*** FLOP *** [4c 6d 3d]
Player#9316: bets $2.00
warioman: folds
Player#7911: calls $2.00
Player#4436: folds
Player#9471: folds
*** TURN *** [4c 6d 3d] [Ks]
Player#9316: bets $4.50
Player#7911: calls $4.50
*** RIVER *** [4c 6d 3d] [Ks] [4s]
Player#9316: checks
Player#7911: bets $15.08
Player#9316: folds
Player#7911: doesn't show hand
Uncalled bet ($15.08) returned to Player#7911
Player#7911 collected $14.25 from pot
*** SUMMARY ***
Total Pot $15.00 | Rake $0.75
Board [4c 6d 3d Ks 4s]
Seat 1: Player#9316 (small blind) folded on the river
Seat 2: warioman (big blind) folded on the flop
Seat 3: Player#5986 folded before the flop
Seat 4: Player#7911 shows [] and won ($14.25) with 
Seat 5: Player#4436 folded on the flop
Seat 6: Player#9471 (button) folded on the flop

PokerStars Hand #4169ae7b-6fd1-4684-9996-0ac970866e1e:  Hold'em No Limit ($0.1/$0.20 USD) - 2021/11/19 22:17:00 ET
Table 'Bel Air' 6-max Seat #1 is the button
Seat 1: Player#7955 ($34.97 in chips)
Seat 2: Player#8367 ($9.46 in chips)
Seat 3: Player#1735 ($20.43 in chips)
Seat 4: Player#1027 ($47.04 in chips)
Seat 5: Player#5114 ($21.28 in chips)
Seat 6: warioman ($22.29 in chips)
Player#8367: posts small blind $0.10
Player#1735: posts big blind $0.20
*** HOLE CARDS ***
Dealt to warioman [5h Td]
Player#1027: folds
Player#5114: folds
warioman: folds
Player#7955: raises $0.20 to $0.6
Player#8367: folds
Player#1735: folds
Player#7955: doesn't show hand
Uncalled bet ($0.60) returned to Player#7955
Player#7955 collected $0.30 from pot
*** SUMMARY ***
Total Pot $0.30 | Rake $0.00
Seat 1: Player#7955 shows [] and won ($0.30) with 
Seat 2: Player#8367 (small blind) folded before the flop
Seat 3: Player#1735 (big blind) folded before the flop
Seat 4: Player#1027 folded before the flop
Seat 5: Player#5114 folded before the flop
Seat 6: warioman folded before the flop

PokerStars Hand #afdbd107-b855-42a3-a269-808aedf17492:  Hold'em No Limit ($0.1/$0.20 USD) - 2021/11/19 22:17:00 ET
Table 'Huntsville' 6-max Seat #5 is the button
Seat 1: Player#2285 ($50.16 in chips)
Seat 2: warioman ($19.70 in chips)
Seat 3: Player#3668 ($56.90 in chips)
Seat 4: Player#9982 ($21.98 in chips)
Seat 5: Player#3455 ($11.45 in chips)
Seat 6: Player#9216 ($5.42 in chips)
Player#9216: posts small blind $0.10
Player#2285: posts big blind $0.20
*** HOLE CARDS ***
Dealt to warioman [Qh 5d]
warioman: folds
Player#3668: folds
Player#9982: folds
Player#3455: calls $0.20
Player#9216: calls $0.10
Player#2285: raises $0.20 to $0.8
Player#3455: folds
Player#9216: folds
Player#2285: doesn't show hand
Uncalled bet ($0.80) returned to Player#2285
Player#2285 collected $0.40 from pot
*** SUMMARY ***
Total Pot $0.40 | Rake $0.00
Seat 1: Player#2285 shows [] and won ($0.40) with 
Seat 2: warioman folded before the flop
Seat 3: Player#3668 folded before the flop
Seat 4: Player#9982 folded before the flop
Seat 5: Player#3455 (button) folded before the flop
Seat 6: Player#9216 (small blind) folded before the flop

PokerStars Hand #ba184e88-23f6-4a01-b666-4ec2779d122b:  Hold'em No Limit ($0.1/$0.20 USD) - 2021/11/19 22:16:00 ET
Table 'Bel Air' 6-max Seat #6 is the button
Seat 1: Player#4584 ($35.07 in chips)
Seat 2: Player#3722 ($10.26 in chips)
Seat 3: Player#1830 ($19.42 in chips)
Seat 4: Player#8244 ($47.04 in chips)
Seat 5: Player#1709 ($21.48 in chips)
Seat 6: warioman ($22.29 in chips)
Player#4584: posts small blind $0.10
Player#3722: posts big blind $0.20
*** HOLE CARDS ***
Dealt to warioman [9h 2d]
Player#1830: calls $0.20
Player#8244: folds
Player#1709: calls $0.20
warioman: folds
Player#4584: folds
Player#3722: checks
*** FLOP *** [Th 8d Jd]
Player#3722: checks
Player#1830: bets $0.60
Player#1709: folds
Player#3722: calls $0.60
*** TURN *** [Th 8d Jd] [Kh]
Player#3722: checks
Player#1830: checks
*** RIVER *** [Th 8d Jd] [Kh] [Kh]
Player#3722: checks
Player#1830: checks
*** SHOW DOWN *** 
Player#1830 collected $1.80 from pot
*** SUMMARY ***
Total Pot $1.90 | Rake $0.10
Board [Th 8d Jd Kh Kh]
Seat 1: Player#4584 (small blind) folded before the flop
Seat 2: Player#3722 (big blind) mucked
Seat 3: Player#1830 shows [Ts 9d] and won ($1.80) with 
Seat 4: Player#8244 folded before the flop
Seat 5: Player#1709 folded on the flop
Seat 6: warioman (button) folded before the flop

PokerStars Hand #1def0a4f-7cbc-4afc-8b4c-7a914f8a0509:  Hold'em No Limit ($0.1/$0.20 USD) - 2021/11/19 22:16:00 ET
Table 'Huntsville' 6-max Seat #4 is the button
Seat 1: Player#4535 ($44.70 in chips)
Seat 2: warioman ($19.70 in chips)
Seat 3: Player#7043 ($56.90 in chips)
Seat 4: Player#9860 ($26.72 in chips)
Seat 5: Player#9856 ($12.50 in chips)
Seat 6: Player#5809 ($5.62 in chips)
Player#9856: posts small blind $0.10
Player#5809: posts big blind $0.20
*** HOLE CARDS ***
Dealt to warioman [8c 3s]
Player#4535: raises $0.20 to $0.6
warioman: folds
Player#7043: folds
Player#9860: raises $0.60 to $1.05
Player#9856: calls $0.95
Player#5809: folds
Player#4535: calls $0.45
*** FLOP *** [Ks 3d 6c]
Player#9856: checks
Player#4535: checks
Player#9860: bets $1.68
Player#9856: folds
Player#4535: calls $1.68
*** TURN *** [Ks 3d 6c] [7c]
Player#4535: checks
Player#9860: bets $2.01
Player#4535: calls $2.01
*** RIVER *** [Ks 3d 6c] [7c] [Jc]
Player#4535: checks
Player#9860: checks
*** SHOW DOWN *** 
Player#4535 collected $10.19 from pot
*** SUMMARY ***
Total Pot $10.73 | Rake $0.54
Board [Ks 3d 6c 7c Jc]
Seat 1: Player#4535 shows [Kh Js] and won ($10.19) with 
Seat 2: warioman folded before the flop
Seat 3: Player#7043 folded before the flop
Seat 4: Player#9860 (button) mucked
Seat 5: Player#9856 (small blind) folded on the flop
Seat 6: Player#5809 (big blind) folded before the flop

PokerStars Hand #9cb1138c-84df-4cd8-b27c-63188cb1ffab:  Hold'em No Limit ($0.1/$0.20 USD) - 2021/11/19 22:16:00 ET
Table 'Bel Air' 6-max Seat #5 is the button
Seat 1: Player#8746 ($35.27 in chips)
Seat 2: Player#7657 ($10.26 in chips)
Seat 3: Player#3275 ($19.40 in chips)
Seat 4: Player#2129 ($47.04 in chips)
Seat 5: Player#0307 ($21.48 in chips)
Seat 6: warioman ($22.28 in chips)
warioman: posts small blind $0.10
Player#8746: posts big blind $0.20
*** HOLE CARDS ***
Dealt to warioman [Ad 4d]
Player#7657: folds
Player#3275: calls $0.20
Player#2129: folds
Player#0307: folds
warioman: calls $0.10
Player#8746: checks
*** FLOP *** [6d Kc Ac]
warioman: checks
Player#8746: checks
Player#3275: bets $0.40
warioman: calls $0.40
Player#8746: folds
*** TURN *** [6d Kc Ac] [6h]
warioman: checks
Player#3275: bets $1.00
warioman: calls $1.00
*** RIVER *** [6d Kc Ac] [6h] [5h]
warioman: checks
Player#3275: checks
*** SHOW DOWN *** 
warioman collected $3.23 from pot
*** SUMMARY ***
Total Pot $3.40 | Rake $0.17
Board [6d Kc Ac 6h 5h]
Seat 1: Player#8746 (big blind) folded on the flop
Seat 2: Player#7657 folded before the flop
Seat 3: Player#3275 mucked
Seat 4: Player#2129 folded before the flop
Seat 5: Player#0307 (button) folded before the flop
Seat 6: warioman (small blind)

PokerStars Hand #c9ef90fb-acdd-471e-96fa-9ffcb55711b5:  Hold'em No Limit ($0.1/$0.20 USD) - 2021/11/19 22:15:00 ET
Table 'Huntsville' 6-max Seat #3 is the button
Seat 1: Player#2112 ($44.20 in chips)
Seat 2: warioman ($19.70 in chips)
Seat 3: Player#5775 ($56.90 in chips)
Seat 4: Player#7008 ($26.82 in chips)
Seat 5: Player#6599 ($12.70 in chips)
Seat 6: Player#3289 ($5.82 in chips)
Player#7008: posts small blind $0.10
Player#6599: posts big blind $0.20
*** HOLE CARDS ***
Dealt to warioman [2s 4s]
Player#3289: calls $0.20
Player#2112: raises $0.20 to $0.9
warioman: folds
Player#5775: folds
Player#7008: folds
Player#6599: folds
Player#3289: folds
Player#2112: doesn't show hand
Uncalled bet ($0.90) returned to Player#2112
Player#2112 collected $0.50 from pot
*** SUMMARY ***
Total Pot $0.50 | Rake $0.00
Seat 1: Player#2112 shows [] and won ($0.50) with 
Seat 2: warioman folded before the flop
Seat 3: Player#5775 (button) folded before the flop
Seat 4: Player#7008 (small blind) folded before the flop
Seat 5: Player#6599 (big blind) folded before the flop
Seat 6: Player#3289 folded before the flop

PokerStars Hand #14fac851-25ad-4fd6-b5c6-ce1db297a81e:  Hold'em No Limit ($0.1/$0.20 USD) - 2021/11/19 22:15:00 ET
Table 'Bel Air' 6-max Seat #4 is the button
Seat 1: Player#3536 ($35.27 in chips)
Seat 2: Player#1925 ($9.43 in chips)
Seat 3: Player#5417 ($20.00 in chips)
Seat 4: Player#1388 ($47.04 in chips)
Seat 5: Player#6941 ($21.58 in chips)
Seat 6: warioman ($22.48 in chips)
Player#6941: posts small blind $0.10
warioman: posts big blind $0.20
*** HOLE CARDS ***
Dealt to warioman [Kd 4c]
Player#5417 Entry Bet 0.2
Player#3536: folds
Player#1925: raises $0.20 to $0.6
Player#5417: calls $0.40
Player#1388: folds
Player#6941: folds
warioman: folds
*** FLOP *** [Kh 3c 6d]
Player#1925: bets $0.60
Player#5417: folds
Player#1925 Show
Player#1925 Showing Pocket Cards 27
Uncalled bet ($0.60) returned to Player#1925
Player#1925 collected $1.23 from pot
*** SUMMARY ***
Total Pot $1.30 | Rake $0.06
Board [Kh 3c 6d]
Seat 1: Player#3536 folded before the flop
Seat 2: Player#1925 shows [2s 7d] and won ($1.23) with 
Seat 3: Player#5417 folded on the flop
Seat 4: Player#1388 (button) folded before the flop
Seat 5: Player#6941 (small blind) folded before the flop
Seat 6: warioman (big blind) folded before the flop

PokerStars Hand #137f5ae8-b588-4b81-b92e-1631fffda15d:  Hold'em No Limit ($0.1/$0.20 USD) - 2021/11/19 22:15:00 ET
Table 'Huntsville' 6-max Seat #2 is the button
Seat 1: Player#4591 ($44.20 in chips)
Seat 2: warioman ($19.70 in chips)
Seat 3: Player#7235 ($57.10 in chips)
Seat 4: Player#0102 ($27.02 in chips)
Seat 5: Player#0026 ($12.70 in chips)
Seat 6: Player#5263 ($5.45 in chips)
Player#7235: posts small blind $0.10
Player#0102: posts big blind $0.20
*** HOLE CARDS ***
Dealt to warioman [2d 7c]
Player#0026: folds
Player#5263: calls $0.20
Player#4591: folds
warioman: folds
Player#7235: calls $0.10
Player#0102: checks
*** FLOP *** [Tc 3d Kh]
Player#7235: checks
Player#0102: checks
Player#5263: checks
*** TURN *** [Tc 3d Kh] [Kc]
Player#7235: checks
Player#0102: checks
Player#5263: bets $0.60
Player#7235: folds
Player#0102: folds
Player#5263: doesn't show hand
Uncalled bet ($0.60) returned to Player#5263
Player#5263 collected $0.57 from pot
*** SUMMARY ***
Total Pot $0.60 | Rake $0.03
Board [Tc 3d Kh Kc]
Seat 1: Player#4591 folded before the flop
Seat 2: warioman (button) folded before the flop
Seat 3: Player#7235 (small blind) folded on the turn
Seat 4: Player#0102 (big blind) folded on the turn
Seat 5: Player#0026 folded before the flop
Seat 6: Player#5263 shows [] and won ($0.57) with 

PokerStars Hand #8d331264-f0bd-4f5c-b8c0-343591796419:  Hold'em No Limit ($0.1/$0.20 USD) - 2021/11/19 22:14:00 ET
Table 'Huntsville' 6-max Seat #1 is the button
Seat 1: Player#4524 ($44.20 in chips)
Seat 2: warioman ($19.80 in chips)
Seat 3: Player#8353 ($57.30 in chips)
Seat 4: Player#3836 ($27.02 in chips)
Seat 5: Player#0189 ($12.70 in chips)
Seat 6: Player#0755 ($5.17 in chips)
warioman: posts small blind $0.10
Player#8353: posts big blind $0.20
*** HOLE CARDS ***
Dealt to warioman [6s Ad]
Player#3836: folds
Player#0189: folds
Player#0755: calls $0.20
Player#4524: folds
warioman: folds
Player#8353: checks
*** FLOP *** [2c 6h Qs]
Player#8353: checks
Player#0755: bets $0.60
Player#8353: folds
Player#0755: doesn't show hand
Uncalled bet ($0.60) returned to Player#0755
Player#0755 collected $0.48 from pot
*** SUMMARY ***
Total Pot $0.50 | Rake $0.03
Board [2c 6h Qs]
Seat 1: Player#4524 (button) folded before the flop
Seat 2: warioman (small blind) folded before the flop
Seat 3: Player#8353 (big blind) folded on the flop
Seat 4: Player#3836 folded before the flop
Seat 5: Player#0189 folded before the flop
Seat 6: Player#0755 shows [] and won ($0.48) with 

PokerStars Hand #8d89e057-6373-40ee-9897-865b7027a988:  Hold'em No Limit ($0.1/$0.20 USD) - 2021/11/19 22:14:00 ET
Table 'Bel Air' 6-max Seat #3 is the button
Seat 1: Player#6705 ($35.27 in chips)
Seat 2: Player#4560 ($9.43 in chips)
Seat 3: Player#8651 ($20.00 in chips)
Seat 4: Player#3051 ($47.24 in chips)
Seat 5: Player#0299 ($21.40 in chips)
Seat 6: warioman ($22.48 in chips)
Player#3051: posts small blind $0.10
Player#0299: posts big blind $0.20
*** HOLE CARDS ***
Dealt to warioman [8d Ac]
warioman: folds
Player#6705: folds
Player#4560: folds
Player#3051: calls $0.10
Player#0299: checks
*** FLOP *** [6d Kd Td]
Player#3051: checks
Player#0299: bets $0.20
Player#3051: folds
Player#0299: doesn't show hand
Uncalled bet ($0.20) returned to Player#0299
Player#0299 collected $0.38 from pot
*** SUMMARY ***
Total Pot $0.40 | Rake $0.02
Board [6d Kd Td]
Seat 1: Player#6705 folded before the flop
Seat 2: Player#4560 folded before the flop
Seat 3: Player#8651 (button) mucked
Seat 4: Player#3051 (small blind) folded on the flop
Seat 5: Player#0299 shows [] and won ($0.38) with 
Seat 6: warioman folded before the flop

PokerStars Hand #6a08f925-bb5d-44e1-86cf-59ecc53f2c3d:  Hold'em No Limit ($0.1/$0.20 USD) - 2021/11/19 22:14:00 ET
Table 'Huntsville' 6-max Seat #6 is the button
Seat 1: Player#8536 ($44.00 in chips)
Seat 2: warioman ($20.00 in chips)
Seat 3: Player#7062 ($57.30 in chips)
Seat 4: Player#8707 ($27.02 in chips)
Seat 5: Player#1056 ($12.70 in chips)
Seat 6: Player#1363 ($5.17 in chips)
Player#8536: posts small blind $0.10
warioman: posts big blind $0.20
*** HOLE CARDS ***
Dealt to warioman [3c Ts]
Player#7062: folds
Player#8707: folds
Player#1056: folds
Player#1363: folds
Player#8536: raises $0.20 to $0.6
warioman: folds
Player#8536: doesn't show hand
Uncalled bet ($0.60) returned to Player#8536
Player#8536 collected $0.20 from pot
*** SUMMARY ***
Total Pot $0.20 | Rake $0.00
Seat 1: Player#8536 shows [] and won ($0.20) with 
Seat 2: warioman (big blind) folded before the flop
Seat 3: Player#7062 folded before the flop
Seat 4: Player#8707 folded before the flop
Seat 5: Player#1056 folded before the flop
Seat 6: Player#1363 (button) folded before the flop

PokerStars Hand #cb99e2f8-a8ec-4ca1-8590-bc5653cd7e3d:  Hold'em No Limit ($0.1/$0.20 USD) - 2021/11/19 22:14:00 ET
Table 'Bel Air' 6-max Seat #1 is the button
Seat 1: Player#6664 ($35.27 in chips)
Seat 2: Player#7425 ($7.80 in chips)
Seat 3: Player#6647 ($47.44 in chips)
Seat 4: Player#8088 ($23.00 in chips)
Seat 5: warioman ($22.48 in chips)
Player#7425: posts small blind $0.10
Player#6647: posts big blind $0.20
*** HOLE CARDS ***
Dealt to warioman [9c Jd]
Player#8088: raises $0.20 to $0.6
warioman: folds
Player#6664: folds
Player#7425: calls $0.50
Player#6647: folds
*** FLOP *** [3c 8c 7d]
Player#7425: checks
Player#8088: bets $1.00
Player#7425: calls $1.00
*** TURN *** [3c 8c 7d] [8h]
Player#7425: checks
Player#8088: checks
*** RIVER *** [3c 8c 7d] [8h] [6h]
Player#7425: bets $0.80
Player#8088: folds
Player#7425: doesn't show hand
Uncalled bet ($0.80) returned to Player#7425
Player#7425 collected $3.23 from pot
*** SUMMARY ***
Total Pot $3.40 | Rake $0.17
Board [3c 8c 7d 8h 6h]
Seat 1: Player#6664 (button) folded before the flop
Seat 2: Player#7425 shows [] and won ($3.23) with 
Seat 3: Player#6647 (big blind) folded before the flop
Seat 4: Player#8088 folded on the river
Seat 5: warioman folded before the flop

PokerStars Hand #a3ef7b60-9e8a-4e7c-9e76-2f620b5ead69:  Hold'em No Limit ($0.1/$0.20 USD) - 2021/11/19 22:14:00 ET
Table 'Bel Air' 6-max Seat #6 is the button
Seat 1: Player#4875 ($35.37 in chips)
Seat 2: Player#4026 ($7.70 in chips)
Seat 3: Player#7225 ($17.68 in chips)
Seat 4: Player#6463 ($47.44 in chips)
Seat 5: Player#8568 ($23.00 in chips)
Seat 6: warioman ($22.48 in chips)
Player#4875: posts small blind $0.10
Player#4026: posts big blind $0.20
*** HOLE CARDS ***
Dealt to warioman [5h 3h]
Player#7225: folds
Player#6463: folds
Player#8568: folds
warioman: folds
Player#4875: folds
Player#4026 collected $0.20 from pot
*** SUMMARY ***
Total Pot $0.20 | Rake $0.00
Seat 1: Player#4875 (small blind) folded before the flop
Seat 2: Player#4026 shows [] and won ($0.20) with 
Seat 3: Player#7225 folded before the flop
Seat 4: Player#6463 folded before the flop
Seat 5: Player#8568 folded before the flop
Seat 6: warioman (button) folded before the flop

PokerStars Hand #1f1ff314-3a9e-413f-bce0-49cb12febaae:  Hold'em No Limit ($0.1/$0.20 USD) - 2021/11/19 22:13:00 ET
Table 'Bel Air' 6-max Seat #5 is the button
Seat 1: Player#5744 ($35.57 in chips)
Seat 2: Player#5542 ($7.40 in chips)
Seat 3: Player#2012 ($17.68 in chips)
Seat 4: Player#2446 ($47.44 in chips)
Seat 5: Player#4825 ($23.00 in chips)
Seat 6: warioman ($22.58 in chips)
warioman: posts small blind $0.10
Player#5744: posts big blind $0.20
*** HOLE CARDS ***
Dealt to warioman [3d 4c]
Player#5542: raises $0.20 to $0.6
Player#2012: folds
Player#2446: folds
Player#4825: folds
warioman: folds
Player#5744: folds
Player#5542: doesn't show hand
Uncalled bet ($0.60) returned to Player#5542
Player#5542 collected $0.30 from pot
*** SUMMARY ***
Total Pot $0.30 | Rake $0.00
Seat 1: Player#5744 (big blind) folded before the flop
Seat 2: Player#5542 shows [] and won ($0.30) with 
Seat 3: Player#2012 folded before the flop
Seat 4: Player#2446 folded before the flop
Seat 5: Player#4825 (button) folded before the flop
Seat 6: warioman (small blind) folded before the flop

PokerStars Hand #51deb797-82b7-42cb-b0d1-eca51dd05369:  Hold'em No Limit ($0.1/$0.20 USD) - 2021/11/19 22:13:00 ET
Table 'Bel Air' 6-max Seat #4 is the button
Seat 1: Player#1845 ($35.27 in chips)
Seat 2: Player#4697 ($7.40 in chips)
Seat 3: Player#0590 ($17.68 in chips)
Seat 4: Player#5784 ($47.44 in chips)
Seat 5: Player#9320 ($23.10 in chips)
Seat 6: warioman ($22.78 in chips)
Player#9320: posts small blind $0.10
warioman: posts big blind $0.20
*** HOLE CARDS ***
Dealt to warioman [4d Th]
Player#1845: raises $0.20 to $0.4
Player#4697: folds
Player#0590: folds
Player#5784: folds
Player#9320: folds
warioman: folds
Player#1845: doesn't show hand
Uncalled bet ($0.40) returned to Player#1845
Player#1845 collected $0.30 from pot
*** SUMMARY ***
Total Pot $0.30 | Rake $0.00
Seat 1: Player#1845 shows [] and won ($0.30) with 
Seat 2: Player#4697 folded before the flop
Seat 3: Player#0590 folded before the flop
Seat 4: Player#5784 (button) folded before the flop
Seat 5: Player#9320 (small blind) folded before the flop
Seat 6: warioman (big blind) folded before the flop

PokerStars Hand #95c70942-0364-40b0-97b8-91517cb692cf:  Hold'em No Limit ($0.1/$0.20 USD) - 2021/11/19 22:13:00 ET
Table 'Huntsville' 6-max Seat #5 is the button
Seat 1: Player#1038 ($44.60 in chips)
Seat 2: warioman ($20.00 in chips)
Seat 3: Player#9202 ($57.30 in chips)
Seat 4: Player#4346 ($23.48 in chips)
Seat 5: Player#0078 ($12.70 in chips)
Seat 6: Player#0336 ($8.47 in chips)
Player#0336: posts small blind $0.10
Player#1038: posts big blind $0.20
*** HOLE CARDS ***
Dealt to warioman [3d 2c]
warioman: folds
Player#9202: folds
Player#4346: raises $0.20 to $0.6
Player#0078: folds
Player#0336: calls $0.50
Player#1038: calls $0.40
*** FLOP *** [9s 8c 4s]
Player#0336: checks
Player#1038: checks
Player#4346: bets $0.90
Player#0336: calls $0.90
Player#1038: folds
*** TURN *** [9s 8c 4s] [Kc]
Player#0336: bets $1.80
Player#4346: raises1.80 to $9
Player#0336: folds
Player#4346: doesn't show hand
Uncalled bet ($9.00) returned to Player#4346
Player#4346 collected $5.13 from pot
*** SUMMARY ***
Total Pot $5.40 | Rake $0.27
Board [9s 8c 4s Kc]
Seat 1: Player#1038 (big blind) folded on the flop
Seat 2: warioman folded before the flop
Seat 3: Player#9202 folded before the flop
Seat 4: Player#4346 shows [] and won ($5.13) with 
Seat 5: Player#0078 (button) folded before the flop
Seat 6: Player#0336 (small blind) folded on the turn

PokerStars Hand #7fb602c0-5fd4-4af3-846d-b69218ee8292:  Hold'em No Limit ($0.1/$0.20 USD) - 2021/11/19 22:13:00 ET
Table 'Bel Air' 6-max Seat #3 is the button
Seat 1: Player#8510 ($35.27 in chips)
Seat 2: Player#6799 ($7.40 in chips)
Seat 3: Player#1473 ($17.68 in chips)
Seat 4: Player#4867 ($47.54 in chips)
Seat 5: Player#2814 ($23.30 in chips)
Seat 6: warioman ($22.48 in chips)
Player#4867: posts small blind $0.10
Player#2814: posts big blind $0.20
*** HOLE CARDS ***
Dealt to warioman [Kc Ks]
warioman: raises $0.20 to $0.5
Player#8510: folds
Player#6799: folds
Player#1473: folds
Player#4867: folds
Player#2814: folds
warioman: doesn't show hand
Uncalled bet ($0.50) returned to warioman
warioman collected $0.30 from pot
*** SUMMARY ***
Total Pot $0.30 | Rake $0.00
Seat 1: Player#8510 folded before the flop
Seat 2: Player#6799 folded before the flop
Seat 3: Player#1473 (button) folded before the flop
Seat 4: Player#4867 (small blind) folded before the flop
Seat 5: Player#2814 (big blind) folded before the flop
Seat 6: warioman

PokerStars Hand #d55358e8-7399-489a-813f-bab0b45b883d:  Hold'em No Limit ($0.1/$0.20 USD) - 2021/11/19 22:13:00 ET
Table 'Bel Air' 6-max Seat #2 is the button
Seat 1: Player#1947 ($35.27 in chips)
Seat 2: Player#5361 ($7.40 in chips)
Seat 3: Player#8907 ($17.78 in chips)
Seat 4: Player#0357 ($47.44 in chips)
Seat 5: Player#0076 ($23.30 in chips)
Seat 6: warioman ($22.48 in chips)
Player#8907: posts small blind $0.10
Player#0357: posts big blind $0.20
*** HOLE CARDS ***
Dealt to warioman [3c 2s]
Player#0076: folds
warioman: folds
Player#1947: folds
Player#5361: folds
Player#8907: folds
Player#0357 collected $0.20 from pot
*** SUMMARY ***
Total Pot $0.20 | Rake $0.00
Seat 1: Player#1947 folded before the flop
Seat 2: Player#5361 (button) folded before the flop
Seat 3: Player#8907 (small blind) folded before the flop
Seat 4: Player#0357 shows [] and won ($0.20) with 
Seat 5: Player#0076 folded before the flop
Seat 6: warioman folded before the flop

PokerStars Hand #6dbed727-9b10-4e17-9b95-413801367650:  Hold'em No Limit ($0.1/$0.20 USD) - 2021/11/19 22:13:00 ET
Table 'Huntsville' 6-max Seat #4 is the button
Seat 1: Player#3981 ($44.60 in chips)
Seat 2: warioman ($20.00 in chips)
Seat 3: Player#2962 ($57.30 in chips)
Seat 4: Player#1960 ($23.48 in chips)
Seat 5: Player#8497 ($12.80 in chips)
Seat 6: Player#6638 ($8.37 in chips)
Player#8497: posts small blind $0.10
Player#6638: posts big blind $0.20
*** HOLE CARDS ***
Dealt to warioman [Tc 2s]
Player#3981: folds
warioman: folds
Player#2962: folds
Player#1960: folds
Player#8497: folds
Player#6638 collected $0.20 from pot
*** SUMMARY ***
Total Pot $0.20 | Rake $0.00
Seat 1: Player#3981 folded before the flop
Seat 2: warioman folded before the flop
Seat 3: Player#2962 folded before the flop
Seat 4: Player#1960 (button) folded before the flop
Seat 5: Player#8497 (small blind) folded before the flop
Seat 6: Player#6638 shows [] and won ($0.20) with 

PokerStars Hand #69136b95-5a0b-4f50-8072-2d00551d57b3:  Hold'em No Limit ($0.1/$0.20 USD) - 2021/11/19 22:13:00 ET
Table 'Bel Air' 6-max Seat #1 is the button
Seat 1: Player#4686 ($35.27 in chips)
Seat 2: Player#6115 ($7.50 in chips)
Seat 3: Player#6494 ($17.98 in chips)
Seat 4: Player#2133 ($47.44 in chips)
Seat 5: Player#7930 ($23.00 in chips)
Seat 6: warioman ($22.48 in chips)
Player#6115: posts small blind $0.10
Player#6494: posts big blind $0.20
*** HOLE CARDS ***
Dealt to warioman [7s 3s]
Player#2133: folds
Player#7930: raises $0.20 to $0.6
warioman: folds
Player#4686: folds
Player#6115: folds
Player#6494: folds
Player#7930: doesn't show hand
Uncalled bet ($0.60) returned to Player#7930
Player#7930 collected $0.30 from pot
*** SUMMARY ***
Total Pot $0.30 | Rake $0.00
Seat 1: Player#4686 (button) folded before the flop
Seat 2: Player#6115 (small blind) folded before the flop
Seat 3: Player#6494 (big blind) folded before the flop
Seat 4: Player#2133 folded before the flop
Seat 5: Player#7930 shows [] and won ($0.30) with 
Seat 6: warioman folded before the flop

PokerStars Hand #6810a5ca-e74f-405f-8b5a-82d540983f3c:  Hold'em No Limit ($0.1/$0.20 USD) - 2021/11/19 22:12:00 ET
Table 'Bel Air' 6-max Seat #6 is the button
Seat 1: Player#1651 ($35.37 in chips)
Seat 2: Player#3021 ($7.40 in chips)
Seat 3: Player#5869 ($17.98 in chips)
Seat 4: Player#1821 ($47.44 in chips)
Seat 5: Player#5392 ($23.00 in chips)
Seat 6: warioman ($22.48 in chips)
Player#1651: posts small blind $0.10
Player#3021: posts big blind $0.20
*** HOLE CARDS ***
Dealt to warioman [3s Jd]
Player#5869: folds
Player#1821: folds
Player#5392: folds
warioman: folds
Player#1651: folds
Player#3021 collected $0.20 from pot
*** SUMMARY ***
Total Pot $0.20 | Rake $0.00
Seat 1: Player#1651 (small blind) folded before the flop
Seat 2: Player#3021 shows [] and won ($0.20) with 
Seat 3: Player#5869 folded before the flop
Seat 4: Player#1821 folded before the flop
Seat 5: Player#5392 folded before the flop
Seat 6: warioman (button) folded before the flop

PokerStars Hand #58559fab-9bc5-4af9-b0cb-bc2876048abc:  Hold'em No Limit ($0.1/$0.20 USD) - 2021/11/19 22:12:00 ET
Table 'Bel Air' 6-max Seat #5 is the button
Seat 1: Player#6675 ($35.57 in chips)
Seat 2: Player#3969 ($7.40 in chips)
Seat 3: Player#0380 ($17.98 in chips)
Seat 4: Player#1766 ($47.14 in chips)
Seat 5: Player#9118 ($23.00 in chips)
Seat 6: warioman ($22.58 in chips)
warioman: posts small blind $0.10
Player#6675: posts big blind $0.20
*** HOLE CARDS ***
Dealt to warioman [2c Kd]
Player#3969: folds
Player#0380: folds
Player#1766: raises $0.20 to $0.5
Player#9118: folds
warioman: folds
Player#6675: folds
Player#6675: doesn't show hand
Player#3969: doesn't show hand
Player#0380: doesn't show hand
Player#1766: doesn't show hand
Player#9118: doesn't show hand
warioman: doesn't show hand
Uncalled bet ($0.50) returned to Player#1766
Player#1766 collected $0.30 from pot
*** SUMMARY ***
Total Pot $0.30 | Rake $0.00
Seat 1: Player#6675 (big blind) folded before the flop
Seat 2: Player#3969 folded before the flop
Seat 3: Player#0380 folded before the flop
Seat 4: Player#1766 shows [] and won ($0.30) with 
Seat 5: Player#9118 (button) folded before the flop
Seat 6: warioman (small blind) folded before the flop

PokerStars Hand #4cd713bb-415e-4898-98e8-a77f0624cf0b:  Hold'em No Limit ($0.1/$0.20 USD) - 2021/11/19 22:12:00 ET
Table 'Bel Air' 6-max Seat #4 is the button
Seat 1: Player#3643 ($35.57 in chips)
Seat 2: Player#1756 ($7.40 in chips)
Seat 3: Player#7117 ($17.34 in chips)
Seat 4: Player#6474 ($47.14 in chips)
Seat 5: Player#8153 ($23.10 in chips)
Seat 6: warioman ($23.18 in chips)
Player#8153: posts small blind $0.10
warioman: posts big blind $0.20
*** HOLE CARDS ***
Dealt to warioman [Td 7d]
Player#3643: folds
Player#1756: folds
Player#7117: raises $0.20 to $0.6
Player#6474: folds
Player#8153: folds
warioman: calls $0.40
*** FLOP *** [5c Ts 3c]
warioman: checks
Player#7117: bets $1.30
warioman: folds
Player#7117: doesn't show hand
Uncalled bet ($1.30) returned to Player#7117
Player#7117 collected $1.24 from pot
*** SUMMARY ***
Total Pot $1.30 | Rake $0.07
Board [5c Ts 3c]
Seat 1: Player#3643 folded before the flop
Seat 2: Player#1756 folded before the flop
Seat 3: Player#7117 shows [] and won ($1.24) with 
Seat 4: Player#6474 (button) folded before the flop
Seat 5: Player#8153 (small blind) folded before the flop
Seat 6: warioman (big blind) folded on the flop

PokerStars Hand #cfbed605-8a2b-4c43-9a12-b0bd7da14c40:  Hold'em No Limit ($0.1/$0.20 USD) - 2021/11/19 22:12:00 ET
Table 'Huntsville' 6-max Seat #3 is the button
Seat 1: Player#0597 ($44.60 in chips)
Seat 2: warioman ($19.30 in chips)
Seat 3: Player#5207 ($57.30 in chips)
Seat 4: Player#3123 ($20.68 in chips)
Seat 5: Player#6046 ($13.00 in chips)
Seat 6: Player#2898 ($8.37 in chips)
Player#3123: posts small blind $0.10
Player#6046: posts big blind $0.20
*** HOLE CARDS ***
Dealt to warioman [Ts 8s]
Player#2898: folds
Player#0597: folds
warioman: raises $0.20 to $0.5
Player#5207: folds
Player#3123: calls $0.40
Player#6046: folds
*** FLOP *** [Js 2s 2c]
Player#3123: bets $0.60
warioman: calls $0.60
*** TURN *** [Js 2s 2c] [8h]
Player#3123: bets $1.80
warioman: calls $1.80
*** RIVER *** [Js 2s 2c] [8h] [4h]
Player#3123: bets $3.00
warioman: folds
Player#3123: doesn't show hand
Uncalled bet ($3.00) returned to Player#3123
Player#3123 collected $5.70 from pot
*** SUMMARY ***
Total Pot $6.00 | Rake $0.30
Board [Js 2s 2c 8h 4h]
Seat 1: Player#0597 folded before the flop
Seat 2: warioman folded on the river
Seat 3: Player#5207 (button) folded before the flop
Seat 4: Player#3123 shows [] and won ($5.70) with 
Seat 5: Player#6046 (big blind) folded before the flop
Seat 6: Player#2898 folded before the flop

PokerStars Hand #8535b650-4025-4911-aa6e-aefdd0ab72bb:  Hold'em No Limit ($0.1/$0.20 USD) - 2021/11/19 22:11:00 ET
Table 'Huntsville' 6-max Seat #4 is the button
Seat 1: Player#8997 ($39.24 in chips)
Seat 2: warioman ($19.30 in chips)
Seat 3: Player#7940 ($62.20 in chips)
Seat 4: Player#5138 ($20.88 in chips)
Seat 5: Player#7252 ($13.00 in chips)
Seat 6: Player#1334 ($9.17 in chips)
Player#7252: posts small blind $0.10
Player#7940: posts big blind $0.20
*** HOLE CARDS ***
Dealt to warioman [7c 4c]
Player#7252 Waiting
Player#1334: calls $0.20
Player#8997: raises $0.20 to $0.8
warioman: folds
Player#7940: calls $0.70
Player#5138: folds
Player#1334: calls $0.60
*** FLOP *** [3h Js 3c]
Player#7940: checks
Player#1334: checks
Player#8997: bets $1.40
Player#7940: calls $1.40
Player#1334: folds
*** TURN *** [3h Js 3c] [6c]
Player#7940: checks
Player#8997: checks
*** RIVER *** [3h Js 3c] [6c] [Kc]
Player#7940: bets $2.70
Player#8997: calls $2.70
*** SHOW DOWN *** 
Player#8997 collected $10.26 from pot
*** SUMMARY ***
Total Pot $10.80 | Rake $0.54
Board [3h Js 3c 6c Kc]
Seat 1: Player#8997 shows [Qc Jh] and won ($10.26) with 
Seat 2: warioman folded before the flop
Seat 3: Player#7940 (big blind) mucked
Seat 4: Player#5138 (button) folded before the flop
Seat 5: Player#7252 (small blind) mucked
Seat 6: Player#1334 folded on the flop

PokerStars Hand #15bb7369-decc-40d5-b3a3-cfab12cf7235:  Hold'em No Limit ($0.1/$0.20 USD) - 2021/11/19 22:11:00 ET
Table 'Bel Air' 6-max Seat #3 is the button
Seat 1: Player#0382 ($34.74 in chips)
Seat 2: Player#3815 ($8.00 in chips)
Seat 3: Player#5127 ($17.34 in chips)
Seat 4: Player#4990 ($47.24 in chips)
Seat 5: Player#3316 ($23.30 in chips)
Seat 6: warioman ($23.18 in chips)
Player#4990: posts small blind $0.10
Player#3316: posts big blind $0.20
*** HOLE CARDS ***
Dealt to warioman [9d Qs]
Player#3815 Entry Bet 0.2
warioman: folds
Player#0382: calls $0.20
Player#3815: checks
Player#5127: folds
Player#4990: folds
Player#3316: checks
*** FLOP *** [4s 7d 7s]
Player#3316: checks
Player#0382: checks
Player#3815: bets $0.40
Player#3316: folds
Player#0382: calls $0.40
*** TURN *** [4s 7d 7s] [Jc]
Player#0382: checks
Player#3815: checks
*** RIVER *** [4s 7d 7s] [Jc] [4c]
Player#0382: bets $0.60
Player#3815: folds
Player#0382: doesn't show hand
Uncalled bet ($0.60) returned to Player#0382
Player#0382 collected $1.23 from pot
*** SUMMARY ***
Total Pot $1.30 | Rake $0.06
Board [4s 7d 7s Jc 4c]
Seat 1: Player#0382 shows [] and won ($1.23) with 
Seat 2: Player#3815 folded on the river
Seat 3: Player#5127 (button) folded before the flop
Seat 4: Player#4990 (small blind) folded before the flop
Seat 5: Player#3316 (big blind) folded on the flop
Seat 6: warioman folded before the flop

PokerStars Hand #1094e44d-5922-4f90-8cb2-4b4fc38719bf:  Hold'em No Limit ($0.1/$0.20 USD) - 2021/11/19 22:11:00 ET
Table 'Bel Air' 6-max Seat #1 is the button
Seat 1: Player#5849 ($34.74 in chips)
Seat 2: Player#3228 ($17.44 in chips)
Seat 3: Player#7759 ($47.44 in chips)
Seat 4: Player#6899 ($23.30 in chips)
Seat 5: warioman ($22.88 in chips)
Player#3228: posts small blind $0.10
Player#7759: posts big blind $0.20
*** HOLE CARDS ***
Dealt to warioman [Td Kd]
Player#6899: folds
warioman: raises $0.20 to $0.5
Player#5849: folds
Player#3228: folds
Player#7759: folds
warioman: doesn't show hand
Uncalled bet ($0.50) returned to warioman
warioman collected $0.30 from pot
*** SUMMARY ***
Total Pot $0.30 | Rake $0.00
Seat 1: Player#5849 (button) folded before the flop
Seat 2: Player#3228 (small blind) folded before the flop
Seat 3: Player#7759 (big blind) folded before the flop
Seat 4: Player#6899 folded before the flop
Seat 5: warioman

PokerStars Hand #f71b55a4-371a-4316-bc51-1227ae633d2e:  Hold'em No Limit ($0.1/$0.20 USD) - 2021/11/19 22:10:00 ET
Table 'Huntsville' 6-max Seat #1 is the button
Seat 1: Player#3073 ($39.24 in chips)
Seat 2: warioman ($19.40 in chips)
Seat 3: Player#5413 ($62.40 in chips)
Seat 4: Player#8822 ($19.38 in chips)
Seat 5: Player#8463 ($10.52 in chips)
warioman: posts small blind $0.10
Player#5413: posts big blind $0.20
*** HOLE CARDS ***
Dealt to warioman [4s 9s]
Player#8822: raises $0.20 to $0.6
Player#8463: calls $0.60
Player#3073: folds
warioman: folds
Player#5413: folds
*** FLOP *** [Ah Jc 2s]
Player#8822: checks
Player#8463: bets $0.75
Player#8822: calls $0.75
*** TURN *** [Ah Jc 2s] [5s]
Player#8822: checks
Player#8463: checks
*** RIVER *** [Ah Jc 2s] [5s] [4s]
Player#8822: bets $3.00
Player#8463: folds
Player#8822: doesn't show hand
Uncalled bet ($3.00) returned to Player#8822
Player#8822 collected $2.85 from pot
*** SUMMARY ***
Total Pot $3.00 | Rake $0.15
Board [Ah Jc 2s 5s 4s]
Seat 1: Player#3073 (button) folded before the flop
Seat 2: warioman (small blind) folded before the flop
Seat 3: Player#5413 (big blind) folded before the flop
Seat 4: Player#8822 shows [] and won ($2.85) with 
Seat 5: Player#8463 folded on the river

PokerStars Hand #43fd78d5-2718-4e5b-9844-298cbc468581:  Hold'em No Limit ($0.1/$0.20 USD) - 2021/11/19 22:10:00 ET
Table 'Bel Air' 6-max Seat #6 is the button
Seat 1: Player#2455 ($34.94 in chips)
Seat 2: Player#1663 ($17.26 in chips)
Seat 3: Player#2564 ($47.44 in chips)
Seat 4: Player#1961 ($23.30 in chips)
Seat 5: warioman ($22.88 in chips)
Player#2455: posts small blind $0.10
Player#1663: posts big blind $0.20
*** HOLE CARDS ***
Dealt to warioman [5d 4c]
Player#2564: folds
Player#1961: folds
warioman: folds
Player#2455: calls $0.10
Player#1663: checks
*** FLOP *** [4d 6s Kd]
Player#2455: checks
Player#1663: bets $0.40
Player#2455: folds
Player#1663: doesn't show hand
Uncalled bet ($0.40) returned to Player#1663
Player#1663 collected $0.38 from pot
*** SUMMARY ***
Total Pot $0.40 | Rake $0.02
Board [4d 6s Kd]
Seat 1: Player#2455 (small blind) folded on the flop
Seat 2: Player#1663 shows [] and won ($0.38) with 
Seat 3: Player#2564 folded before the flop
Seat 4: Player#1961 folded before the flop
Seat 5: warioman folded before the flop

PokerStars Hand #f2abfe4f-88b5-4b2b-b305-a1818226c549:  Hold'em No Limit ($0.1/$0.20 USD) - 2021/11/19 22:10:00 ET
Table 'Bel Air' 6-max Seat #4 is the button
Seat 1: Player#6545 ($35.14 in chips)
Seat 2: Player#0889 ($17.26 in chips)
Seat 3: Player#0295 ($47.44 in chips)
Seat 4: Player#8461 ($23.30 in chips)
Seat 5: warioman ($22.68 in chips)
warioman: posts small blind $0.10
Player#6545: posts big blind $0.20
*** HOLE CARDS ***
Dealt to warioman [7c Kh]
Player#0889: folds
Player#0295: folds
Player#8461: folds
warioman: raises $0.20 to $0.6
Player#6545: folds
warioman: doesn't show hand
Uncalled bet ($0.60) returned to warioman
warioman collected $0.20 from pot
*** SUMMARY ***
Total Pot $0.20 | Rake $0.00
Seat 1: Player#6545 (big blind) folded before the flop
Seat 2: Player#0889 folded before the flop
Seat 3: Player#0295 folded before the flop
Seat 4: Player#8461 (button) folded before the flop
Seat 5: warioman (small blind)

PokerStars Hand #0211a8f3-fdc0-4f98-8c9a-1848dc8cac72:  Hold'em No Limit ($0.1/$0.20 USD) - 2021/11/19 22:09:00 ET
Table 'Bel Air' 6-max Seat #3 is the button
Seat 1: Player#4380 ($33.03 in chips)
Seat 2: Player#1652 ($19.28 in chips)
Seat 3: Player#1685 ($47.44 in chips)
Seat 4: Player#4359 ($23.40 in chips)
Seat 5: warioman ($22.88 in chips)
Player#4359: posts small blind $0.10
warioman: posts big blind $0.20
*** HOLE CARDS ***
Dealt to warioman [Js 5c]
Player#4380: calls $0.20
Player#1652: raises $0.20 to $0.6
Player#1685: folds
Player#4359: folds
warioman: folds
Player#4380: calls $0.40
*** FLOP *** [Ks 4h 3h]
Player#4380: checks
Player#1652: bets $1.42
Player#4380: calls $1.42
*** TURN *** [Ks 4h 3h] [2c]
Player#4380: checks
Player#1652: checks
*** RIVER *** [Ks 4h 3h] [2c] [8c]
Player#4380: bets $5.14
Player#1652: folds
Player#4380: doesn't show hand
Uncalled bet ($5.14) returned to Player#4380
Player#4380 collected $4.12 from pot
*** SUMMARY ***
Total Pot $4.34 | Rake $0.22
Board [Ks 4h 3h 2c 8c]
Seat 1: Player#4380 shows [] and won ($4.12) with 
Seat 2: Player#1652 folded on the river
Seat 3: Player#1685 (button) folded before the flop
Seat 4: Player#4359 (small blind) folded before the flop
Seat 5: warioman (big blind) folded before the flop

PokerStars Hand #01b2fb7f-c7c4-4f8e-9378-59d8651234f8:  Hold'em No Limit ($0.1/$0.20 USD) - 2021/11/19 22:09:00 ET
Table 'Huntsville' 6-max Seat #6 is the button
Seat 1: Player#3797 ($31.51 in chips)
Seat 2: warioman ($20.00 in chips)
Seat 3: Player#6435 ($62.40 in chips)
Seat 4: Player#6789 ($24.38 in chips)
Seat 5: Player#2917 ($12.70 in chips)
Seat 6: Player#3637 ($12.72 in chips)
Player#3797: posts small blind $0.10
warioman: posts big blind $0.20
*** HOLE CARDS ***
Dealt to warioman [As Jc]
Player#6435: folds
Player#6789: raises $0.20 to $0.6
Player#2917: calls $0.60
Player#3637: calls $0.60
Player#3797: calls $0.50
warioman: calls $0.40
*** FLOP *** [5d 9s Qh]
Player#3797: bets $1.60
warioman: folds
Player#6789: calls $1.60
Player#2917: folds
Player#3637: calls $1.60
*** TURN *** [5d 9s Qh] [7c]
Player#3797: bets $2.80
Player#6789: calls $2.80
Player#3637: folds
*** RIVER *** [5d 9s Qh] [7c] [7c]
Player#3797: bets $10.05
Player#6789: folds
Player#3797: doesn't show hand
Uncalled bet ($10.05) returned to Player#3797
Player#3797 collected $12.73 from pot
*** SUMMARY ***
Total Pot $13.40 | Rake $0.67
Board [5d 9s Qh 7c 7c]
Seat 1: Player#3797 shows [] and won ($12.73) with 
Seat 2: warioman (big blind) folded on the flop
Seat 3: Player#6435 folded before the flop
Seat 4: Player#6789 folded on the river
Seat 5: Player#2917 folded on the flop
Seat 6: Player#3637 (button) folded on the turn

PokerStars Hand #906d6296-2491-4305-8bed-d1ffd697fee3:  Hold'em No Limit ($0.1/$0.20 USD) - 2021/11/19 22:09:00 ET
Table 'Bel Air' 6-max Seat #2 is the button
Seat 1: Player#4513 ($33.03 in chips)
Seat 2: Player#4377 ($19.48 in chips)
Seat 3: Player#9112 ($47.54 in chips)
Seat 4: Player#6823 ($23.10 in chips)
Seat 5: warioman ($22.88 in chips)
Player#9112: posts small blind $0.10
Player#6823: posts big blind $0.20
*** HOLE CARDS ***
Dealt to warioman [7c Ad]
warioman: folds
Player#4513: folds
Player#4377: calls $0.20
Player#9112: folds
Player#6823: raises $0.20 to $0.8
Player#4377: folds
Player#6823: doesn't show hand
Uncalled bet ($0.80) returned to Player#6823
Player#6823 collected $0.30 from pot
*** SUMMARY ***
Total Pot $0.30 | Rake $0.00
Seat 1: Player#4513 folded before the flop
Seat 2: Player#4377 (button) folded before the flop
Seat 3: Player#9112 (small blind) folded before the flop
Seat 4: Player#6823 shows [] and won ($0.30) with 
Seat 5: warioman folded before the flop

PokerStars Hand #8be012bc-5374-4a65-8c7e-eb6aaa278354:  Hold'em No Limit ($0.1/$0.20 USD) - 2021/11/19 22:09:00 ET
Table 'Bel Air' 6-max Seat #1 is the button
Seat 1: Player#8625 ($33.03 in chips)
Seat 2: Player#4060 ($19.58 in chips)
Seat 3: Player#8660 ($47.74 in chips)
Seat 4: Player#2183 ($23.10 in chips)
Seat 5: warioman ($22.58 in chips)
Player#4060: posts small blind $0.10
Player#8660: posts big blind $0.20
*** HOLE CARDS ***
Dealt to warioman [9d Td]
Player#2183: folds
warioman: raises $0.20 to $0.5
Player#8625: folds
Player#4060: folds
Player#8660: folds
warioman: doesn't show hand
Uncalled bet ($0.50) returned to warioman
warioman collected $0.30 from pot
*** SUMMARY ***
Total Pot $0.30 | Rake $0.00
Seat 1: Player#8625 (button) folded before the flop
Seat 2: Player#4060 (small blind) folded before the flop
Seat 3: Player#8660 (big blind) folded before the flop
Seat 4: Player#2183 folded before the flop
Seat 5: warioman

PokerStars Hand #94672127-f60f-4c9d-9301-664702cefa7b:  Hold'em No Limit ($0.1/$0.20 USD) - 2021/11/19 22:08:00 ET
Table 'Bel Air' 6-max Seat #6 is the button
Seat 1: Player#4304 ($33.13 in chips)
Seat 2: Player#8820 ($19.48 in chips)
Seat 3: Player#8471 ($47.74 in chips)
Seat 4: Player#6025 ($23.10 in chips)
Seat 5: warioman ($22.58 in chips)
Player#4304: posts small blind $0.10
Player#8820: posts big blind $0.20
*** HOLE CARDS ***
Dealt to warioman [5s Js]
Player#8471: folds
Player#6025: folds
warioman: folds
Player#4304: folds
Player#8820 collected $0.20 from pot
*** SUMMARY ***
Total Pot $0.20 | Rake $0.00
Seat 1: Player#4304 (small blind) folded before the flop
Seat 2: Player#8820 shows [] and won ($0.20) with 
Seat 3: Player#8471 folded before the flop
Seat 4: Player#6025 folded before the flop
Seat 5: warioman folded before the flop

PokerStars Hand #b045d955-9add-4a99-882b-07e5cad90003:  Hold'em No Limit ($0.1/$0.20 USD) - 2021/11/19 22:08:00 ET
Table 'Huntsville' 6-max Seat #5 is the button
Seat 1: Player#0744 ($32.11 in chips)
Seat 2: warioman ($20.00 in chips)
Seat 3: Player#5828 ($62.40 in chips)
Seat 4: Player#8086 ($16.94 in chips)
Seat 5: Player#2995 ($19.70 in chips)
Seat 6: Player#9182 ($13.32 in chips)
Player#9182: posts small blind $0.10
Player#0744: posts big blind $0.20
*** HOLE CARDS ***
Dealt to warioman [Ts Jh]
warioman: folds
Player#5828: folds
Player#8086: raises $0.20 to $0.6
Player#2995: calls $0.60
Player#9182: calls $0.50
Player#0744: calls $0.40
*** FLOP *** [5d Ad Ks]
Player#9182: checks
Player#0744: checks
Player#8086: bets $1.20
Player#2995: raises $1.20 to $2.6
Player#9182: folds
Player#0744: folds
Player#8086: calls $1.40
*** TURN *** [5d Ad Ks] [9s]
Player#8086: checks
Player#2995: bets $3.80
Player#8086: calls $3.80
*** RIVER *** [5d Ad Ks] [9s] [Ts]
Player#8086: bets $9.94
Player#2995: folds
Player#8086: doesn't show hand
Uncalled bet ($9.94) returned to Player#8086
Player#8086 collected $14.44 from pot
*** SUMMARY ***
Total Pot $15.20 | Rake $0.76
Board [5d Ad Ks 9s Ts]
Seat 1: Player#0744 (big blind) folded on the flop
Seat 2: warioman folded before the flop
Seat 3: Player#5828 folded before the flop
Seat 4: Player#8086 shows [] and won ($14.44) with 
Seat 5: Player#2995 (button) folded on the river
Seat 6: Player#9182 (small blind) folded on the flop

PokerStars Hand #74cfad41-a4fb-4ac4-9e52-7691b9190de3:  Hold'em No Limit ($0.1/$0.20 USD) - 2021/11/19 22:08:00 ET
Table 'Bel Air' 6-max Seat #4 is the button
Seat 1: Player#4849 ($33.73 in chips)
Seat 2: Player#7219 ($19.48 in chips)
Seat 3: Player#6936 ($47.74 in chips)
Seat 4: Player#9899 ($22.46 in chips)
Seat 5: warioman ($22.68 in chips)
warioman: posts small blind $0.10
Player#4849: posts big blind $0.20
*** HOLE CARDS ***
Dealt to warioman [7h Kc]
Player#7219: folds
Player#6936: folds
Player#9899: raises $0.20 to $0.6
warioman: folds
Player#4849: calls $0.40
*** FLOP *** [7d Tc 5c]
Player#4849: checks
Player#9899: bets $1.00
Player#4849: folds
Player#9899: doesn't show hand
Uncalled bet ($1.00) returned to Player#9899
Player#9899 collected $1.24 from pot
*** SUMMARY ***
Total Pot $1.30 | Rake $0.07
Board [7d Tc 5c]
Seat 1: Player#4849 (big blind) folded on the flop
Seat 2: Player#7219 folded before the flop
Seat 3: Player#6936 folded before the flop
Seat 4: Player#9899 shows [] and won ($1.24) with 
Seat 5: warioman (small blind) folded before the flop

PokerStars Hand #7d5a89fb-50ab-4e04-84ae-66c47b743409:  Hold'em No Limit ($0.1/$0.20 USD) - 2021/11/19 22:08:00 ET
Table 'Bel Air' 6-max Seat #3 is the button
Seat 1: Player#5855 ($33.73 in chips)
Seat 2: Player#0139 ($19.48 in chips)
Seat 3: Player#5090 ($47.74 in chips)
Seat 4: Player#0615 ($22.56 in chips)
Seat 5: warioman ($22.58 in chips)
Player#0615: posts small blind $0.10
warioman: posts big blind $0.20
*** HOLE CARDS ***
Dealt to warioman [6s 7s]
Player#5855: folds
Player#0139: folds
Player#5090: folds
Player#0615: folds
warioman collected $0.20 from pot
*** SUMMARY ***
Total Pot $0.20 | Rake $0.00
Seat 1: Player#5855 folded before the flop
Seat 2: Player#0139 folded before the flop
Seat 3: Player#5090 (button) folded before the flop
Seat 4: Player#0615 (small blind) folded before the flop
Seat 5: warioman (big blind)

PokerStars Hand #4ef3c18e-eeb5-46ae-8221-87afabf04e4d:  Hold'em No Limit ($0.1/$0.20 USD) - 2021/11/19 22:08:00 ET
Table 'Bel Air' 6-max Seat #2 is the button
Seat 1: Player#8695 ($33.73 in chips)
Seat 2: Player#9964 ($19.48 in chips)
Seat 3: Player#0603 ($47.84 in chips)
Seat 4: Player#0257 ($22.76 in chips)
Seat 5: warioman ($22.28 in chips)
Player#0603: posts small blind $0.10
Player#0257: posts big blind $0.20
*** HOLE CARDS ***
Dealt to warioman [9c Jc]
warioman: raises $0.20 to $0.5
Player#8695: folds
Player#9964: folds
Player#0603: folds
Player#0257: folds
warioman: doesn't show hand
Uncalled bet ($0.50) returned to warioman
warioman collected $0.30 from pot
*** SUMMARY ***
Total Pot $0.30 | Rake $0.00
Seat 1: Player#8695 folded before the flop
Seat 2: Player#9964 (button) folded before the flop
Seat 3: Player#0603 (small blind) folded before the flop
Seat 4: Player#0257 (big blind) folded before the flop
Seat 5: warioman

PokerStars Hand #36f2bc62-4d8a-4293-abf7-918e33e66074:  Hold'em No Limit ($0.1/$0.20 USD) - 2021/11/19 22:07:00 ET
Table 'Bel Air' 6-max Seat #1 is the button
Seat 1: Player#4215 ($33.73 in chips)
Seat 2: Player#8659 ($19.58 in chips)
Seat 3: Player#3113 ($48.04 in chips)
Seat 4: Player#8331 ($22.76 in chips)
Seat 5: warioman ($21.98 in chips)
Player#8659: posts small blind $0.10
Player#3113: posts big blind $0.20
*** HOLE CARDS ***
Dealt to warioman [Js Kc]
Player#8331: folds
warioman: raises $0.20 to $0.5
Player#4215: folds
Player#8659: folds
Player#3113: folds
warioman: doesn't show hand
Uncalled bet ($0.50) returned to warioman
warioman collected $0.30 from pot
*** SUMMARY ***
Total Pot $0.30 | Rake $0.00
Seat 1: Player#4215 (button) folded before the flop
Seat 2: Player#8659 (small blind) folded before the flop
Seat 3: Player#3113 (big blind) folded before the flop
Seat 4: Player#8331 folded before the flop
Seat 5: warioman

PokerStars Hand #b0338fe7-e4e5-45fa-8e0c-3bb7207c6ec2:  Hold'em No Limit ($0.1/$0.20 USD) - 2021/11/19 22:07:00 ET
Table 'Bel Air' 6-max Seat #6 is the button
Seat 1: Player#8070 ($33.83 in chips)
Seat 2: Player#8179 ($19.48 in chips)
Seat 3: Player#8707 ($48.04 in chips)
Seat 4: Player#5522 ($22.76 in chips)
Seat 5: warioman ($21.98 in chips)
Player#8070: posts small blind $0.10
Player#8179: posts big blind $0.20
*** HOLE CARDS ***
Dealt to warioman [4d 2h]
Player#8707: folds
Player#5522: folds
warioman: folds
Player#8070: folds
Player#8179 collected $0.20 from pot
*** SUMMARY ***
Total Pot $0.20 | Rake $0.00
Seat 1: Player#8070 (small blind) folded before the flop
Seat 2: Player#8179 shows [] and won ($0.20) with 
Seat 3: Player#8707 folded before the flop
Seat 4: Player#5522 folded before the flop
Seat 5: warioman folded before the flop

PokerStars Hand #f27d959e-b852-4784-8a0e-5133fac857a5:  Hold'em No Limit ($0.1/$0.20 USD) - 2021/11/19 22:07:00 ET
Table 'Bel Air' 6-max Seat #4 is the button
Seat 1: Player#1890 ($34.03 in chips)
Seat 2: Player#4418 ($20.28 in chips)
Seat 3: Player#6132 ($48.04 in chips)
Seat 4: Player#8556 ($21.75 in chips)
Seat 5: warioman ($22.08 in chips)
warioman: posts small blind $0.10
Player#1890: posts big blind $0.20
*** HOLE CARDS ***
Dealt to warioman [Kc 4d]
Player#4418: calls $0.20
Player#6132: folds
Player#8556: raises $0.20 to $0.8
warioman: folds
Player#1890: folds
Player#4418: calls $0.60
*** FLOP *** [6d 4h 3h]
Player#4418: checks
Player#8556: bets $1.40
Player#4418: folds
Player#8556: doesn't show hand
Uncalled bet ($1.40) returned to Player#8556
Player#8556 collected $1.80 from pot
*** SUMMARY ***
Total Pot $1.90 | Rake $0.10
Board [6d 4h 3h]
Seat 1: Player#1890 (big blind) folded before the flop
Seat 2: Player#4418 folded on the flop
Seat 3: Player#6132 folded before the flop
Seat 4: Player#8556 shows [] and won ($1.80) with 
Seat 5: warioman (small blind) folded before the flop

PokerStars Hand #12e95d31-d211-468a-b212-a7a39c26b5ab:  Hold'em No Limit ($0.1/$0.20 USD) - 2021/11/19 22:07:00 ET
Table 'Huntsville' 6-max Seat #4 is the button
Seat 1: Player#4344 ($32.11 in chips)
Seat 2: warioman ($20.00 in chips)
Seat 3: Player#0173 ($62.90 in chips)
Seat 4: Player#2314 ($13.50 in chips)
Seat 5: Player#0378 ($19.80 in chips)
Seat 6: Player#7135 ($14.87 in chips)
Player#0378: posts small blind $0.10
Player#7135: posts big blind $0.20
*** HOLE CARDS ***
Dealt to warioman [Kh Qh]
Player#4344: folds
warioman: raises $0.20 to $0.5
Player#0173: calls $0.50
Player#2314: calls $0.50
Player#0378: folds
Player#7135: calls $0.30
*** FLOP *** [3c Ts 2h]
Player#7135: checks
warioman: checks
Player#0173: checks
Player#2314: checks
*** TURN *** [3c Ts 2h] [Th]
Player#7135: bets $1.05
warioman: calls $1.05
Player#0173: folds
Player#2314: calls $1.05
*** RIVER *** [3c Ts 2h] [Th] [4h]
Player#7135: checks
warioman: checks
Player#2314: bets $2.63
Player#7135: folds
warioman: folds
Player#2314: doesn't show hand
Uncalled bet ($2.63) returned to Player#2314
Player#2314 collected $4.99 from pot
*** SUMMARY ***
Total Pot $5.25 | Rake $0.26
Board [3c Ts 2h Th 4h]
Seat 1: Player#4344 folded before the flop
Seat 2: warioman folded on the river
Seat 3: Player#0173 folded on the turn
Seat 4: Player#2314 shows [] and won ($4.99) with 
Seat 5: Player#0378 (small blind) folded before the flop
Seat 6: Player#7135 (big blind) folded on the river

PokerStars Hand #40ac6c7c-82ec-429f-9872-a319691302f5:  Hold'em No Limit ($0.1/$0.20 USD) - 2021/11/19 22:06:00 ET
Table 'Bel Air' 6-max Seat #3 is the button
Seat 1: Player#8876 ($34.03 in chips)
Seat 2: Player#9899 ($20.00 in chips)
Seat 3: Player#0829 ($48.04 in chips)
Seat 4: Player#3506 ($21.85 in chips)
Seat 5: warioman ($22.28 in chips)
Player#3506: posts small blind $0.10
warioman: posts big blind $0.20
*** HOLE CARDS ***
Dealt to warioman [8s 2d]
Player#9899 Entry Bet 0.2
Player#8876: folds
Player#9899: checks
Player#0829: folds
Player#3506: folds
warioman: checks
*** FLOP *** [Qs Ad 9c]
warioman: checks
Player#9899: bets $0.50
warioman: folds
Player#9899: doesn't show hand
Uncalled bet ($0.50) returned to Player#9899
Player#9899 collected $0.29 from pot
*** SUMMARY ***
Total Pot $0.30 | Rake $0.02
Board [Qs Ad 9c]
Seat 1: Player#8876 folded before the flop
Seat 2: Player#9899 shows [] and won ($0.29) with 
Seat 3: Player#0829 (button) folded before the flop
Seat 4: Player#3506 (small blind) folded before the flop
Seat 5: warioman (big blind) folded on the flop

PokerStars Hand #c10f04fd-dc8c-4a36-bc73-ab1013235373:  Hold'em No Limit ($0.1/$0.20 USD) - 2021/11/19 22:06:00 ET
Table 'Bel Air' 6-max Seat #1 is the button
Seat 1: Player#4240 ($34.03 in chips)
Seat 2: Player#4982 ($48.14 in chips)
Seat 3: Player#3061 ($21.30 in chips)
Seat 4: warioman ($22.78 in chips)
Player#4982: posts small blind $0.10
Player#3061: posts big blind $0.20
*** HOLE CARDS ***
Dealt to warioman [8d Ac]
warioman: raises $0.20 to $0.5
Player#4240: folds
Player#4982: folds
Player#3061: calls $0.30
*** FLOP *** [7s Qs 5d]
Player#3061: checks
warioman: checks
*** TURN *** [7s Qs 5d] [Jh]
Player#3061: bets $1.00
warioman: folds
Player#3061: doesn't show hand
Uncalled bet ($1.00) returned to Player#3061
Player#3061 collected $1.05 from pot
*** SUMMARY ***
Total Pot $1.10 | Rake $0.06
Board [7s Qs 5d Jh]
Seat 1: Player#4240 (button) folded before the flop
Seat 2: Player#4982 (small blind) folded before the flop
Seat 3: Player#3061 shows [] and won ($1.05) with 
Seat 4: warioman folded on the turn

PokerStars Hand #74a0bbc9-9a24-4132-a1ec-129818ddf241:  Hold'em No Limit ($0.1/$0.20 USD) - 2021/11/19 22:06:00 ET
Table 'Bel Air' 6-max Seat #6 is the button
Seat 1: Player#1416 ($34.13 in chips)
Seat 2: Player#1161 ($11.68 in chips)
Seat 3: Player#7153 ($48.34 in chips)
Seat 4: Player#1828 ($21.00 in chips)
Seat 5: warioman ($22.78 in chips)
Player#1416: posts small blind $0.10
Player#7153: posts big blind $0.20
*** HOLE CARDS ***
Dealt to warioman [Td 3d]
Player#1161 Decline Entry Bet
Player#1828: raises $0.20 to $0.6
warioman: folds
Player#1416: folds
Player#7153: folds
Player#1828: doesn't show hand
Uncalled bet ($0.60) returned to Player#1828
Player#1828 collected $0.30 from pot
*** SUMMARY ***
Total Pot $0.30 | Rake $0.00
Seat 1: Player#1416 (small blind) folded before the flop
Seat 2: Player#1161 mucked
Seat 3: Player#7153 (big blind) folded before the flop
Seat 4: Player#1828 shows [] and won ($0.30) with 
Seat 5: warioman folded before the flop

PokerStars Hand #ea170819-608c-4db4-af9e-e65b608ea38b:  Hold'em No Limit ($0.1/$0.20 USD) - 2021/11/19 22:05:00 ET
Table 'Huntsville' 6-max Seat #3 is the button
Seat 1: Player#7074 ($32.11 in chips)
Seat 2: warioman ($19.22 in chips)
Seat 3: Player#3701 ($65.00 in chips)
Seat 4: Player#9092 ($13.60 in chips)
Seat 5: Player#4928 ($20.00 in chips)
Seat 6: Player#5648 ($10.70 in chips)
Player#9092: posts small blind $0.10
Player#4928: posts big blind $0.20
*** HOLE CARDS ***
Dealt to warioman [Kh As]
Player#5648: raises $0.20 to $0.6
Player#7074: folds
warioman: raises $0.60 to $2.1
Player#3701: calls $2.10
Player#9092: folds
Player#4928: folds
Player#5648: calls $1.50
*** FLOP *** [7c 5d Jc]
Player#5648: checks
warioman: checks
Player#3701: checks
*** TURN *** [7c 5d Jc] [4s]
Player#5648: checks
warioman: checks
Player#3701: checks
*** RIVER *** [7c 5d Jc] [4s] [3s]
Player#5648: bets $3.30
warioman: folds
Player#3701: folds
Player#5648: doesn't show hand
Uncalled bet ($3.30) returned to Player#5648
Player#5648 collected $6.27 from pot
*** SUMMARY ***
Total Pot $6.60 | Rake $0.33
Board [7c 5d Jc 4s 3s]
Seat 1: Player#7074 folded before the flop
Seat 2: warioman folded on the river
Seat 3: Player#3701 (button) folded on the river
Seat 4: Player#9092 (small blind) folded before the flop
Seat 5: Player#4928 (big blind) folded before the flop
Seat 6: Player#5648 shows [] and won ($6.27) with 

PokerStars Hand #22c2b55b-e4cb-40f9-b514-ff6aa8a182e0:  Hold'em No Limit ($0.1/$0.20 USD) - 2021/11/19 22:05:00 ET
Table 'Bel Air' 6-max Seat #5 is the button
Seat 1: Player#9650 ($34.33 in chips)
Seat 2: Player#7345 ($20.81 in chips)
Seat 3: Player#7048 ($11.38 in chips)
Seat 4: Player#5152 ($48.34 in chips)
Seat 5: Player#1796 ($21.00 in chips)
Seat 6: warioman ($22.88 in chips)
warioman: posts small blind $0.10
Player#9650: posts big blind $0.20
*** HOLE CARDS ***
Dealt to warioman [Qd 5h]
Player#7345: folds
Player#7048: raises $0.20 to $0.6
Player#5152: folds
Player#1796: folds
warioman: folds
Player#9650: folds
Player#7048: doesn't show hand
Uncalled bet ($0.60) returned to Player#7048
Player#7048 collected $0.30 from pot
*** SUMMARY ***
Total Pot $0.30 | Rake $0.00
Seat 1: Player#9650 (big blind) folded before the flop
Seat 2: Player#7345 folded before the flop
Seat 3: Player#7048 shows [] and won ($0.30) with 
Seat 4: Player#5152 folded before the flop
Seat 5: Player#1796 (button) folded before the flop
Seat 6: warioman (small blind) folded before the flop

PokerStars Hand #ccf5c1e5-6ebe-48e5-a765-41fcf57526d1:  Hold'em No Limit ($0.1/$0.20 USD) - 2021/11/19 22:05:00 ET
Table 'Bel Air' 6-max Seat #4 is the button
Seat 1: Player#4447 ($34.33 in chips)
Seat 2: Player#9790 ($20.51 in chips)
Seat 3: Player#1956 ($11.38 in chips)
Seat 4: Player#4497 ($48.34 in chips)
Seat 5: Player#7730 ($21.10 in chips)
Seat 6: warioman ($23.08 in chips)
Player#7730: posts small blind $0.10
warioman: posts big blind $0.20
*** HOLE CARDS ***
Dealt to warioman [Kc 2c]
Player#4447: folds
Player#9790: raises $0.20 to $0.75
Player#1956: folds
Player#4497: folds
Player#7730: folds
warioman: folds
Player#9790: doesn't show hand
Uncalled bet ($0.75) returned to Player#9790
Player#9790 collected $0.30 from pot
*** SUMMARY ***
Total Pot $0.30 | Rake $0.00
Seat 1: Player#4447 folded before the flop
Seat 2: Player#9790 shows [] and won ($0.30) with 
Seat 3: Player#1956 folded before the flop
Seat 4: Player#4497 (button) folded before the flop
Seat 5: Player#7730 (small blind) folded before the flop
Seat 6: warioman (big blind) folded before the flop

PokerStars Hand #08da3763-c80f-4ff0-b7ab-9dfa31004185:  Hold'em No Limit ($0.1/$0.20 USD) - 2021/11/19 22:05:00 ET
Table 'Bel Air' 6-max Seat #3 is the button
Seat 1: Player#0243 ($34.33 in chips)
Seat 2: Player#3951 ($20.51 in chips)
Seat 3: Player#5434 ($11.38 in chips)
Seat 4: Player#6456 ($48.44 in chips)
Seat 5: Player#1264 ($21.00 in chips)
Seat 6: warioman ($23.08 in chips)
Player#6456: posts small blind $0.10
Player#1264: posts big blind $0.20
*** HOLE CARDS ***
Dealt to warioman [7h Qc]
warioman: folds
Player#0243: folds
Player#3951: folds
Player#5434: folds
Player#6456: folds
Player#1264 collected $0.20 from pot
*** SUMMARY ***
Total Pot $0.20 | Rake $0.00
Seat 1: Player#0243 folded before the flop
Seat 2: Player#3951 folded before the flop
Seat 3: Player#5434 (button) folded before the flop
Seat 4: Player#6456 (small blind) folded before the flop
Seat 5: Player#1264 shows [] and won ($0.20) with 
Seat 6: warioman folded before the flop

PokerStars Hand #02b1df85-4169-432c-8bd8-9b6f19cc89e4:  Hold'em No Limit ($0.1/$0.20 USD) - 2021/11/19 22:04:00 ET
Table 'Bel Air' 6-max Seat #2 is the button
Seat 1: Player#2476 ($34.33 in chips)
Seat 2: Player#8853 ($20.21 in chips)
Seat 3: Player#4994 ($11.48 in chips)
Seat 4: Player#1936 ($48.64 in chips)
Seat 5: Player#1130 ($21.00 in chips)
Seat 6: warioman ($23.08 in chips)
Player#4994: posts small blind $0.10
Player#1936: posts big blind $0.20
*** HOLE CARDS ***
Dealt to warioman [Qc 5c]
Player#1130: folds
warioman: folds
Player#2476: folds
Player#8853: raises $0.20 to $0.75
Player#4994: folds
Player#1936: folds
Player#8853: doesn't show hand
Uncalled bet ($0.75) returned to Player#8853
Player#8853 collected $0.30 from pot
*** SUMMARY ***
Total Pot $0.30 | Rake $0.00
Seat 1: Player#2476 folded before the flop
Seat 2: Player#8853 shows [] and won ($0.30) with 
Seat 3: Player#4994 (small blind) folded before the flop
Seat 4: Player#1936 (big blind) folded before the flop
Seat 5: Player#1130 folded before the flop
Seat 6: warioman folded before the flop

PokerStars Hand #60a705e7-2f28-4bc0-b908-4367605e90c0:  Hold'em No Limit ($0.1/$0.20 USD) - 2021/11/19 22:04:00 ET
Table 'Huntsville' 6-max Seat #2 is the button
Seat 1: Player#0677 ($32.11 in chips)
Seat 2: warioman ($20.27 in chips)
Seat 3: Player#8541 ($65.10 in chips)
Seat 4: Player#6427 ($12.56 in chips)
Seat 5: Player#9832 ($20.00 in chips)
Seat 6: Player#2571 ($10.70 in chips)
Player#8541: posts small blind $0.10
Player#6427: posts big blind $0.20
*** HOLE CARDS ***
Dealt to warioman [Ad Kh]
Player#9832: folds
Player#2571: folds
Player#0677: folds
warioman: raises $0.20 to $0.5
Player#8541: folds
Player#6427: calls $0.30
*** FLOP *** [Jh 6s 7c]
Player#6427: checks
warioman: checks
Player#6427 collected $1.05 from pot
*** SUMMARY ***
Total Pot $1.10 | Rake $0.06
Board [Jh 6s 7c]
Seat 1: Player#0677 folded before the flop
Seat 2: warioman (button)
Seat 3: Player#8541 (small blind) folded before the flop
Seat 4: Player#6427 shows [] and won ($1.05) with 
Seat 5: Player#9832 folded before the flop
Seat 6: Player#2571 folded before the flop

