PokerStars Hand #6c693f6b-7c78-41e0-9f66-f08273aeb12e:  Hold'em No Limit ($0.1/$0.20 USD) - 2021/11/21 01:06:00 ET
Table 'Lacey' 6-max Seat #6 is the button
Seat 1: warioman ($59.02 in chips)
Seat 2: Player#1847 ($35.57 in chips)
warioman: posts small blind $0.10
Player#1847: posts big blind $0.20
*** HOLE CARDS ***
Dealt to warioman [9h 2d]
warioman: folds
Player#1847 collected $0.20 from pot
*** SUMMARY ***
Total Pot $0.20 | Rake $0.00
Seat 1: warioman (small blind) folded before the flop
Seat 2: Player#1847 shows [] and won ($0.20) with 

PokerStars Hand #9e17a9ec-1cba-4176-93a5-b2e75514ec4e:  Hold'em No Limit ($0.1/$0.20 USD) - 2021/11/21 01:05:00 ET
Table 'Denver' 6-max Seat #6 is the button
Seat 1: Player#5956 ($56.72 in chips)
Seat 2: warioman ($43.17 in chips)
Seat 3: Player#3362 ($14.16 in chips)
Player#5956: posts small blind $0.10
Player#3362: posts big blind $0.20
*** HOLE CARDS ***
Dealt to warioman []
warioman Decline Entry Bet
Player#5956: folds
Player#3362 collected $0.20 from pot
*** SUMMARY ***
Total Pot $0.20 | Rake $0.00
Seat 1: Player#5956 (small blind) folded before the flop
Seat 2: warioman
Seat 3: Player#3362 shows [] and won ($0.20) with 

PokerStars Hand #63c84b79-81fd-438a-bcd0-79ede98fef38:  Hold'em No Limit ($0.1/$0.20 USD) - 2021/11/21 01:05:00 ET
Table 'Lacey' 6-max Seat #6 is the button
Seat 1: warioman ($59.12 in chips)
Seat 2: Player#2295 ($10.81 in chips)
Seat 3: Player#2335 ($25.74 in chips)
warioman: posts small blind $0.10
Player#2295: posts big blind $0.20
*** HOLE CARDS ***
Dealt to warioman [2h Qc]
Player#2335: raises $0.20 to $0.4
warioman: folds
Player#2295: raises $0.40 to $0.65
Player#2335: calls $0.25
*** FLOP *** [2d Qd Ks]
Player#2295: bets $0.70
Player#2335: calls $0.70
*** TURN *** [2d Qd Ks] [7c]
Player#2295: bets $1.40
Player#2335: raises $ 21.40 to $24.39
Player#2295: calls $8.06
Player#2295 Showing Pocket Cards QA
Player#2335 Showing Pocket Cards K7
*** RIVER *** [2d Qd Ks] [7c] [3s]
Player#2335 collected $35.15 from pot
*** SUMMARY ***
Total Pot $36.65 | Rake $1.50
Board [2d Qd Ks 7c 3s]
Seat 1: warioman (small blind) folded before the flop
Seat 2: Player#2295 (big blind) mucked
Seat 3: Player#2335 shows [Kh 7s] and won ($35.15) with 

PokerStars Hand #acd28f82-1067-4748-b639-89b7b626650a:  Hold'em No Limit ($0.1/$0.20 USD) - 2021/11/21 01:05:00 ET
Table 'Denver' 6-max Seat #2 is the button
Seat 1: Player#2789 ($57.22 in chips)
Seat 2: warioman ($42.62 in chips)
Seat 3: Player#0716 ($14.26 in chips)
Player#0716: posts small blind $0.10
Player#2789: posts big blind $0.20
*** HOLE CARDS ***
Dealt to warioman [8h As]
warioman: raises $0.20 to $0.5
Player#0716: folds
Player#2789: calls $0.30
*** FLOP *** [6c Kd 3c]
Player#2789: checks
warioman: bets $0.33
Player#2789: folds
warioman: doesn't show hand
Uncalled bet ($0.33) returned to warioman
warioman collected $1.05 from pot
*** SUMMARY ***
Total Pot $1.10 | Rake $0.06
Board [6c Kd 3c]
Seat 1: Player#2789 (big blind) folded on the flop
Seat 2: warioman (button)
Seat 3: Player#0716 (small blind) folded before the flop

PokerStars Hand #1a8b8846-84c4-4efc-b3f5-e79a324bcaca:  Hold'em No Limit ($0.1/$0.20 USD) - 2021/11/21 01:05:00 ET
Table 'Lacey' 6-max Seat #2 is the button
Seat 1: warioman ($59.32 in chips)
Seat 2: Player#9775 ($10.51 in chips)
Seat 3: Player#1464 ($25.84 in chips)
Player#1464: posts small blind $0.10
warioman: posts big blind $0.20
*** HOLE CARDS ***
Dealt to warioman [Jc 5h]
Player#9775: raises $0.20 to $0.6
Player#1464: folds
warioman: folds
Player#9775: doesn't show hand
Uncalled bet ($0.60) returned to Player#9775
Player#9775 collected $0.30 from pot
*** SUMMARY ***
Total Pot $0.30 | Rake $0.00
Seat 1: warioman (big blind) folded before the flop
Seat 2: Player#9775 shows [] and won ($0.30) with 
Seat 3: Player#1464 (small blind) folded before the flop

PokerStars Hand #616032ed-6150-4016-94ed-272c7eaf91d4:  Hold'em No Limit ($0.1/$0.20 USD) - 2021/11/21 01:04:00 ET
Table 'Lacey' 6-max Seat #1 is the button
Seat 1: warioman ($59.32 in chips)
Seat 2: Player#7998 ($11.11 in chips)
Seat 3: Player#7883 ($25.24 in chips)
Player#7998: posts small blind $0.10
Player#7883: posts big blind $0.20
*** HOLE CARDS ***
Dealt to warioman [4h 3s]
warioman: folds
Player#7998: raises $0.20 to $0.6
Player#7883: raises $0.60 to $1.8
Player#7998: folds
Player#7883: doesn't show hand
Uncalled bet ($1.80) returned to Player#7883
Player#7883 collected $0.60 from pot
*** SUMMARY ***
Total Pot $0.60 | Rake $0.00
Seat 1: warioman (button) folded before the flop
Seat 2: Player#7998 (small blind) folded before the flop
Seat 3: Player#7883 shows [] and won ($0.60) with 

PokerStars Hand #64955ddf-7806-4904-b427-5779739c72e4:  Hold'em No Limit ($0.1/$0.20 USD) - 2021/11/21 01:04:00 ET
Table 'Denver' 6-max Seat #1 is the button
Seat 1: Player#8192 ($55.42 in chips)
Seat 2: warioman ($44.22 in chips)
Seat 3: Player#3575 ($14.46 in chips)
warioman: posts small blind $0.10
Player#3575: posts big blind $0.20
*** HOLE CARDS ***
Dealt to warioman [9d Td]
Player#8192: raises $0.20 to $0.4
warioman: raises $0.40 to $1.6
Player#3575: folds
Player#8192: raises1.60 to $5
warioman: folds
Player#8192: doesn't show hand
Uncalled bet ($5.00) returned to Player#8192
Player#8192 collected $1.80 from pot
*** SUMMARY ***
Total Pot $1.80 | Rake $0.00
Seat 1: Player#8192 shows [] and won ($1.80) with 
Seat 2: warioman (small blind) folded before the flop
Seat 3: Player#3575 (big blind) folded before the flop

PokerStars Hand #7ae128fc-6729-43cb-8bee-87d94f04bf8e:  Hold'em No Limit ($0.1/$0.20 USD) - 2021/11/21 01:04:00 ET
Table 'Denver' 6-max Seat #6 is the button
Seat 1: Player#3761 ($55.52 in chips)
Seat 2: Player#1234 ($63.91 in chips)
Seat 3: warioman ($44.12 in chips)
Seat 4: Player#2589 ($14.46 in chips)
Player#3761: posts small blind $0.10
warioman: posts big blind $0.20
*** HOLE CARDS ***
Dealt to warioman [6s 5d]
Player#1234 Decline Entry Bet
Player#2589: folds
Player#3761: folds
warioman collected $0.20 from pot
*** SUMMARY ***
Total Pot $0.20 | Rake $0.00
Seat 1: Player#3761 (small blind) folded before the flop
Seat 2: Player#1234 mucked
Seat 3: warioman (big blind)
Seat 4: Player#2589 folded before the flop

PokerStars Hand #c5a49a35-fc61-49c0-9e3d-70e1944ef06c:  Hold'em No Limit ($0.1/$0.20 USD) - 2021/11/21 01:03:00 ET
Table 'Denver' 6-max Seat #4 is the button
Seat 1: Player#3139 ($55.72 in chips)
Seat 2: Player#3041 ($55.72 in chips)
Seat 3: Player#3078 ($63.91 in chips)
Seat 4: warioman ($44.12 in chips)
Seat 5: Player#7964 ($14.28 in chips)
Player#7964: posts small blind $0.10
Player#3139: posts big blind $0.20
*** HOLE CARDS ***
Dealt to warioman [7c 3c]
Player#3041: folds
Player#3078: folds
warioman: folds
Player#7964: calls $0.10
Player#3139: checks
*** FLOP *** [7d 2c 9s]
Player#7964: checks
Player#3139: checks
*** TURN *** [7d 2c 9s] [As]
Player#7964: bets $0.30
Player#3139: folds
Player#7964: doesn't show hand
Uncalled bet ($0.30) returned to Player#7964
Player#7964 collected $0.38 from pot
*** SUMMARY ***
Total Pot $0.40 | Rake $0.02
Board [7d 2c 9s As]
Seat 1: Player#3139 (big blind) folded on the turn
Seat 2: Player#3041 folded before the flop
Seat 3: Player#3078 folded before the flop
Seat 4: warioman (button) folded before the flop
Seat 5: Player#7964 shows [] and won ($0.38) with 

PokerStars Hand #4e425be2-a9bd-47e4-876d-c8c76716c5ff:  Hold'em No Limit ($0.1/$0.20 USD) - 2021/11/21 01:03:00 ET
Table 'Lacey' 6-max Seat #6 is the button
Seat 1: warioman ($59.42 in chips)
Seat 2: Player#3186 ($11.96 in chips)
Seat 3: Player#3307 ($24.38 in chips)
warioman: posts small blind $0.10
Player#3186: posts big blind $0.20
*** HOLE CARDS ***
Dealt to warioman [5d 6d]
Player#3307: raises $0.20 to $0.4
warioman: folds
Player#3186: calls $0.20
*** FLOP *** [3s 8c 9s]
Player#3186: checks
Player#3307: checks
*** TURN *** [3s 8c 9s] [Th]
Player#3186: bets $0.45
Player#3307: calls $0.45
*** RIVER *** [3s 8c 9s] [Th] [Qh]
Player#3186: checks
Player#3307: bets $1.20
Player#3186: folds
Player#3307: doesn't show hand
Uncalled bet ($1.20) returned to Player#3307
Player#3307 collected $1.71 from pot
*** SUMMARY ***
Total Pot $1.80 | Rake $0.09
Board [3s 8c 9s Th Qh]
Seat 1: warioman (small blind) folded before the flop
Seat 2: Player#3186 (big blind) folded on the river
Seat 3: Player#3307 shows [] and won ($1.71) with 

PokerStars Hand #4517f5a2-2439-4729-b6f4-a9b1a04b4fd6:  Hold'em No Limit ($0.1/$0.20 USD) - 2021/11/21 01:03:00 ET
Table 'Lacey' 6-max Seat #2 is the button
Seat 1: warioman ($59.62 in chips)
Seat 2: Player#4354 ($11.96 in chips)
Seat 3: Player#0315 ($24.18 in chips)
Player#0315: posts small blind $0.10
warioman: posts big blind $0.20
*** HOLE CARDS ***
Dealt to warioman [Ts 2c]
Player#4354: folds
Player#0315: raises $0.20 to $0.6
warioman: folds
Player#0315: doesn't show hand
Uncalled bet ($0.60) returned to Player#0315
Player#0315 collected $0.20 from pot
*** SUMMARY ***
Total Pot $0.20 | Rake $0.00
Seat 1: warioman (big blind) folded before the flop
Seat 2: Player#4354 (button) folded before the flop
Seat 3: Player#0315 shows [] and won ($0.20) with 

PokerStars Hand #aaf1c20c-9af7-43c9-8000-172d7062da36:  Hold'em No Limit ($0.1/$0.20 USD) - 2021/11/21 01:03:00 ET
Table 'Denver' 6-max Seat #3 is the button
Seat 1: Player#3468 ($55.72 in chips)
Seat 2: Player#8175 ($56.47 in chips)
Seat 3: Player#8730 ($63.91 in chips)
Seat 4: warioman ($44.22 in chips)
Seat 5: Player#0992 ($13.43 in chips)
warioman: posts small blind $0.10
Player#0992: posts big blind $0.20
*** HOLE CARDS ***
Dealt to warioman [Jh 8c]
Player#3468: folds
Player#8175: raises $0.20 to $0.75
Player#8730: folds
warioman: folds
Player#0992: raises $0.75 to $1.9
Player#8175: folds
Player#0992: doesn't show hand
Uncalled bet ($1.90) returned to Player#0992
Player#0992 collected $0.85 from pot
*** SUMMARY ***
Total Pot $0.85 | Rake $0.00
Seat 1: Player#3468 folded before the flop
Seat 2: Player#8175 folded before the flop
Seat 3: Player#8730 (button) folded before the flop
Seat 4: warioman (small blind) folded before the flop
Seat 5: Player#0992 shows [] and won ($0.85) with 

PokerStars Hand #8246ece7-cc35-4db8-a513-bccf821862bc:  Hold'em No Limit ($0.1/$0.20 USD) - 2021/11/21 01:03:00 ET
Table 'Lacey' 6-max Seat #1 is the button
Seat 1: warioman ($59.62 in chips)
Seat 2: Player#1456 ($10.34 in chips)
Seat 3: Player#5599 ($25.98 in chips)
Player#1456: posts small blind $0.10
Player#5599: posts big blind $0.20
*** HOLE CARDS ***
Dealt to warioman [7c Jh]
warioman: folds
Player#1456: raises $0.20 to $0.6
Player#5599: raises $0.60 to $1.8
Player#1456: calls $1.20
*** FLOP *** [Td 4d As]
Player#1456: checks
Player#5599: checks
*** TURN *** [Td 4d As] [Kc]
Player#1456: bets $1.80
Player#5599: folds
Player#1456: doesn't show hand
Uncalled bet ($1.80) returned to Player#1456
Player#1456 collected $3.42 from pot
*** SUMMARY ***
Total Pot $3.60 | Rake $0.18
Board [Td 4d As Kc]
Seat 1: warioman (button) folded before the flop
Seat 2: Player#1456 shows [] and won ($3.42) with 
Seat 3: Player#5599 (big blind) folded on the turn

PokerStars Hand #601edcd4-76a7-4d16-a489-f8a5c3c160e7:  Hold'em No Limit ($0.1/$0.20 USD) - 2021/11/21 01:02:00 ET
Table 'Lacey' 6-max Seat #6 is the button
Seat 1: warioman ($59.42 in chips)
Seat 2: Player#3660 ($10.54 in chips)
Seat 3: Player#0242 ($25.98 in chips)
warioman: posts small blind $0.10
Player#3660: posts big blind $0.20
*** HOLE CARDS ***
Dealt to warioman [Kc Ks]
Player#0242: folds
warioman: raises $0.20 to $0.6
Player#3660: folds
warioman: doesn't show hand
Uncalled bet ($0.60) returned to warioman
warioman collected $0.20 from pot
*** SUMMARY ***
Total Pot $0.20 | Rake $0.00
Seat 1: warioman (small blind)
Seat 2: Player#3660 (big blind) folded before the flop
Seat 3: Player#0242 folded before the flop

PokerStars Hand #c1f94051-f88a-4d4f-ace0-971b8fa07d55:  Hold'em No Limit ($0.1/$0.20 USD) - 2021/11/21 01:02:00 ET
Table 'Lacey' 6-max Seat #2 is the button
Seat 1: warioman ($59.62 in chips)
Seat 2: Player#3477 ($10.24 in chips)
Seat 3: Player#7234 ($26.08 in chips)
Player#7234: posts small blind $0.10
warioman: posts big blind $0.20
*** HOLE CARDS ***
Dealt to warioman [Qh 3c]
Player#3477: raises $0.20 to $0.4
Player#7234: folds
warioman: folds
Player#3477: doesn't show hand
Uncalled bet ($0.40) returned to Player#3477
Player#3477 collected $0.30 from pot
*** SUMMARY ***
Total Pot $0.30 | Rake $0.00
Seat 1: warioman (big blind) folded before the flop
Seat 2: Player#3477 shows [] and won ($0.30) with 
Seat 3: Player#7234 (small blind) folded before the flop

PokerStars Hand #52d39837-f1b8-4ff1-93ce-18e91734911a:  Hold'em No Limit ($0.1/$0.20 USD) - 2021/11/21 01:02:00 ET
Table 'Denver' 6-max Seat #2 is the button
Seat 1: Player#5298 ($55.72 in chips)
Seat 2: Player#2637 ($56.47 in chips)
Seat 3: Player#6616 ($64.51 in chips)
Seat 4: warioman ($44.42 in chips)
Seat 5: Player#2613 ($12.70 in chips)
Player#6616: posts small blind $0.10
warioman: posts big blind $0.20
*** HOLE CARDS ***
Dealt to warioman [8h 3s]
Player#2613: raises $0.20 to $0.6
Player#5298: folds
Player#2637: folds
Player#6616: calls $0.50
warioman: folds
*** FLOP *** [8c 3d 4s]
Player#6616: checks
Player#2613: checks
*** TURN *** [8c 3d 4s] [Qs]
Player#6616: checks
Player#2613: checks
*** RIVER *** [8c 3d 4s] [Qs] [7s]
Player#6616: checks
Player#2613: checks
*** SHOW DOWN *** 
Player#2613 collected $1.33 from pot
*** SUMMARY ***
Total Pot $1.40 | Rake $0.07
Board [8c 3d 4s Qs 7s]
Seat 1: Player#5298 folded before the flop
Seat 2: Player#2637 (button) folded before the flop
Seat 3: Player#6616 (small blind) mucked
Seat 4: warioman (big blind) folded before the flop
Seat 5: Player#2613 shows [Qh Jh] and won ($1.33) with 

PokerStars Hand #170e4c76-1f3f-43d5-9da2-481f2a9440e8:  Hold'em No Limit ($0.1/$0.20 USD) - 2021/11/21 01:01:00 ET
Table 'Denver' 6-max Seat #1 is the button
Seat 1: Player#6644 ($57.32 in chips)
Seat 2: Player#1062 ($54.84 in chips)
Seat 3: Player#5877 ($64.71 in chips)
Seat 4: warioman ($44.42 in chips)
Seat 5: Player#6688 ($12.70 in chips)
Player#1062: posts small blind $0.10
Player#5877: posts big blind $0.20
*** HOLE CARDS ***
Dealt to warioman [2h Qc]
warioman: folds
Player#6688: folds
Player#6644: raises $0.20 to $0.6
Player#1062: raises $0.60 to $1.6
Player#5877: folds
Player#6644: calls $1.00
*** FLOP *** [5d 7h 3s]
Player#1062: bets $2.59
Player#6644: folds
Player#1062: doesn't show hand
Uncalled bet ($2.59) returned to Player#1062
Player#1062 collected $3.23 from pot
*** SUMMARY ***
Total Pot $3.40 | Rake $0.17
Board [5d 7h 3s]
Seat 1: Player#6644 (button) folded on the flop
Seat 2: Player#1062 shows [] and won ($3.23) with 
Seat 3: Player#5877 (big blind) folded before the flop
Seat 4: warioman folded before the flop
Seat 5: Player#6688 folded before the flop

PokerStars Hand #8554a360-91df-46e1-9cac-d30f1c7a9e9f:  Hold'em No Limit ($0.1/$0.20 USD) - 2021/11/21 01:01:00 ET
Table 'Lacey' 6-max Seat #1 is the button
Seat 1: warioman ($61.17 in chips)
Seat 2: Player#4811 ($10.34 in chips)
Seat 3: Player#4668 ($24.59 in chips)
Player#4811: posts small blind $0.10
Player#4668: posts big blind $0.20
*** HOLE CARDS ***
Dealt to warioman [Kc 9d]
warioman: raises $0.20 to $0.5
Player#4811: folds
Player#4668: calls $0.30
*** FLOP *** [6h 8c 4s]
Player#4668: bets $0.20
warioman: calls $0.20
*** TURN *** [6h 8c 4s] [Ks]
Player#4668: checks
warioman: bets $0.85
Player#4668: calls $0.85
*** RIVER *** [6h 8c 4s] [Ks] [2s]
Player#4668: bets $4.80
warioman: folds
Player#4668: doesn't show hand
Uncalled bet ($4.80) returned to Player#4668
Player#4668 collected $3.04 from pot
*** SUMMARY ***
Total Pot $3.20 | Rake $0.16
Board [6h 8c 4s Ks 2s]
Seat 1: warioman (button) folded on the river
Seat 2: Player#4811 (small blind) folded before the flop
Seat 3: Player#4668 shows [] and won ($3.04) with 

PokerStars Hand #e2cf712a-7471-4b68-9246-4ab9991cd065:  Hold'em No Limit ($0.1/$0.20 USD) - 2021/11/21 01:01:00 ET
Table 'Lacey' 6-max Seat #6 is the button
Seat 1: warioman ($61.27 in chips)
Seat 2: Player#5409 ($10.24 in chips)
Seat 3: Player#3441 ($24.59 in chips)
warioman: posts small blind $0.10
Player#5409: posts big blind $0.20
*** HOLE CARDS ***
Dealt to warioman [9d 7s]
Player#3441: folds
warioman: folds
Player#5409 collected $0.20 from pot
*** SUMMARY ***
Total Pot $0.20 | Rake $0.00
Seat 1: warioman (small blind) folded before the flop
Seat 2: Player#5409 shows [] and won ($0.20) with 
Seat 3: Player#3441 folded before the flop

PokerStars Hand #90b26b42-e1d2-474d-89c6-ca7d027e4a47:  Hold'em No Limit ($0.1/$0.20 USD) - 2021/11/21 01:01:00 ET
Table 'Lacey' 6-max Seat #2 is the button
Seat 1: warioman ($61.47 in chips)
Seat 2: Player#8256 ($9.94 in chips)
Seat 3: Player#8759 ($24.69 in chips)
Player#8759: posts small blind $0.10
warioman: posts big blind $0.20
*** HOLE CARDS ***
Dealt to warioman [5s 7d]
Player#8256: raises $0.20 to $0.6
Player#8759: folds
warioman: folds
Player#8256: doesn't show hand
Uncalled bet ($0.60) returned to Player#8256
Player#8256 collected $0.30 from pot
*** SUMMARY ***
Total Pot $0.30 | Rake $0.00
Seat 1: warioman (big blind) folded before the flop
Seat 2: Player#8256 shows [] and won ($0.30) with 
Seat 3: Player#8759 (small blind) folded before the flop

PokerStars Hand #857e7dc6-8042-4afe-90fc-d249990343e0:  Hold'em No Limit ($0.1/$0.20 USD) - 2021/11/21 01:01:00 ET
Table 'Denver' 6-max Seat #6 is the button
Seat 1: Player#0756 ($57.42 in chips)
Seat 2: Player#0647 ($55.04 in chips)
Seat 3: Player#5699 ($61.09 in chips)
Seat 4: warioman ($44.42 in chips)
Seat 5: Player#3424 ($16.40 in chips)
Player#0756: posts small blind $0.10
Player#0647: posts big blind $0.20
*** HOLE CARDS ***
Dealt to warioman [7c 2d]
Player#5699: raises $0.20 to $0.6
warioman: folds
Player#3424: calls $0.60
Player#0756: folds
Player#0647: folds
*** FLOP *** [Qh 3d 2h]
Player#5699: bets $0.20
Player#3424: raises $0.20 to $1.3
Player#5699: calls $1.10
*** TURN *** [Qh 3d 2h] [Tc]
Player#5699: checks
Player#3424: bets $1.80
Player#5699: calls $1.80
*** RIVER *** [Qh 3d 2h] [Tc] [Ac]
Player#5699: checks
Player#3424: checks
*** SHOW DOWN *** 
Player#5699 collected $7.31 from pot
*** SUMMARY ***
Total Pot $7.70 | Rake $0.39
Board [Qh 3d 2h Tc Ac]
Seat 1: Player#0756 (small blind) folded before the flop
Seat 2: Player#0647 (big blind) folded before the flop
Seat 3: Player#5699 shows [Td Ac] and won ($7.31) with 
Seat 4: warioman folded before the flop
Seat 5: Player#3424 mucked

PokerStars Hand #55694776-6ae8-4f58-a759-2efc78f13805:  Hold'em No Limit ($0.1/$0.20 USD) - 2021/11/21 01:00:00 ET
Table 'Lacey' 6-max Seat #1 is the button
Seat 1: warioman ($61.17 in chips)
Seat 2: Player#6116 ($10.04 in chips)
Seat 3: Player#5676 ($24.89 in chips)
Player#6116: posts small blind $0.10
Player#5676: posts big blind $0.20
*** HOLE CARDS ***
Dealt to warioman [Qc Js]
warioman: raises $0.20 to $0.5
Player#6116: folds
Player#5676: folds
warioman: doesn't show hand
Uncalled bet ($0.50) returned to warioman
warioman collected $0.30 from pot
*** SUMMARY ***
Total Pot $0.30 | Rake $0.00
Seat 1: warioman (button)
Seat 2: Player#6116 (small blind) folded before the flop
Seat 3: Player#5676 (big blind) folded before the flop

PokerStars Hand #dc81ff50-f8b9-4079-a92a-5647aee74c60:  Hold'em No Limit ($0.1/$0.20 USD) - 2021/11/21 01:00:00 ET
Table 'Denver' 6-max Seat #4 is the button
Seat 1: Player#9224 ($57.62 in chips)
Seat 2: Player#6332 ($54.74 in chips)
Seat 3: Player#7068 ($61.09 in chips)
Seat 4: warioman ($44.42 in chips)
Seat 5: Player#7583 ($16.50 in chips)
Player#7583: posts small blind $0.10
Player#9224: posts big blind $0.20
*** HOLE CARDS ***
Dealt to warioman [8s 6s]
Player#6332: raises $0.20 to $0.6
Player#7068: folds
warioman: folds
Player#7583: folds
Player#9224: folds
Player#6332: doesn't show hand
Uncalled bet ($0.60) returned to Player#6332
Player#6332 collected $0.30 from pot
*** SUMMARY ***
Total Pot $0.30 | Rake $0.00
Seat 1: Player#9224 (big blind) folded before the flop
Seat 2: Player#6332 shows [] and won ($0.30) with 
Seat 3: Player#7068 folded before the flop
Seat 4: warioman (button) folded before the flop
Seat 5: Player#7583 (small blind) folded before the flop

PokerStars Hand #bac88592-877e-4ee5-b0b9-808c4efe1caf:  Hold'em No Limit ($0.1/$0.20 USD) - 2021/11/21 01:00:00 ET
Table 'Lacey' 6-max Seat #6 is the button
Seat 1: warioman ($61.27 in chips)
Seat 2: Player#1723 ($10.44 in chips)
Seat 3: Player#8805 ($24.43 in chips)
warioman: posts small blind $0.10
Player#1723: posts big blind $0.20
*** HOLE CARDS ***
Dealt to warioman [Kh Jd]
Player#8805: raises $0.20 to $0.4
warioman: folds
Player#1723: calls $0.20
*** FLOP *** [4d 4c As]
Player#1723: checks
Player#8805: bets $0.20
Player#1723: folds
Player#8805: doesn't show hand
Uncalled bet ($0.20) returned to Player#8805
Player#8805 collected $0.86 from pot
*** SUMMARY ***
Total Pot $0.90 | Rake $0.05
Board [4d 4c As]
Seat 1: warioman (small blind) folded before the flop
Seat 2: Player#1723 (big blind) folded on the flop
Seat 3: Player#8805 shows [] and won ($0.86) with 

PokerStars Hand #7dd8170e-925d-4f74-bec4-0279fa03cfba:  Hold'em No Limit ($0.1/$0.20 USD) - 2021/11/21 01:00:00 ET
Table 'Denver' 6-max Seat #3 is the button
Seat 1: Player#9163 ($57.62 in chips)
Seat 2: Player#4590 ($54.74 in chips)
Seat 3: Player#2164 ($60.79 in chips)
Seat 4: warioman ($44.52 in chips)
Seat 5: Player#4551 ($16.70 in chips)
warioman: posts small blind $0.10
Player#4551: posts big blind $0.20
*** HOLE CARDS ***
Dealt to warioman [6s 7d]
Player#9163: folds
Player#4590: folds
Player#2164: raises $0.20 to $0.6
warioman: folds
Player#4551: folds
Player#2164: doesn't show hand
Uncalled bet ($0.60) returned to Player#2164
Player#2164 collected $0.30 from pot
*** SUMMARY ***
Total Pot $0.30 | Rake $0.00
Seat 1: Player#9163 folded before the flop
Seat 2: Player#4590 folded before the flop
Seat 3: Player#2164 shows [] and won ($0.30) with 
Seat 4: warioman (small blind) folded before the flop
Seat 5: Player#4551 (big blind) folded before the flop

PokerStars Hand #46a58eb3-b42f-4dda-9a22-27db0c83b790:  Hold'em No Limit ($0.1/$0.20 USD) - 2021/11/21 01:00:00 ET
Table 'Lacey' 6-max Seat #2 is the button
Seat 1: warioman ($61.47 in chips)
Seat 2: Player#7081 ($10.14 in chips)
Seat 3: Player#6541 ($24.53 in chips)
Player#6541: posts small blind $0.10
warioman: posts big blind $0.20
*** HOLE CARDS ***
Dealt to warioman [5c 9c]
Player#7081: raises $0.20 to $0.6
Player#6541: folds
warioman: folds
Player#7081: doesn't show hand
Uncalled bet ($0.60) returned to Player#7081
Player#7081 collected $0.30 from pot
*** SUMMARY ***
Total Pot $0.30 | Rake $0.00
Seat 1: warioman (big blind) folded before the flop
Seat 2: Player#7081 shows [] and won ($0.30) with 
Seat 3: Player#6541 (small blind) folded before the flop

PokerStars Hand #0e06bb26-867d-4fdd-9a75-f8d24461f010:  Hold'em No Limit ($0.1/$0.20 USD) - 2021/11/21 01:00:00 ET
Table 'Lacey' 6-max Seat #1 is the button
Seat 1: warioman ($61.17 in chips)
Seat 2: Player#3366 ($10.24 in chips)
Seat 3: Player#4500 ($24.73 in chips)
Player#3366: posts small blind $0.10
Player#4500: posts big blind $0.20
*** HOLE CARDS ***
Dealt to warioman [As 6d]
warioman: raises $0.20 to $0.5
Player#3366: folds
Player#4500: folds
warioman: doesn't show hand
Uncalled bet ($0.50) returned to warioman
warioman collected $0.30 from pot
*** SUMMARY ***
Total Pot $0.30 | Rake $0.00
Seat 1: warioman (button)
Seat 2: Player#3366 (small blind) folded before the flop
Seat 3: Player#4500 (big blind) folded before the flop

PokerStars Hand #bf88994c-f4fa-4cdf-97f6-3ebc5c0d5284:  Hold'em No Limit ($0.1/$0.20 USD) - 2021/11/21 00:59:00 ET
Table 'Denver' 6-max Seat #2 is the button
Seat 1: Player#1813 ($57.32 in chips)
Seat 2: Player#7045 ($54.74 in chips)
Seat 3: Player#3057 ($60.89 in chips)
Seat 4: warioman ($44.72 in chips)
Seat 5: Player#7365 ($16.70 in chips)
Player#3057: posts small blind $0.10
warioman: posts big blind $0.20
*** HOLE CARDS ***
Dealt to warioman [9s 6h]
Player#7365: folds
Player#1813: raises $0.20 to $0.4
Player#7045: folds
Player#3057: folds
warioman: folds
Player#1813: doesn't show hand
Uncalled bet ($0.40) returned to Player#1813
Player#1813 collected $0.30 from pot
*** SUMMARY ***
Total Pot $0.30 | Rake $0.00
Seat 1: Player#1813 shows [] and won ($0.30) with 
Seat 2: Player#7045 (button) folded before the flop
Seat 3: Player#3057 (small blind) folded before the flop
Seat 4: warioman (big blind) folded before the flop
Seat 5: Player#7365 folded before the flop

PokerStars Hand #98b6218c-3f72-4547-a725-087173faa33d:  Hold'em No Limit ($0.1/$0.20 USD) - 2021/11/21 00:59:00 ET
Table 'Lacey' 6-max Seat #6 is the button
Seat 1: warioman ($61.27 in chips)
Seat 2: Player#6313 ($10.44 in chips)
Seat 3: Player#0188 ($24.43 in chips)
warioman: posts small blind $0.10
Player#6313: posts big blind $0.20
*** HOLE CARDS ***
Dealt to warioman [Kh 8d]
Player#0188: raises $0.20 to $0.4
warioman: folds
Player#6313: folds
Player#0188: doesn't show hand
Uncalled bet ($0.40) returned to Player#0188
Player#0188 collected $0.30 from pot
*** SUMMARY ***
Total Pot $0.30 | Rake $0.00
Seat 1: warioman (small blind) folded before the flop
Seat 2: Player#6313 (big blind) folded before the flop
Seat 3: Player#0188 shows [] and won ($0.30) with 

PokerStars Hand #62b7dc63-9eba-4ac2-a8d6-a058b9e9e3f3:  Hold'em No Limit ($0.1/$0.20 USD) - 2021/11/21 00:59:00 ET
Table 'Denver' 6-max Seat #1 is the button
Seat 1: Player#1367 ($57.32 in chips)
Seat 2: Player#3726 ($54.24 in chips)
Seat 3: Player#5455 ($61.44 in chips)
Seat 4: warioman ($44.72 in chips)
Seat 5: Player#0492 ($16.70 in chips)
Player#3726: posts small blind $0.10
Player#5455: posts big blind $0.20
*** HOLE CARDS ***
Dealt to warioman [Js 3h]
warioman: folds
Player#0492: folds
Player#1367: folds
Player#3726: raises $0.20 to $0.55
Player#5455: calls $0.35
*** FLOP *** [3c 9s 6s]
Player#3726: checks
Player#5455: checks
*** TURN *** [3c 9s 6s] [5d]
Player#3726: bets $0.55
Player#5455: folds
Player#3726: doesn't show hand
Uncalled bet ($0.55) returned to Player#3726
Player#3726 collected $1.05 from pot
*** SUMMARY ***
Total Pot $1.10 | Rake $0.06
Board [3c 9s 6s 5d]
Seat 1: Player#1367 (button) folded before the flop
Seat 2: Player#3726 shows [] and won ($1.05) with 
Seat 3: Player#5455 (big blind) folded on the turn
Seat 4: warioman folded before the flop
Seat 5: Player#0492 folded before the flop

PokerStars Hand #d014730f-873d-402b-9bed-e83d6094d319:  Hold'em No Limit ($0.1/$0.20 USD) - 2021/11/21 00:58:00 ET
Table 'Lacey' 6-max Seat #2 is the button
Seat 1: warioman ($60.73 in chips)
Seat 2: Player#9916 ($10.44 in chips)
Seat 3: Player#1917 ($25.03 in chips)
Player#1917: posts small blind $0.10
warioman: posts big blind $0.20
*** HOLE CARDS ***
Dealt to warioman [Qd Ks]
Player#9916: folds
Player#1917: raises $0.20 to $0.6
warioman: calls $0.40
*** FLOP *** [Jd 6h 3h]
Player#1917: checks
warioman: checks
*** TURN *** [Jd 6h 3h] [Qh]
Player#1917: checks
warioman: bets $0.56
Player#1917: folds
warioman: doesn't show hand
Uncalled bet ($0.56) returned to warioman
warioman collected $1.14 from pot
*** SUMMARY ***
Total Pot $1.20 | Rake $0.06
Board [Jd 6h 3h Qh]
Seat 1: warioman (big blind)
Seat 2: Player#9916 (button) folded before the flop
Seat 3: Player#1917 (small blind) folded on the turn

PokerStars Hand #8174ed30-a5de-432c-9752-39c1e5757a49:  Hold'em No Limit ($0.1/$0.20 USD) - 2021/11/21 00:58:00 ET
Table 'Lacey' 6-max Seat #1 is the button
Seat 1: warioman ($60.73 in chips)
Seat 2: Player#9037 ($10.54 in chips)
Seat 3: Player#1635 ($24.93 in chips)
Player#9037: posts small blind $0.10
Player#1635: posts big blind $0.20
*** HOLE CARDS ***
Dealt to warioman [2c Qc]
warioman: folds
Player#9037: folds
Player#1635 collected $0.20 from pot
*** SUMMARY ***
Total Pot $0.20 | Rake $0.00
Seat 1: warioman (button) folded before the flop
Seat 2: Player#9037 (small blind) folded before the flop
Seat 3: Player#1635 shows [] and won ($0.20) with 

PokerStars Hand #99c948c7-efb0-4dbc-bd02-5d7ab9dcb6c1:  Hold'em No Limit ($0.1/$0.20 USD) - 2021/11/21 00:58:00 ET
Table 'Lacey' 6-max Seat #6 is the button
Seat 1: warioman ($60.83 in chips)
Seat 2: Player#1782 ($10.44 in chips)
Seat 3: Player#3550 ($24.93 in chips)
warioman: posts small blind $0.10
Player#1782: posts big blind $0.20
*** HOLE CARDS ***
Dealt to warioman [9h 3s]
Player#3550: folds
warioman: folds
Player#1782 collected $0.20 from pot
*** SUMMARY ***
Total Pot $0.20 | Rake $0.00
Seat 1: warioman (small blind) folded before the flop
Seat 2: Player#1782 shows [] and won ($0.20) with 
Seat 3: Player#3550 folded before the flop

PokerStars Hand #3fee02a3-0b89-406d-a863-ec295d1993a5:  Hold'em No Limit ($0.1/$0.20 USD) - 2021/11/21 00:58:00 ET
Table 'Lacey' 6-max Seat #2 is the button
Seat 1: warioman ($60.73 in chips)
Seat 2: Player#3307 ($10.44 in chips)
Seat 3: Player#9911 ($25.03 in chips)
Player#9911: posts small blind $0.10
warioman: posts big blind $0.20
*** HOLE CARDS ***
Dealt to warioman [Jh 3c]
Player#3307: folds
Player#9911: folds
warioman collected $0.20 from pot
*** SUMMARY ***
Total Pot $0.20 | Rake $0.00
Seat 1: warioman (big blind)
Seat 2: Player#3307 (button) folded before the flop
Seat 3: Player#9911 (small blind) folded before the flop

PokerStars Hand #7c20d2df-0568-452a-9578-c369d691c35c:  Hold'em No Limit ($0.1/$0.20 USD) - 2021/11/21 00:58:00 ET
Table 'Lacey' 6-max Seat #1 is the button
Seat 1: warioman ($60.73 in chips)
Seat 2: Player#2020 ($10.24 in chips)
Seat 3: Player#1726 ($25.23 in chips)
Player#2020: posts small blind $0.10
Player#1726: posts big blind $0.20
*** HOLE CARDS ***
Dealt to warioman [3d Td]
warioman: folds
Player#2020: raises $0.20 to $0.6
Player#1726: folds
Player#2020: doesn't show hand
Uncalled bet ($0.60) returned to Player#2020
Player#2020 collected $0.20 from pot
*** SUMMARY ***
Total Pot $0.20 | Rake $0.00
Seat 1: warioman (button) folded before the flop
Seat 2: Player#2020 shows [] and won ($0.20) with 
Seat 3: Player#1726 (big blind) folded before the flop

PokerStars Hand #45c94ebc-eea9-4330-a918-00003ff3c172:  Hold'em No Limit ($0.1/$0.20 USD) - 2021/11/21 00:58:00 ET
Table 'Lacey' 6-max Seat #6 is the button
Seat 1: warioman ($60.83 in chips)
Seat 2: Player#4966 ($10.44 in chips)
Seat 3: Player#4548 ($24.93 in chips)
warioman: posts small blind $0.10
Player#4966: posts big blind $0.20
*** HOLE CARDS ***
Dealt to warioman [Kh 7s]
Player#4548: raises $0.20 to $0.4
warioman: folds
Player#4966: folds
Player#4548: doesn't show hand
Uncalled bet ($0.40) returned to Player#4548
Player#4548 collected $0.30 from pot
*** SUMMARY ***
Total Pot $0.30 | Rake $0.00
Seat 1: warioman (small blind) folded before the flop
Seat 2: Player#4966 (big blind) folded before the flop
Seat 3: Player#4548 shows [] and won ($0.30) with 

PokerStars Hand #bc2a7c54-ba76-4b01-a227-9f89398d4c30:  Hold'em No Limit ($0.1/$0.20 USD) - 2021/11/21 00:57:00 ET
Table 'Denver' 6-max Seat #6 is the button
Seat 1: Player#8715 ($54.05 in chips)
Seat 2: Player#3114 ($54.84 in chips)
Seat 3: Player#8460 ($61.44 in chips)
Seat 4: warioman ($44.72 in chips)
Seat 5: Player#8019 ($19.70 in chips)
Player#8715: posts small blind $0.10
Player#3114: posts big blind $0.20
*** HOLE CARDS ***
Dealt to warioman [Qc 2d]
Player#8460: folds
warioman: folds
Player#8019: raises $0.20 to $0.6
Player#8715: calls $0.50
Player#3114: calls $0.40
*** FLOP *** [3c 5s 8d]
Player#8715: checks
Player#3114: checks
Player#8019: bets $1.00
Player#8715: calls $1.00
Player#3114: folds
*** TURN *** [3c 5s 8d] [2h]
Player#8715: checks
Player#8019: checks
*** RIVER *** [3c 5s 8d] [2h] [Qh]
Player#8715: checks
Player#8019: bets $1.40
Player#8715: calls $1.40
*** SHOW DOWN *** 
Player#8715 collected $6.27 from pot
*** SUMMARY ***
Total Pot $6.60 | Rake $0.33
Board [3c 5s 8d 2h Qh]
Seat 1: Player#8715 shows [As 3s] and won ($6.27) with 
Seat 2: Player#3114 (big blind) folded on the flop
Seat 3: Player#8460 folded before the flop
Seat 4: warioman folded before the flop
Seat 5: Player#8019 mucked

PokerStars Hand #3cd1762e-7f64-40e7-b54d-40392c58b4d1:  Hold'em No Limit ($0.1/$0.20 USD) - 2021/11/21 00:57:00 ET
Table 'Lacey' 6-max Seat #2 is the button
Seat 1: warioman ($59.61 in chips)
Seat 2: Player#2988 ($11.69 in chips)
Seat 3: Player#0467 ($25.03 in chips)
Player#0467: posts small blind $0.10
warioman: posts big blind $0.20
*** HOLE CARDS ***
Dealt to warioman [Ac 6h]
Player#2988: raises $0.20 to $0.6
Player#0467: folds
warioman: calls $0.40
*** FLOP *** [Th As 2s]
warioman: checks
Player#2988: bets $0.65
warioman: calls $0.65
*** TURN *** [Th As 2s] [9d]
warioman: checks
Player#2988: checks
*** RIVER *** [Th As 2s] [9d] [5d]
warioman: checks
Player#2988: checks
*** SHOW DOWN *** 
warioman collected $2.47 from pot
*** SUMMARY ***
Total Pot $2.60 | Rake $0.13
Board [Th As 2s 9d 5d]
Seat 1: warioman (big blind)
Seat 2: Player#2988 (button) mucked
Seat 3: Player#0467 (small blind) folded before the flop

PokerStars Hand #8dd982d3-0a4c-48f4-88ff-0943954967cf:  Hold'em No Limit ($0.1/$0.20 USD) - 2021/11/21 00:57:00 ET
Table 'Denver' 6-max Seat #4 is the button
Seat 1: Player#1928 ($54.25 in chips)
Seat 2: Player#0568 ($54.84 in chips)
Seat 3: Player#9073 ($61.44 in chips)
Seat 4: warioman ($44.42 in chips)
Seat 5: Player#1456 ($19.80 in chips)
Player#1456: posts small blind $0.10
Player#1928: posts big blind $0.20
*** HOLE CARDS ***
Dealt to warioman [Kh Qs]
Player#0568: folds
Player#9073: folds
warioman: raises $0.20 to $0.5
Player#1456: folds
Player#1928: folds
warioman: doesn't show hand
Uncalled bet ($0.50) returned to warioman
warioman collected $0.30 from pot
*** SUMMARY ***
Total Pot $0.30 | Rake $0.00
Seat 1: Player#1928 (big blind) folded before the flop
Seat 2: Player#0568 folded before the flop
Seat 3: Player#9073 folded before the flop
Seat 4: warioman (button)
Seat 5: Player#1456 (small blind) folded before the flop

PokerStars Hand #10d1309a-48ba-48fe-a7d8-bcb1fe8ff69e:  Hold'em No Limit ($0.1/$0.20 USD) - 2021/11/21 00:56:00 ET
Table 'Denver' 6-max Seat #3 is the button
Seat 1: Player#9912 ($54.25 in chips)
Seat 2: Player#2920 ($54.84 in chips)
Seat 3: Player#5942 ($63.84 in chips)
Seat 4: warioman ($42.07 in chips)
Seat 5: Player#6160 ($20.00 in chips)
warioman: posts small blind $0.10
Player#6160: posts big blind $0.20
*** HOLE CARDS ***
Dealt to warioman [As Jc]
Player#9912: folds
Player#2920: folds
Player#5942: raises $0.20 to $0.6
warioman: raises $0.60 to $2.4
Player#6160: folds
Player#5942: calls $1.80
*** FLOP *** [4d Ad 6h]
warioman: bets $1.50
Player#5942: folds
warioman: doesn't show hand
Uncalled bet ($1.50) returned to warioman
warioman collected $4.75 from pot
*** SUMMARY ***
Total Pot $5.00 | Rake $0.25
Board [4d Ad 6h]
Seat 1: Player#9912 folded before the flop
Seat 2: Player#2920 folded before the flop
Seat 3: Player#5942 (button) folded on the flop
Seat 4: warioman (small blind)
Seat 5: Player#6160 (big blind) folded before the flop

PokerStars Hand #1d1127b3-525b-44f6-a1ad-2db5f0696e7f:  Hold'em No Limit ($0.1/$0.20 USD) - 2021/11/21 00:56:00 ET
Table 'Lacey' 6-max Seat #1 is the button
Seat 1: warioman ($60.11 in chips)
Seat 2: Player#4473 ($11.79 in chips)
Seat 3: Player#9653 ($24.48 in chips)
Player#4473: posts small blind $0.10
Player#9653: posts big blind $0.20
*** HOLE CARDS ***
Dealt to warioman [2d 2h]
warioman: raises $0.20 to $0.5
Player#4473: folds
Player#9653: calls $0.30
*** FLOP *** [8c 7s 6h]
Player#9653: checks
warioman: checks
*** TURN *** [8c 7s 6h] [Ah]
Player#9653: checks
warioman: checks
*** RIVER *** [8c 7s 6h] [Ah] [Qh]
Player#9653: bets $0.40
warioman: folds
Player#9653: doesn't show hand
Uncalled bet ($0.40) returned to Player#9653
Player#9653 collected $1.05 from pot
*** SUMMARY ***
Total Pot $1.10 | Rake $0.06
Board [8c 7s 6h Ah Qh]
Seat 1: warioman (button) folded on the river
Seat 2: Player#4473 (small blind) folded before the flop
Seat 3: Player#9653 shows [] and won ($1.05) with 

PokerStars Hand #2aa9eee0-5dcd-4817-b76f-9bde27a9d7b9:  Hold'em No Limit ($0.1/$0.20 USD) - 2021/11/21 00:56:00 ET
Table 'Lacey' 6-max Seat #6 is the button
Seat 1: warioman ($60.21 in chips)
Seat 2: Player#9188 ($11.99 in chips)
Seat 3: Player#7771 ($24.18 in chips)
warioman: posts small blind $0.10
Player#9188: posts big blind $0.20
*** HOLE CARDS ***
Dealt to warioman [Qd 2d]
Player#7771: raises $0.20 to $0.4
warioman: folds
Player#9188: folds
Player#7771: doesn't show hand
Uncalled bet ($0.40) returned to Player#7771
Player#7771 collected $0.30 from pot
*** SUMMARY ***
Total Pot $0.30 | Rake $0.00
Seat 1: warioman (small blind) folded before the flop
Seat 2: Player#9188 (big blind) folded before the flop
Seat 3: Player#7771 shows [] and won ($0.30) with 

PokerStars Hand #279445f6-d446-4a50-980c-56f5d65157d5:  Hold'em No Limit ($0.1/$0.20 USD) - 2021/11/21 00:56:00 ET
Table 'Denver' 6-max Seat #2 is the button
Seat 1: Player#0580 ($54.25 in chips)
Seat 2: Player#7816 ($54.84 in chips)
Seat 3: Player#4600 ($63.94 in chips)
Seat 4: warioman ($42.27 in chips)
Seat 5: Player#3363 ($19.70 in chips)
Player#4600: posts small blind $0.10
warioman: posts big blind $0.20
*** HOLE CARDS ***
Dealt to warioman [9d Qc]
Player#3363: raises $0.20 to $0.6
Player#0580: folds
Player#7816: folds
Player#4600: folds
warioman: folds
Player#3363: doesn't show hand
Uncalled bet ($0.60) returned to Player#3363
Player#3363 collected $0.30 from pot
*** SUMMARY ***
Total Pot $0.30 | Rake $0.00
Seat 1: Player#0580 folded before the flop
Seat 2: Player#7816 (button) folded before the flop
Seat 3: Player#4600 (small blind) folded before the flop
Seat 4: warioman (big blind) folded before the flop
Seat 5: Player#3363 shows [] and won ($0.30) with 

PokerStars Hand #a64e5903-c7e4-4b48-bb2c-8c9ded88705a:  Hold'em No Limit ($0.1/$0.20 USD) - 2021/11/21 00:56:00 ET
Table 'Lacey' 6-max Seat #2 is the button
Seat 1: warioman ($60.41 in chips)
Seat 2: Player#5842 ($11.99 in chips)
Seat 3: Player#1466 ($23.98 in chips)
Player#1466: posts small blind $0.10
warioman: posts big blind $0.20
*** HOLE CARDS ***
Dealt to warioman [2d 7c]
Player#5842: folds
Player#1466: raises $0.20 to $0.6
warioman: folds
Player#1466: doesn't show hand
Uncalled bet ($0.60) returned to Player#1466
Player#1466 collected $0.20 from pot
*** SUMMARY ***
Total Pot $0.20 | Rake $0.00
Seat 1: warioman (big blind) folded before the flop
Seat 2: Player#5842 (button) folded before the flop
Seat 3: Player#1466 shows [] and won ($0.20) with 

PokerStars Hand #692430ec-74ac-4738-b72b-04fd94f0ef37:  Hold'em No Limit ($0.1/$0.20 USD) - 2021/11/21 00:56:00 ET
Table 'Denver' 6-max Seat #1 is the button
Seat 1: Player#2531 ($54.75 in chips)
Seat 2: Player#1340 ($54.94 in chips)
Seat 3: Player#7403 ($62.84 in chips)
Seat 4: warioman ($42.77 in chips)
Seat 5: Player#9439 ($19.70 in chips)
Player#1340: posts small blind $0.10
Player#7403: posts big blind $0.20
*** HOLE CARDS ***
Dealt to warioman [Qd As]
warioman: raises $0.20 to $0.5
Player#9439: folds
Player#2531: calls $0.50
Player#1340: folds
Player#7403: raises $0.50 to $2.6
warioman: folds
Player#2531: folds
Player#7403: doesn't show hand
Uncalled bet ($2.60) returned to Player#7403
Player#7403 collected $1.10 from pot
*** SUMMARY ***
Total Pot $1.10 | Rake $0.00
Seat 1: Player#2531 (button) folded before the flop
Seat 2: Player#1340 (small blind) folded before the flop
Seat 3: Player#7403 shows [] and won ($1.10) with 
Seat 4: warioman folded before the flop
Seat 5: Player#9439 folded before the flop

PokerStars Hand #ef1077bc-0918-48d5-a02a-9804bd405d2b:  Hold'em No Limit ($0.1/$0.20 USD) - 2021/11/21 00:55:00 ET
Table 'Lacey' 6-max Seat #1 is the button
Seat 1: warioman ($60.41 in chips)
Seat 2: Player#7002 ($11.45 in chips)
Seat 3: Player#9973 ($24.58 in chips)
Player#7002: posts small blind $0.10
Player#9973: posts big blind $0.20
*** HOLE CARDS ***
Dealt to warioman [8c Th]
warioman: folds
Player#7002: raises $0.20 to $0.6
Player#9973: calls $0.40
*** FLOP *** [5c Td 8d]
Player#7002: bets $0.60
Player#9973: folds
Player#7002: doesn't show hand
Uncalled bet ($0.60) returned to Player#7002
Player#7002 collected $1.14 from pot
*** SUMMARY ***
Total Pot $1.20 | Rake $0.06
Board [5c Td 8d]
Seat 1: warioman (button) folded before the flop
Seat 2: Player#7002 shows [] and won ($1.14) with 
Seat 3: Player#9973 (big blind) folded on the flop

PokerStars Hand #12390c92-0853-412c-a17b-3c3b142747a0:  Hold'em No Limit ($0.1/$0.20 USD) - 2021/11/21 00:55:00 ET
Table 'Denver' 6-max Seat #6 is the button
Seat 1: Player#1148 ($54.85 in chips)
Seat 2: Player#5951 ($55.14 in chips)
Seat 3: Player#1038 ($62.84 in chips)
Seat 4: warioman ($42.77 in chips)
Seat 5: Player#3491 ($19.40 in chips)
Player#1148: posts small blind $0.10
Player#5951: posts big blind $0.20
*** HOLE CARDS ***
Dealt to warioman [8c 9d]
Player#1038: folds
warioman: folds
Player#3491: raises $0.20 to $0.6
Player#1148: folds
Player#5951: folds
Player#3491: doesn't show hand
Uncalled bet ($0.60) returned to Player#3491
Player#3491 collected $0.30 from pot
*** SUMMARY ***
Total Pot $0.30 | Rake $0.00
Seat 1: Player#1148 (small blind) folded before the flop
Seat 2: Player#5951 (big blind) folded before the flop
Seat 3: Player#1038 folded before the flop
Seat 4: warioman folded before the flop
Seat 5: Player#3491 shows [] and won ($0.30) with 

PokerStars Hand #70a9ffad-2255-4a33-b18f-249bad309500:  Hold'em No Limit ($0.1/$0.20 USD) - 2021/11/21 00:55:00 ET
Table 'Denver' 6-max Seat #1 is the button
Seat 1: Player#1479 ($54.85 in chips)
Seat 2: Player#8994 ($55.14 in chips)
Seat 3: Player#5478 ($62.84 in chips)
Seat 4: warioman ($42.77 in chips)
Seat 5: Player#9881 ($19.40 in chips)
Player#8994: posts small blind $0.10
Player#1479: posts big blind $0.20
*** HOLE CARDS ***
Dealt to warioman [5s Ad]
Player#8994 Waiting
Player#5478: folds
warioman: folds
Player#9881: folds
 *** SUMMARY ***
Total Pot $0.10 | Rake $0.00
Seat 1: Player#1479 (big blind) mucked
Seat 2: Player#8994 (small blind) mucked
Seat 3: Player#5478 folded before the flop
Seat 4: warioman folded before the flop
Seat 5: Player#9881 folded before the flop

PokerStars Hand #a306cf9b-66c1-48b0-bb45-0a792c299249:  Hold'em No Limit ($0.1/$0.20 USD) - 2021/11/21 00:55:00 ET
Table 'Lacey' 6-max Seat #6 is the button
Seat 1: warioman ($60.51 in chips)
Seat 2: Player#6596 ($11.65 in chips)
Seat 3: Player#1960 ($24.28 in chips)
warioman: posts small blind $0.10
Player#6596: posts big blind $0.20
*** HOLE CARDS ***
Dealt to warioman [4c Td]
Player#1960: raises $0.20 to $0.4
warioman: folds
Player#6596: folds
Player#1960: doesn't show hand
Uncalled bet ($0.40) returned to Player#1960
Player#1960 collected $0.30 from pot
*** SUMMARY ***
Total Pot $0.30 | Rake $0.00
Seat 1: warioman (small blind) folded before the flop
Seat 2: Player#6596 (big blind) folded before the flop
Seat 3: Player#1960 shows [] and won ($0.30) with 

PokerStars Hand #7ab3e80f-c9eb-4a05-ada1-c11436146174:  Hold'em No Limit ($0.1/$0.20 USD) - 2021/11/21 00:54:00 ET
Table 'Lacey' 6-max Seat #2 is the button
Seat 1: warioman ($61.11 in chips)
Seat 2: Player#9992 ($11.65 in chips)
Seat 3: Player#6821 ($23.74 in chips)
Player#6821: posts small blind $0.10
warioman: posts big blind $0.20
*** HOLE CARDS ***
Dealt to warioman [5s 6s]
Player#9992: folds
Player#6821: raises $0.20 to $0.6
warioman: calls $0.40
*** FLOP *** [6c Jh Th]
Player#6821: checks
warioman: checks
*** TURN *** [6c Jh Th] [8c]
Player#6821: bets $0.40
warioman: folds
Player#6821: doesn't show hand
Uncalled bet ($0.40) returned to Player#6821
Player#6821 collected $1.14 from pot
*** SUMMARY ***
Total Pot $1.20 | Rake $0.06
Board [6c Jh Th 8c]
Seat 1: warioman (big blind) folded on the turn
Seat 2: Player#9992 (button) folded before the flop
Seat 3: Player#6821 shows [] and won ($1.14) with 

PokerStars Hand #c3756e1d-1df8-4559-bbd0-25c1b0f822a1:  Hold'em No Limit ($0.1/$0.20 USD) - 2021/11/21 00:54:00 ET
Table 'Denver' 6-max Seat #1 is the button
Seat 1: Player#1126 ($31.62 in chips)
Seat 2: Player#4738 ($55.14 in chips)
Seat 3: Player#1479 ($62.84 in chips)
Seat 4: warioman ($42.77 in chips)
Seat 5: Player#2409 ($19.50 in chips)
Seat 6: Player#9464 ($25.13 in chips)
Player#4738: posts small blind $0.10
Player#2409: posts big blind $0.20
*** HOLE CARDS ***
Dealt to warioman [8c 7s]
Player#4738 Waiting
Player#1126: raises $0.20 to $0.4
Player#1479: folds
warioman: folds
Player#2409: folds
Player#9464: calls $0.20
*** FLOP *** [2s Kc 3d]
Player#9464: bets $0.20
Player#1126: calls $0.20
*** TURN *** [2s Kc 3d] [5s]
Player#9464: checks
Player#1126: checks
*** RIVER *** [2s Kc 3d] [5s] [Js]
Player#9464: bets $1.80
Player#1126: raises $ 31.80 to $31.02
Player#9464: calls $22.73
*** SHOW DOWN *** 
Player#9464: doesn't show hand
Player#1126 collected $55.35 from pot
*** SUMMARY ***
Total Pot $56.85 | Rake $1.50
Board [2s Kc 3d 5s Js]
Seat 1: Player#1126 shows [As 9s] and won ($55.35) with 
Seat 2: Player#4738 (small blind) mucked
Seat 3: Player#1479 folded before the flop
Seat 4: warioman folded before the flop
Seat 5: Player#2409 (big blind) folded before the flop
Seat 6: Player#9464 mucked

PokerStars Hand #895a98b7-5af5-4b3c-9184-97e4ad7f5e8c:  Hold'em No Limit ($0.1/$0.20 USD) - 2021/11/21 00:54:00 ET
Table 'Denver' 6-max Seat #1 is the button
Seat 1: Player#1472 ($31.62 in chips)
Seat 2: Player#2261 ($55.14 in chips)
Seat 3: Player#0453 ($62.84 in chips)
Seat 4: warioman ($42.87 in chips)
Seat 5: Player#3222 ($19.40 in chips)
Seat 6: Player#9256 ($25.13 in chips)
Player#2261: posts small blind $0.10
warioman: posts big blind $0.20
*** HOLE CARDS ***
Dealt to warioman [8s 4c]
Player#2261 Waiting
Player#9256: folds
Player#1472: folds
Player#0453: folds
warioman: folds
Player#3222 collected $0.20 from pot
*** SUMMARY ***
Total Pot $0.20 | Rake $0.00
Seat 1: Player#1472 (button) folded before the flop
Seat 2: Player#2261 (small blind) mucked
Seat 3: Player#0453 folded before the flop
Seat 4: warioman (big blind) folded before the flop
Seat 5: Player#3222 shows [] and won ($0.20) with 
Seat 6: Player#9256 folded before the flop

PokerStars Hand #5aa420ff-64a9-4606-bde1-1f53297e67bf:  Hold'em No Limit ($0.1/$0.20 USD) - 2021/11/21 00:54:00 ET
Table 'Lacey' 6-max Seat #1 is the button
Seat 1: warioman ($60.47 in chips)
Seat 2: Player#9770 ($12.15 in chips)
Seat 3: Player#0350 ($23.94 in chips)
Player#9770: posts small blind $0.10
Player#0350: posts big blind $0.20
*** HOLE CARDS ***
Dealt to warioman [Ks Ad]
warioman: raises $0.20 to $0.5
Player#9770: calls $0.40
Player#0350: folds
*** FLOP *** [7s 6s Ah]
Player#9770: checks
warioman: bets $0.36
Player#9770: folds
warioman: doesn't show hand
Uncalled bet ($0.36) returned to warioman
warioman collected $1.14 from pot
*** SUMMARY ***
Total Pot $1.20 | Rake $0.06
Board [7s 6s Ah]
Seat 1: warioman (button)
Seat 2: Player#9770 (small blind) folded on the flop
Seat 3: Player#0350 (big blind) folded before the flop

PokerStars Hand #22a22421-6361-45f8-9102-f582119d1c00:  Hold'em No Limit ($0.1/$0.20 USD) - 2021/11/21 00:53:00 ET
Table 'Denver' 6-max Seat #1 is the button
Seat 1: Player#2055 ($31.62 in chips)
Seat 2: Player#3712 ($63.64 in chips)
Seat 3: warioman ($43.07 in chips)
Seat 4: Player#6941 ($19.40 in chips)
Seat 5: Player#7517 ($24.22 in chips)
Player#3712: posts small blind $0.10
warioman: posts big blind $0.20
*** HOLE CARDS ***
Dealt to warioman [7h 3c]
Player#6941: folds
Player#7517: raises $0.20 to $0.8
Player#2055: folds
Player#3712: calls $0.70
warioman: folds
*** FLOP *** [Js 6h 5h]
Player#3712: checks
Player#7517: bets $1.00
Player#3712: folds
Player#7517: doesn't show hand
Uncalled bet ($1.00) returned to Player#7517
Player#7517 collected $1.71 from pot
*** SUMMARY ***
Total Pot $1.80 | Rake $0.09
Board [Js 6h 5h]
Seat 1: Player#2055 (button) folded before the flop
Seat 2: Player#3712 (small blind) folded on the flop
Seat 3: warioman (big blind) folded before the flop
Seat 4: Player#6941 folded before the flop
Seat 5: Player#7517 shows [] and won ($1.71) with 

PokerStars Hand #1c5d2612-308c-4051-aa3e-3a9b9658a0fa:  Hold'em No Limit ($0.1/$0.20 USD) - 2021/11/21 00:53:00 ET
Table 'Lacey' 6-max Seat #6 is the button
Seat 1: warioman ($59.93 in chips)
Seat 2: Player#8392 ($41.98 in chips)
Seat 3: Player#2072 ($12.75 in chips)
Seat 4: Player#2431 ($23.94 in chips)
warioman: posts small blind $0.10
Player#2072: posts big blind $0.20
*** HOLE CARDS ***
Dealt to warioman [2h 3h]
Player#8392 Decline Entry Bet
Player#2431: folds
warioman: calls $0.10
Player#2072: checks
*** FLOP *** [2c 4h Jd]
warioman: checks
Player#2072: bets $0.40
warioman: calls $0.40
*** TURN *** [2c 4h Jd] [2s]
warioman: checks
Player#2072: checks
*** RIVER *** [2c 4h Jd] [2s] [6s]
warioman: bets $0.80
Player#2072: folds
warioman: doesn't show hand
Uncalled bet ($0.80) returned to warioman
warioman collected $1.14 from pot
*** SUMMARY ***
Total Pot $1.20 | Rake $0.06
Board [2c 4h Jd 2s 6s]
Seat 1: warioman (small blind)
Seat 2: Player#8392 mucked
Seat 3: Player#2072 (big blind) folded on the river
Seat 4: Player#2431 folded before the flop

PokerStars Hand #eaf2d9bb-2105-4d98-a9b0-591452ae2185:  Hold'em No Limit ($0.1/$0.20 USD) - 2021/11/21 00:52:00 ET
Table 'Lacey' 6-max Seat #3 is the button
Seat 1: warioman ($60.13 in chips)
Seat 2: Player#6662 ($41.68 in chips)
Seat 3: Player#2917 ($12.75 in chips)
Seat 4: Player#0695 ($24.04 in chips)
Player#0695: posts small blind $0.10
warioman: posts big blind $0.20
*** HOLE CARDS ***
Dealt to warioman [4h 8s]
Player#6662: raises $0.20 to $0.75
Player#2917: folds
Player#0695: folds
warioman: folds
Player#6662: doesn't show hand
Uncalled bet ($0.75) returned to Player#6662
Player#6662 collected $0.30 from pot
*** SUMMARY ***
Total Pot $0.30 | Rake $0.00
Seat 1: warioman (big blind) folded before the flop
Seat 2: Player#6662 shows [] and won ($0.30) with 
Seat 3: Player#2917 (button) folded before the flop
Seat 4: Player#0695 (small blind) folded before the flop

PokerStars Hand #72746e5a-049f-4ef8-bf73-c67aab9bb0f0:  Hold'em No Limit ($0.1/$0.20 USD) - 2021/11/21 00:52:00 ET
Table 'Denver' 6-max Seat #6 is the button
Seat 1: Player#1095 ($32.22 in chips)
Seat 2: Player#1075 ($61.84 in chips)
Seat 3: warioman ($43.07 in chips)
Seat 4: Player#6640 ($20.00 in chips)
Seat 5: Player#6144 ($24.82 in chips)
Player#1095: posts small blind $0.10
Player#1075: posts big blind $0.20
*** HOLE CARDS ***
Dealt to warioman [2d 5h]
warioman: folds
Player#6640: raises $0.20 to $0.6
Player#6144: calls $0.60
Player#1095: calls $0.50
Player#1075: raises0.60 to $3
Player#6640: folds
Player#6144: folds
Player#1095: folds
Player#1075: doesn't show hand
Uncalled bet ($3.00) returned to Player#1075
Player#1075 collected $1.80 from pot
*** SUMMARY ***
Total Pot $1.80 | Rake $0.00
Seat 1: Player#1095 (small blind) folded before the flop
Seat 2: Player#1075 shows [] and won ($1.80) with 
Seat 3: warioman folded before the flop
Seat 4: Player#6640 folded before the flop
Seat 5: Player#6144 folded before the flop

PokerStars Hand #cf4ba091-c9ce-4366-b0c3-985309f28593:  Hold'em No Limit ($0.1/$0.20 USD) - 2021/11/21 00:52:00 ET
Table 'Lacey' 6-max Seat #2 is the button
Seat 1: warioman ($60.13 in chips)
Seat 2: Player#7847 ($41.68 in chips)
Seat 3: Player#8685 ($12.85 in chips)
Seat 4: Player#2356 ($23.94 in chips)
Player#8685: posts small blind $0.10
Player#2356: posts big blind $0.20
*** HOLE CARDS ***
Dealt to warioman [9h Kc]
warioman: folds
Player#7847: folds
Player#8685: folds
Player#2356 collected $0.20 from pot
*** SUMMARY ***
Total Pot $0.20 | Rake $0.00
Seat 1: warioman folded before the flop
Seat 2: Player#7847 (button) folded before the flop
Seat 3: Player#8685 (small blind) folded before the flop
Seat 4: Player#2356 shows [] and won ($0.20) with 

PokerStars Hand #4ac90514-90d7-4f54-89c9-9f91179d4473:  Hold'em No Limit ($0.1/$0.20 USD) - 2021/11/21 00:52:00 ET
Table 'Denver' 6-max Seat #5 is the button
Seat 1: Player#6752 ($32.42 in chips)
Seat 2: Player#9822 ($20.00 in chips)
Seat 3: Player#2679 ($43.54 in chips)
Seat 4: warioman ($43.07 in chips)
Seat 5: Player#5234 ($9.62 in chips)
Seat 6: Player#0615 ($24.92 in chips)
Player#0615: posts small blind $0.10
Player#6752: posts big blind $0.20
*** HOLE CARDS ***
Dealt to warioman [Ts 2d]
Player#9822: raises $0.20 to $0.6
Player#2679: raises $0.60 to $2.6
warioman: folds
Player#5234: folds
Player#0615: folds
Player#6752: folds
Player#9822: calls $2.00
*** FLOP *** [Js 9s 4d]
Player#9822: bets $17.40
Player#2679: calls $17.40
Player#9822 Showing Pocket Cards 77
Player#2679 Showing Pocket Cards KK
*** TURN *** [Js 9s 4d] [Qs]
*** RIVER *** [Js 9s 4d] [Qs] [9s]
Player#2679 collected $38.80 from pot
*** SUMMARY ***
Total Pot $40.30 | Rake $1.50
Board [Js 9s 4d Qs 9s]
Seat 1: Player#6752 (big blind) folded before the flop
Seat 2: Player#9822 mucked
Seat 3: Player#2679 shows [Kc Ks] and won ($38.80) with 
Seat 4: warioman folded before the flop
Seat 5: Player#5234 (button) folded before the flop
Seat 6: Player#0615 (small blind) folded before the flop

PokerStars Hand #c76e325c-925b-4cbb-8395-690ece518b6e:  Hold'em No Limit ($0.1/$0.20 USD) - 2021/11/21 00:52:00 ET
Table 'Lacey' 6-max Seat #2 is the button
Seat 1: warioman ($60.13 in chips)
Seat 2: Player#5511 ($41.68 in chips)
Seat 3: Player#4903 ($3.72 in chips)
Seat 4: Player#8890 ($13.05 in chips)
Seat 5: Player#0945 ($20.40 in chips)
Player#4903: posts small blind $0.10
Player#8890: posts big blind $0.20
*** HOLE CARDS ***
Dealt to warioman [2d Jh]
Player#0945: raises $0.20 to $0.4
warioman: folds
Player#5511: folds
Player#4903: calls $0.30
Player#8890: folds
*** FLOP *** [Kh Jc 7h]
Player#4903: bets $3.32
Player#0945: calls $3.32
Player#4903 Showing Pocket Cards KJ
Player#0945 Showing Pocket Cards T9
*** TURN *** [Kh Jc 7h] [Ac]
*** RIVER *** [Kh Jc 7h] [Ac] [Qs]
Player#0945 collected $7.26 from pot
*** SUMMARY ***
Total Pot $7.64 | Rake $0.38
Board [Kh Jc 7h Ac Qs]
Seat 1: warioman folded before the flop
Seat 2: Player#5511 (button) folded before the flop
Seat 3: Player#4903 (small blind) mucked
Seat 4: Player#8890 (big blind) folded before the flop
Seat 5: Player#0945 shows [Tc 9c] and won ($7.26) with 

PokerStars Hand #517563ba-c5d7-4d0e-bc33-dc069d787283:  Hold'em No Limit ($0.1/$0.20 USD) - 2021/11/21 00:51:00 ET
Table 'Lacey' 6-max Seat #1 is the button
Seat 1: warioman ($60.13 in chips)
Seat 2: Player#8863 ($42.08 in chips)
Seat 3: Player#0977 ($28.14 in chips)
Seat 4: Player#2967 ($2.80 in chips)
Seat 5: Player#0208 ($13.05 in chips)
Seat 6: Player#3236 ($21.00 in chips)
Player#8863: posts small blind $0.10
Player#2967: posts big blind $0.20
*** HOLE CARDS ***
Dealt to warioman [5h 7h]
Player#0977 Decline Entry Bet
Player#0208: folds
Player#3236: raises $0.20 to $0.4
warioman: folds
Player#8863: calls $0.30
Player#2967: calls $0.20
*** FLOP *** [Ts 9d Td]
Player#8863: checks
Player#2967: bets $0.20
Player#3236: calls $0.20
Player#8863: folds
*** TURN *** [Ts 9d Td] [9h]
Player#2967: bets $2.20
Player#3236: folds
Player#2967: doesn't show hand
Uncalled bet ($2.20) returned to Player#2967
Player#2967 collected $1.52 from pot
*** SUMMARY ***
Total Pot $1.60 | Rake $0.08
Board [Ts 9d Td 9h]
Seat 1: warioman (button) folded before the flop
Seat 2: Player#8863 (small blind) folded on the flop
Seat 3: Player#0977 mucked
Seat 4: Player#2967 shows [] and won ($1.52) with 
Seat 5: Player#0208 folded before the flop
Seat 6: Player#3236 folded on the turn

PokerStars Hand #359d2f16-b897-487e-ae80-c4485d4d0be2:  Hold'em No Limit ($0.1/$0.20 USD) - 2021/11/21 00:51:00 ET
Table 'Denver' 6-max Seat #4 is the button
Seat 1: Player#7105 ($32.42 in chips)
Seat 2: Player#4593 ($7.40 in chips)
Seat 3: Player#5144 ($43.54 in chips)
Seat 4: warioman ($43.87 in chips)
Seat 5: Player#0984 ($10.42 in chips)
Seat 6: Player#8901 ($23.44 in chips)
Player#0984: posts small blind $0.10
Player#8901: posts big blind $0.20
*** HOLE CARDS ***
Dealt to warioman [6c 7c]
Player#7105: folds
Player#4593: folds
Player#5144: folds
warioman: raises $0.20 to $0.5
Player#0984: calls $0.40
Player#8901: raises $0.50 to $0.8
warioman: calls $0.30
Player#0984: calls $0.30
*** FLOP *** [Tc Kh Qd]
Player#0984: checks
Player#8901: checks
warioman: checks
*** TURN *** [Tc Kh Qd] [5h]
Player#0984: checks
Player#8901: bets $1.00
warioman: folds
Player#0984: folds
Player#8901: doesn't show hand
Uncalled bet ($1.00) returned to Player#8901
Player#8901 collected $2.28 from pot
*** SUMMARY ***
Total Pot $2.40 | Rake $0.12
Board [Tc Kh Qd 5h]
Seat 1: Player#7105 folded before the flop
Seat 2: Player#4593 folded before the flop
Seat 3: Player#5144 folded before the flop
Seat 4: warioman (button) folded on the turn
Seat 5: Player#0984 (small blind) folded on the turn
Seat 6: Player#8901 shows [] and won ($2.28) with 

PokerStars Hand #cf005bdd-74c0-4ab3-be1c-27ef78b94a19:  Hold'em No Limit ($0.1/$0.20 USD) - 2021/11/21 00:50:00 ET
Table 'Lacey' 6-max Seat #6 is the button
Seat 1: warioman ($57.78 in chips)
Seat 2: Player#2534 ($42.28 in chips)
Seat 3: Player#6038 ($30.54 in chips)
Seat 4: Player#7893 ($2.80 in chips)
Seat 5: Player#2293 ($13.05 in chips)
Seat 6: Player#6498 ($21.00 in chips)
warioman: posts small blind $0.10
Player#2534: posts big blind $0.20
*** HOLE CARDS ***
Dealt to warioman [5s As]
Player#6038: raises $0.20 to $0.6
Player#7893: folds
Player#2293: folds
Player#6498: folds
warioman: raises $0.60 to $2.4
Player#2534: folds
Player#6038: calls $1.80
*** FLOP *** [6d 8s 5h]
warioman: checks
Player#6038: checks
*** TURN *** [6d 8s 5h] [8c]
warioman: bets $1.50
Player#6038: folds
warioman: doesn't show hand
Uncalled bet ($1.50) returned to warioman
warioman collected $4.75 from pot
*** SUMMARY ***
Total Pot $5.00 | Rake $0.25
Board [6d 8s 5h 8c]
Seat 1: warioman (small blind)
Seat 2: Player#2534 (big blind) folded before the flop
Seat 3: Player#6038 folded on the turn
Seat 4: Player#7893 folded before the flop
Seat 5: Player#2293 folded before the flop
Seat 6: Player#6498 (button) folded before the flop

PokerStars Hand #5e3ca316-597a-4107-ab1b-8563cb11a78d:  Hold'em No Limit ($0.1/$0.20 USD) - 2021/11/21 00:50:00 ET
Table 'Lacey' 6-max Seat #5 is the button
Seat 1: warioman ($57.98 in chips)
Seat 2: Player#7838 ($42.28 in chips)
Seat 3: Player#2026 ($30.54 in chips)
Seat 4: Player#1680 ($2.43 in chips)
Seat 5: Player#2842 ($13.05 in chips)
Seat 6: Player#4896 ($21.20 in chips)
Player#4896: posts small blind $0.10
warioman: posts big blind $0.20
*** HOLE CARDS ***
Dealt to warioman [4d 5c]
Player#7838: folds
Player#2026: folds
Player#1680: calls $0.20
Player#2842: folds
Player#4896: calls $0.10
warioman: checks
*** FLOP *** [2c As 2d]
Player#4896: checks
warioman: checks
Player#1680: bets $2.23
Player#4896: folds
warioman: folds
Player#1680: doesn't show hand
Uncalled bet ($2.23) returned to Player#1680
Player#1680 collected $0.57 from pot
*** SUMMARY ***
Total Pot $0.60 | Rake $0.03
Board [2c As 2d]
Seat 1: warioman (big blind) folded on the flop
Seat 2: Player#7838 folded before the flop
Seat 3: Player#2026 folded before the flop
Seat 4: Player#1680 shows [] and won ($0.57) with 
Seat 5: Player#2842 (button) folded before the flop
Seat 6: Player#4896 (small blind) folded on the flop

PokerStars Hand #91bee41e-57ad-4891-a06d-53eda49b041b:  Hold'em No Limit ($0.1/$0.20 USD) - 2021/11/21 00:50:00 ET
Table 'Denver' 6-max Seat #3 is the button
Seat 1: Player#1396 ($32.42 in chips)
Seat 2: Player#8180 ($11.50 in chips)
Seat 3: Player#8553 ($43.54 in chips)
Seat 4: warioman ($43.97 in chips)
Seat 5: Player#3573 ($11.02 in chips)
Seat 6: Player#9320 ($19.08 in chips)
warioman: posts small blind $0.10
Player#3573: posts big blind $0.20
*** HOLE CARDS ***
Dealt to warioman [5s Ad]
Player#9320: calls $0.20
Player#1396: folds
Player#8180: raises $0.20 to $0.6
Player#8553: folds
warioman: folds
Player#3573: calls $0.40
Player#9320: calls $0.40
*** FLOP *** [6s Jd As]
Player#3573: checks
Player#9320: bets $1.00
Player#8180: calls $1.00
Player#3573: folds
*** TURN *** [6s Jd As] [4s]
Player#9320: bets $2.50
Player#8180: calls $2.50
*** RIVER *** [6s Jd As] [4s] [8s]
Player#9320: checks
Player#8180: checks
*** SHOW DOWN *** 
Player#9320 collected $8.46 from pot
*** SUMMARY ***
Total Pot $8.90 | Rake $0.45
Board [6s Jd As 4s 8s]
Seat 1: Player#1396 folded before the flop
Seat 2: Player#8180 mucked
Seat 3: Player#8553 (button) folded before the flop
Seat 4: warioman (small blind) folded before the flop
Seat 5: Player#3573 (big blind) folded on the flop
Seat 6: Player#9320 shows [Qd 8h] and won ($8.46) with 

PokerStars Hand #c2eb9dde-67e5-4b0d-b936-8cc6419f755a:  Hold'em No Limit ($0.1/$0.20 USD) - 2021/11/21 00:49:00 ET
Table 'Lacey' 6-max Seat #4 is the button
Seat 1: warioman ($57.98 in chips)
Seat 2: Player#5817 ($42.28 in chips)
Seat 3: Player#4498 ($30.24 in chips)
Seat 4: Player#9452 ($2.43 in chips)
Seat 5: Player#0668 ($13.15 in chips)
Seat 6: Player#7259 ($21.40 in chips)
Player#0668: posts small blind $0.10
Player#7259: posts big blind $0.20
*** HOLE CARDS ***
Dealt to warioman [3s 8c]
warioman: folds
Player#5817: folds
Player#4498: raises $0.20 to $0.6
Player#9452: folds
Player#0668: folds
Player#7259: folds
Player#4498: doesn't show hand
Uncalled bet ($0.60) returned to Player#4498
Player#4498 collected $0.30 from pot
*** SUMMARY ***
Total Pot $0.30 | Rake $0.00
Seat 1: warioman folded before the flop
Seat 2: Player#5817 folded before the flop
Seat 3: Player#4498 shows [] and won ($0.30) with 
Seat 4: Player#9452 (button) folded before the flop
Seat 5: Player#0668 (small blind) folded before the flop
Seat 6: Player#7259 (big blind) folded before the flop

PokerStars Hand #040cf107-a953-403d-a672-f87acba84907:  Hold'em No Limit ($0.1/$0.20 USD) - 2021/11/21 00:49:00 ET
Table 'Lacey' 6-max Seat #3 is the button
Seat 1: warioman ($57.98 in chips)
Seat 2: Player#9172 ($42.28 in chips)
Seat 3: Player#4060 ($30.24 in chips)
Seat 4: Player#8997 ($2.63 in chips)
Seat 5: Player#4355 ($12.95 in chips)
Seat 6: Player#6107 ($21.40 in chips)
Player#8997: posts small blind $0.10
Player#4355: posts big blind $0.20
*** HOLE CARDS ***
Dealt to warioman [Qc Js]
Player#6107: folds
warioman: folds
Player#9172: folds
Player#4060: folds
Player#8997: calls $0.10
Player#4355: raises $0.20 to $0.6
Player#8997: folds
Player#4355: doesn't show hand
Uncalled bet ($0.60) returned to Player#4355
Player#4355 collected $0.20 from pot
*** SUMMARY ***
Total Pot $0.20 | Rake $0.00
Seat 1: warioman folded before the flop
Seat 2: Player#9172 folded before the flop
Seat 3: Player#4060 (button) folded before the flop
Seat 4: Player#8997 (small blind) folded before the flop
Seat 5: Player#4355 shows [] and won ($0.20) with 
Seat 6: Player#6107 folded before the flop

PokerStars Hand #ec2aa9e7-6fbc-4651-80de-95acc0723f3b:  Hold'em No Limit ($0.1/$0.20 USD) - 2021/11/21 00:48:00 ET
Table 'Denver' 6-max Seat #2 is the button
Seat 1: Player#8613 ($29.39 in chips)
Seat 2: Player#4843 ($14.55 in chips)
Seat 3: Player#5921 ($43.64 in chips)
Seat 4: warioman ($44.17 in chips)
Seat 5: Player#6931 ($11.02 in chips)
Seat 6: Player#4439 ($19.08 in chips)
Player#5921: posts small blind $0.10
warioman: posts big blind $0.20
*** HOLE CARDS ***
Dealt to warioman [6c Kd]
Player#6931: folds
Player#4439: folds
Player#8613: raises $0.20 to $0.4
Player#4843: raises $0.40 to $1.13
Player#5921: folds
warioman: folds
Player#8613: calls $0.73
*** FLOP *** [Jh 4d 9h]
Player#8613: checks
Player#4843: checks
*** TURN *** [Jh 4d 9h] [5c]
Player#8613: checks
Player#4843: bets $1.92
Player#8613: calls $1.92
*** RIVER *** [Jh 4d 9h] [5c] [3c]
Player#8613: checks
Player#4843: checks
*** SHOW DOWN *** 
Player#8613 collected $6.08 from pot
*** SUMMARY ***
Total Pot $6.40 | Rake $0.32
Board [Jh 4d 9h 5c 3c]
Seat 1: Player#8613 shows [Tc Jd] and won ($6.08) with 
Seat 2: Player#4843 (button) mucked
Seat 3: Player#5921 (small blind) folded before the flop
Seat 4: warioman (big blind) folded before the flop
Seat 5: Player#6931 folded before the flop
Seat 6: Player#4439 folded before the flop

PokerStars Hand #33760f9c-4eab-4710-bc9f-65ffee5b27b8:  Hold'em No Limit ($0.1/$0.20 USD) - 2021/11/21 00:48:00 ET
Table 'Lacey' 6-max Seat #2 is the button
Seat 1: warioman ($57.98 in chips)
Seat 2: Player#1145 ($41.24 in chips)
Seat 3: Player#4599 ($30.34 in chips)
Seat 4: Player#1064 ($3.68 in chips)
Seat 5: Player#5566 ($12.95 in chips)
Seat 6: Player#6673 ($21.40 in chips)
Player#4599: posts small blind $0.10
Player#1064: posts big blind $0.20
*** HOLE CARDS ***
Dealt to warioman [5h 6d]
Player#5566: folds
Player#6673: folds
warioman: folds
Player#1145: raises $0.20 to $0.55
Player#4599: folds
Player#1064: calls $0.35
*** FLOP *** [9h 9d 9s]
Player#1064: checks
Player#1145: checks
*** TURN *** [9h 9d 9s] [Ad]
Player#1064: checks
Player#1145: checks
*** RIVER *** [9h 9d 9s] [Ad] [8d]
Player#1064: checks
Player#1145: bets $0.50
Player#1064: calls $0.50
*** SHOW DOWN *** 
Player#1064: doesn't show hand
Player#1145 collected $2.09 from pot
*** SUMMARY ***
Total Pot $2.20 | Rake $0.11
Board [9h 9d 9s Ad 8d]
Seat 1: warioman folded before the flop
Seat 2: Player#1145 shows [7h 9c] and won ($2.09) with 
Seat 3: Player#4599 (small blind) folded before the flop
Seat 4: Player#1064 (big blind) mucked
Seat 5: Player#5566 folded before the flop
Seat 6: Player#6673 folded before the flop

PokerStars Hand #73af0368-a111-4c41-ac23-1a6df4135bad:  Hold'em No Limit ($0.1/$0.20 USD) - 2021/11/21 00:47:00 ET
Table 'Lacey' 6-max Seat #1 is the button
Seat 1: warioman ($57.98 in chips)
Seat 2: Player#9589 ($41.34 in chips)
Seat 3: Player#7529 ($29.13 in chips)
Seat 4: Player#1865 ($4.28 in chips)
Seat 5: Player#5549 ($13.55 in chips)
Seat 6: Player#9532 ($21.40 in chips)
Player#9589: posts small blind $0.10
Player#7529: posts big blind $0.20
*** HOLE CARDS ***
Dealt to warioman [Ks Jd]
Player#1865: calls $0.20
Player#5549: raises $0.20 to $0.6
Player#9532: folds
warioman: folds
Player#9589: folds
Player#7529: calls $0.40
Player#1865: calls $0.40
*** FLOP *** [7s 4c Ah]
Player#7529: checks
Player#1865: checks
Player#5549: checks
*** TURN *** [7s 4c Ah] [3c]
Player#7529: bets $1.42
Player#1865: folds
Player#5549: folds
Player#7529: doesn't show hand
Uncalled bet ($1.42) returned to Player#7529
Player#7529 collected $1.81 from pot
*** SUMMARY ***
Total Pot $1.90 | Rake $0.10
Board [7s 4c Ah 3c]
Seat 1: warioman (button) folded before the flop
Seat 2: Player#9589 (small blind) folded before the flop
Seat 3: Player#7529 shows [] and won ($1.81) with 
Seat 4: Player#1865 folded on the turn
Seat 5: Player#5549 folded on the turn
Seat 6: Player#9532 folded before the flop

PokerStars Hand #2dc18ca5-d18d-4f07-80ae-fa0e4964ae60:  Hold'em No Limit ($0.1/$0.20 USD) - 2021/11/21 00:47:00 ET
Table 'Denver' 6-max Seat #1 is the button
Seat 1: Player#2538 ($29.39 in chips)
Seat 2: Player#1813 ($15.35 in chips)
Seat 3: Player#4159 ($43.84 in chips)
Seat 4: warioman ($40.43 in chips)
Seat 5: Player#3121 ($11.02 in chips)
Seat 6: Player#2793 ($22.18 in chips)
Player#1813: posts small blind $0.10
Player#4159: posts big blind $0.20
*** HOLE CARDS ***
Dealt to warioman [5c Ac]
warioman: raises $0.20 to $0.5
Player#3121: folds
Player#2793: raises $0.50 to $0.8
Player#2538: folds
Player#1813: calls $0.70
Player#4159: folds
warioman: calls $0.30
*** FLOP *** [2h As 8c]
Player#1813: checks
warioman: checks
Player#2793: bets $0.60
Player#1813: folds
warioman: calls $0.60
*** TURN *** [2h As 8c] [Tc]
warioman: checks
Player#2793: bets $0.70
warioman: calls $0.70
*** RIVER *** [2h As 8c] [Tc] [4c]
warioman: checks
Player#2793: bets $1.00
warioman: calls $1.00
*** SHOW DOWN *** 
warioman collected $6.84 from pot
*** SUMMARY ***
Total Pot $7.20 | Rake $0.36
Board [2h As 8c Tc 4c]
Seat 1: Player#2538 (button) folded before the flop
Seat 2: Player#1813 (small blind) folded on the flop
Seat 3: Player#4159 (big blind) folded before the flop
Seat 4: warioman
Seat 5: Player#3121 folded before the flop
Seat 6: Player#2793 mucked

PokerStars Hand #ed3e430f-f759-47b2-81cf-c6a702c8faf0:  Hold'em No Limit ($0.1/$0.20 USD) - 2021/11/21 00:46:00 ET
Table 'Lacey' 6-max Seat #6 is the button
Seat 1: warioman ($56.71 in chips)
Seat 2: Player#4411 ($41.54 in chips)
Seat 3: Player#2617 ($29.13 in chips)
Seat 4: Player#1457 ($5.48 in chips)
Seat 5: Player#9016 ($13.55 in chips)
Seat 6: Player#4787 ($21.40 in chips)
warioman: posts small blind $0.10
Player#4411: posts big blind $0.20
*** HOLE CARDS ***
Dealt to warioman [9s 7s]
Player#2617: folds
Player#1457: calls $0.20
Player#9016: folds
Player#4787: folds
warioman: calls $0.10
Player#4411: checks
*** FLOP *** [4h 7h 9d]
warioman: bets $0.40
Player#4411: folds
Player#1457: calls $0.40
*** TURN *** [4h 7h 9d] [6h]
warioman: bets $0.60
Player#1457: calls $0.60
*** RIVER *** [4h 7h 9d] [6h] [Th]
warioman: checks
Player#1457: checks
*** SHOW DOWN *** 
warioman collected $2.47 from pot
*** SUMMARY ***
Total Pot $2.60 | Rake $0.13
Board [4h 7h 9d 6h Th]
Seat 1: warioman (small blind)
Seat 2: Player#4411 (big blind) folded on the flop
Seat 3: Player#2617 folded before the flop
Seat 4: Player#1457 mucked
Seat 5: Player#9016 folded before the flop
Seat 6: Player#4787 (button) folded before the flop

PokerStars Hand #3d2eda7c-6683-4c6e-81f9-4100c1931909:  Hold'em No Limit ($0.1/$0.20 USD) - 2021/11/21 00:46:00 ET
Table 'Denver' 6-max Seat #6 is the button
Seat 1: Player#4841 ($29.99 in chips)
Seat 2: Player#1659 ($19.30 in chips)
Seat 3: Player#1513 ($39.71 in chips)
Seat 4: warioman ($40.43 in chips)
Seat 5: Player#4468 ($11.02 in chips)
Seat 6: Player#8092 ($22.18 in chips)
Player#4841: posts small blind $0.10
Player#1659: posts big blind $0.20
*** HOLE CARDS ***
Dealt to warioman [7c 7h]
Player#1513: raises $0.20 to $0.6
warioman: folds
Player#4468: folds
Player#8092: folds
Player#4841: calls $0.50
Player#1659: calls $0.40
*** FLOP *** [9d Kh 5s]
Player#4841: checks
Player#1659: checks
Player#1513: bets $0.80
Player#4841: folds
Player#1659: calls $0.80
*** TURN *** [9d Kh 5s] [Ts]
Player#1659: bets $2.55
Player#1513: calls $2.55
*** RIVER *** [9d Kh 5s] [Ts] [9s]
Player#1659: checks
Player#1513: bets $35.76
Player#1659: folds
Player#1513: doesn't show hand
Uncalled bet ($35.76) returned to Player#1513
Player#1513 collected $8.07 from pot
*** SUMMARY ***
Total Pot $8.50 | Rake $0.43
Board [9d Kh 5s Ts 9s]
Seat 1: Player#4841 (small blind) folded on the flop
Seat 2: Player#1659 (big blind) folded on the river
Seat 3: Player#1513 shows [] and won ($8.07) with 
Seat 4: warioman folded before the flop
Seat 5: Player#4468 folded before the flop
Seat 6: Player#8092 (button) folded before the flop

PokerStars Hand #aff03f88-1047-458d-8f2e-0ea230964e2a:  Hold'em No Limit ($0.1/$0.20 USD) - 2021/11/21 00:45:00 ET
Table 'Lacey' 6-max Seat #4 is the button
Seat 1: warioman ($47.97 in chips)
Seat 2: Player#6735 ($30.73 in chips)
Seat 3: Player#4984 ($13.18 in chips)
Seat 4: Player#5449 ($13.75 in chips)
Seat 5: Player#3076 ($21.50 in chips)
Player#3076: posts small blind $0.10
warioman: posts big blind $0.20
*** HOLE CARDS ***
Dealt to warioman [Ah As]
Player#6735: calls $0.20
Player#4984: calls $0.20
Player#5449: calls $0.20
Player#3076: folds
warioman: raises $0.20 to $1.6
Player#6735: calls $1.40
Player#4984: calls $1.40
Player#5449: folds
*** FLOP *** [Td 3c Qh]
warioman: bets $1.73
Player#6735: folds
Player#4984: calls $1.73
*** TURN *** [Td 3c Qh] [8h]
warioman: checks
Player#4984: checks
*** RIVER *** [Td 3c Qh] [8h] [5h]
warioman: bets $4.37
Player#4984: calls $4.37
*** SHOW DOWN *** 
Player#4984: doesn't show hand
warioman collected $16.44 from pot
*** SUMMARY ***
Total Pot $17.30 | Rake $0.87
Board [Td 3c Qh 8h 5h]
Seat 1: warioman (big blind)
Seat 2: Player#6735 folded on the flop
Seat 3: Player#4984 mucked
Seat 4: Player#5449 (button) folded before the flop
Seat 5: Player#3076 (small blind) folded before the flop

PokerStars Hand #de7bd608-dc97-4061-83c0-10d281bd57bc:  Hold'em No Limit ($0.1/$0.20 USD) - 2021/11/21 00:45:00 ET
Table 'Denver' 6-max Seat #5 is the button
Seat 1: Player#1073 ($28.41 in chips)
Seat 2: Player#6146 ($20.95 in chips)
Seat 3: Player#8769 ($39.71 in chips)
Seat 4: warioman ($40.43 in chips)
Seat 5: Player#0868 ($11.02 in chips)
Seat 6: Player#8201 ($22.28 in chips)
Player#8201: posts small blind $0.10
Player#1073: posts big blind $0.20
*** HOLE CARDS ***
Dealt to warioman [Qc Ks]
Player#6146: raises $0.20 to $0.8
Player#8769: folds
warioman: folds
Player#0868: folds
Player#8201: folds
Player#1073: calls $0.60
*** FLOP *** [8d 5h 3h]
Player#1073: checks
Player#6146: bets $0.85
Player#1073: calls $0.85
*** TURN *** [8d 5h 3h] [Kc]
Player#1073: checks
Player#6146: checks
*** RIVER *** [8d 5h 3h] [Kc] [Qc]
Player#1073: checks
Player#6146: checks
*** SHOW DOWN *** 
Player#1073 collected $3.23 from pot
*** SUMMARY ***
Total Pot $3.40 | Rake $0.17
Board [8d 5h 3h Kc Qc]
Seat 1: Player#1073 shows [7h Jh] and won ($3.23) with 
Seat 2: Player#6146 mucked
Seat 3: Player#8769 folded before the flop
Seat 4: warioman folded before the flop
Seat 5: Player#0868 (button) folded before the flop
Seat 6: Player#8201 (small blind) folded before the flop

PokerStars Hand #429f20a4-5d75-43d4-93ec-c9e13608799b:  Hold'em No Limit ($0.1/$0.20 USD) - 2021/11/21 00:45:00 ET
Table 'Lacey' 6-max Seat #3 is the button
Seat 1: warioman ($47.97 in chips)
Seat 2: Player#5907 ($31.33 in chips)
Seat 3: Player#0290 ($12.35 in chips)
Seat 4: Player#0392 ($13.85 in chips)
Seat 5: Player#9162 ($21.70 in chips)
Player#0392: posts small blind $0.10
Player#9162: posts big blind $0.20
*** HOLE CARDS ***
Dealt to warioman [Qs Jd]
warioman: folds
Player#5907: raises $0.20 to $0.6
Player#0290: calls $0.60
Player#0392: folds
Player#9162: folds
*** FLOP *** [8s Ks 4h]
Player#5907: checks
Player#0290: checks
*** TURN *** [8s Ks 4h] [4s]
Player#5907: checks
Player#0290: bets $1.50
Player#5907: folds
Player#0290: doesn't show hand
Uncalled bet ($1.50) returned to Player#0290
Player#0290 collected $1.43 from pot
*** SUMMARY ***
Total Pot $1.50 | Rake $0.08
Board [8s Ks 4h 4s]
Seat 1: warioman folded before the flop
Seat 2: Player#5907 folded on the turn
Seat 3: Player#0290 shows [] and won ($1.43) with 
Seat 4: Player#0392 (small blind) folded before the flop
Seat 5: Player#9162 (big blind) folded before the flop

PokerStars Hand #4ac83f06-20e5-489f-9ae6-3671517696a5:  Hold'em No Limit ($0.1/$0.20 USD) - 2021/11/21 00:45:00 ET
Table 'Denver' 6-max Seat #4 is the button
Seat 1: Player#4445 ($28.41 in chips)
Seat 2: Player#7835 ($20.95 in chips)
Seat 3: Player#1553 ($39.71 in chips)
Seat 4: warioman ($40.43 in chips)
Seat 5: Player#9708 ($11.12 in chips)
Seat 6: Player#9972 ($22.18 in chips)
Player#9708: posts small blind $0.10
Player#9972: posts big blind $0.20
*** HOLE CARDS ***
Dealt to warioman [8s 9c]
Player#4445: folds
Player#7835: folds
Player#1553: folds
warioman: folds
Player#9708: folds
Player#9972 collected $0.20 from pot
*** SUMMARY ***
Total Pot $0.20 | Rake $0.00
Seat 1: Player#4445 folded before the flop
Seat 2: Player#7835 folded before the flop
Seat 3: Player#1553 folded before the flop
Seat 4: warioman (button) folded before the flop
Seat 5: Player#9708 (small blind) folded before the flop
Seat 6: Player#9972 shows [] and won ($0.20) with 

PokerStars Hand #4695a1de-d120-42e1-91b1-b6dcd363641f:  Hold'em No Limit ($0.1/$0.20 USD) - 2021/11/21 00:44:00 ET
Table 'Lacey' 6-max Seat #2 is the button
Seat 1: warioman ($47.27 in chips)
Seat 2: Player#7461 ($31.33 in chips)
Seat 3: Player#8766 ($12.45 in chips)
Seat 4: Player#6089 ($14.05 in chips)
Seat 5: Player#1239 ($22.10 in chips)
Player#8766: posts small blind $0.10
Player#6089: posts big blind $0.20
*** HOLE CARDS ***
Dealt to warioman [8c 8s]
Player#1239: raises $0.20 to $0.4
warioman: raises $0.40 to $1.5
Player#7461: folds
Player#8766: folds
Player#6089: folds
Player#1239: folds
warioman: doesn't show hand
Uncalled bet ($1.50) returned to warioman
warioman collected $0.70 from pot
*** SUMMARY ***
Total Pot $0.70 | Rake $0.00
Seat 1: warioman
Seat 2: Player#7461 (button) folded before the flop
Seat 3: Player#8766 (small blind) folded before the flop
Seat 4: Player#6089 (big blind) folded before the flop
Seat 5: Player#1239 folded before the flop

PokerStars Hand #2e395453-0260-4564-9c7a-d4fc3be85623:  Hold'em No Limit ($0.1/$0.20 USD) - 2021/11/21 00:44:00 ET
Table 'Lacey' 6-max Seat #1 is the button
Seat 1: warioman ($47.27 in chips)
Seat 2: Player#8086 ($32.73 in chips)
Seat 3: Player#7238 ($11.19 in chips)
Seat 4: Player#6593 ($14.05 in chips)
Seat 5: Player#4601 ($22.10 in chips)
Player#8086: posts small blind $0.10
Player#7238: posts big blind $0.20
*** HOLE CARDS ***
Dealt to warioman [9s Tc]
Player#6593: folds
Player#4601: folds
warioman: folds
Player#8086: raises $0.20 to $0.6
Player#7238: calls $0.40
*** FLOP *** [8s As 2h]
Player#8086: bets $0.80
Player#7238: calls $0.80
*** TURN *** [8s As 2h] [Jd]
Player#8086: checks
Player#7238: checks
*** RIVER *** [8s As 2h] [Jd] [2d]
Player#8086: checks
Player#7238: checks
*** SHOW DOWN *** 
Player#7238 collected $2.66 from pot
*** SUMMARY ***
Total Pot $2.80 | Rake $0.14
Board [8s As 2h Jd 2d]
Seat 1: warioman (button) folded before the flop
Seat 2: Player#8086 (small blind) mucked
Seat 3: Player#7238 shows [Td 8d] and won ($2.66) with 
Seat 4: Player#6593 folded before the flop
Seat 5: Player#4601 folded before the flop

PokerStars Hand #54e0d514-49dd-4b21-8789-e3ab4a3eb3f8:  Hold'em No Limit ($0.1/$0.20 USD) - 2021/11/21 00:44:00 ET
Table 'Denver' 6-max Seat #3 is the button
Seat 1: Player#3522 ($28.41 in chips)
Seat 2: Player#9202 ($24.80 in chips)
Seat 3: Player#8187 ($35.58 in chips)
Seat 4: warioman ($40.53 in chips)
Seat 5: Player#1821 ($11.72 in chips)
Seat 6: Player#6797 ($22.18 in chips)
warioman: posts small blind $0.10
Player#1821: posts big blind $0.20
*** HOLE CARDS ***
Dealt to warioman [4d 3s]
Player#6797: folds
Player#3522: folds
Player#9202: raises $0.20 to $0.6
Player#8187: calls $0.60
warioman: folds
Player#1821: calls $0.40
*** FLOP *** [Qs 5s 9c]
Player#1821: checks
Player#9202: checks
Player#8187: bets $1.15
Player#1821: folds
Player#9202: calls $1.15
*** TURN *** [Qs 5s 9c] [Kh]
Player#9202: checks
Player#8187: bets $2.10
Player#9202: calls $2.10
*** RIVER *** [Qs 5s 9c] [Kh] [Jh]
Player#9202: checks
Player#8187: checks
*** SHOW DOWN *** 
Player#8187 collected $7.98 from pot
*** SUMMARY ***
Total Pot $8.40 | Rake $0.42
Board [Qs 5s 9c Kh Jh]
Seat 1: Player#3522 folded before the flop
Seat 2: Player#9202 mucked
Seat 3: Player#8187 shows [Qd Ad] and won ($7.98) with 
Seat 4: warioman (small blind) folded before the flop
Seat 5: Player#1821 (big blind) folded on the flop
Seat 6: Player#6797 folded before the flop

PokerStars Hand #d210f45d-60fc-45b2-94e8-70aafe805145:  Hold'em No Limit ($0.1/$0.20 USD) - 2021/11/21 00:43:00 ET
Table 'Denver' 6-max Seat #2 is the button
Seat 1: Player#4768 ($28.41 in chips)
Seat 2: Player#9417 ($24.80 in chips)
Seat 3: Player#4060 ($36.18 in chips)
Seat 4: warioman ($40.73 in chips)
Seat 5: Player#6845 ($10.99 in chips)
Seat 6: Player#9627 ($22.18 in chips)
Player#4060: posts small blind $0.10
warioman: posts big blind $0.20
*** HOLE CARDS ***
Dealt to warioman [9s 4h]
Player#6845: raises $0.20 to $0.6
Player#9627: folds
Player#4768: folds
Player#9417: folds
Player#4060: calls $0.50
warioman: folds
*** FLOP *** [6d 9d 7d]
Player#4060: checks
Player#6845: checks
*** TURN *** [6d 9d 7d] [Jd]
Player#4060: checks
Player#6845: bets $0.40
Player#4060: folds
Player#6845: doesn't show hand
Uncalled bet ($0.40) returned to Player#6845
Player#6845 collected $1.33 from pot
*** SUMMARY ***
Total Pot $1.40 | Rake $0.07
Board [6d 9d 7d Jd]
Seat 1: Player#4768 folded before the flop
Seat 2: Player#9417 (button) folded before the flop
Seat 3: Player#4060 (small blind) folded on the turn
Seat 4: warioman (big blind) folded before the flop
Seat 5: Player#6845 shows [] and won ($1.33) with 
Seat 6: Player#9627 folded before the flop

PokerStars Hand #05ace732-72f6-4eb4-ab46-4bbe68205708:  Hold'em No Limit ($0.1/$0.20 USD) - 2021/11/21 00:43:00 ET
Table 'Lacey' 6-max Seat #6 is the button
Seat 1: warioman ($47.37 in chips)
Seat 2: Player#2328 ($31.87 in chips)
Seat 3: Player#0316 ($14.05 in chips)
Seat 4: Player#5224 ($22.95 in chips)
warioman: posts small blind $0.10
Player#2328: posts big blind $0.20
*** HOLE CARDS ***
Dealt to warioman [3h Kd]
Player#0316: folds
Player#5224: raises $0.20 to $0.4
warioman: folds
Player#2328: raises $0.40 to $0.85
Player#5224: calls $0.45
*** FLOP *** [5d 9c 5h]
Player#2328: checks
Player#5224: checks
*** TURN *** [5d 9c 5h] [2d]
Player#2328: bets $1.35
Player#5224: folds
Player#2328: doesn't show hand
Uncalled bet ($1.35) returned to Player#2328
Player#2328 collected $1.71 from pot
*** SUMMARY ***
Total Pot $1.80 | Rake $0.09
Board [5d 9c 5h 2d]
Seat 1: warioman (small blind) folded before the flop
Seat 2: Player#2328 shows [] and won ($1.71) with 
Seat 3: Player#0316 folded before the flop
Seat 4: Player#5224 folded on the turn

PokerStars Hand #c2571f79-b73d-4389-8492-248d05153994:  Hold'em No Limit ($0.1/$0.20 USD) - 2021/11/21 00:42:00 ET
Table 'Lacey' 6-max Seat #3 is the button
Seat 1: warioman ($47.40 in chips)
Seat 2: Player#8370 ($31.87 in chips)
Seat 3: Player#4601 ($14.05 in chips)
Seat 4: Player#1420 ($22.98 in chips)
Player#1420: posts small blind $0.10
warioman: posts big blind $0.20
*** HOLE CARDS ***
Dealt to warioman [4h As]
Player#8370: folds
Player#4601: folds
Player#1420: raises $0.20 to $0.6
warioman: calls $0.40
*** FLOP *** [Qd Ks 3c]
Player#1420: checks
warioman: checks
*** TURN *** [Qd Ks 3c] [3d]
Player#1420: checks
warioman: checks
*** RIVER *** [Qd Ks 3c] [3d] [Kd]
Player#1420: checks
warioman: checks
*** SHOW DOWN *** 
 *** SUMMARY ***
Total Pot $1.20 | Rake $0.06
Board [Qd Ks 3c 3d Kd]
Seat 1: warioman (big blind)
Seat 2: Player#8370 folded before the flop
Seat 3: Player#4601 (button) folded before the flop
Seat 4: Player#1420 (small blind) mucked

PokerStars Hand #4197c94d-d8e7-4e66-87f1-985a05a96cf7:  Hold'em No Limit ($0.1/$0.20 USD) - 2021/11/21 00:42:00 ET
Table 'Lacey' 6-max Seat #2 is the button
Seat 1: warioman ($47.40 in chips)
Seat 2: Player#8373 ($31.87 in chips)
Seat 3: Player#4652 ($14.15 in chips)
Seat 4: Player#9492 ($22.88 in chips)
Player#4652: posts small blind $0.10
Player#9492: posts big blind $0.20
*** HOLE CARDS ***
Dealt to warioman [Js 8h]
warioman: folds
Player#8373: folds
Player#4652: folds
Player#9492 collected $0.20 from pot
*** SUMMARY ***
Total Pot $0.20 | Rake $0.00
Seat 1: warioman folded before the flop
Seat 2: Player#8373 (button) folded before the flop
Seat 3: Player#4652 (small blind) folded before the flop
Seat 4: Player#9492 shows [] and won ($0.20) with 

PokerStars Hand #6ec2cd94-6d70-4b79-9f56-e26e55fc1106:  Hold'em No Limit ($0.1/$0.20 USD) - 2021/11/21 00:42:00 ET
Table 'Denver' 6-max Seat #1 is the button
Seat 1: Player#1475 ($28.61 in chips)
Seat 2: Player#3775 ($24.90 in chips)
Seat 3: Player#2887 ($35.35 in chips)
Seat 4: warioman ($40.73 in chips)
Seat 5: Player#7993 ($10.99 in chips)
Seat 6: Player#3971 ($22.78 in chips)
Player#3775: posts small blind $0.10
Player#2887: posts big blind $0.20
*** HOLE CARDS ***
Dealt to warioman [Qc 8s]
warioman: folds
Player#7993: folds
Player#3971: calls $0.20
Player#1475: calls $0.20
Player#3775: folds
Player#2887: checks
*** FLOP *** [4s 7d Ah]
Player#2887: checks
Player#3971: bets $0.40
Player#1475: folds
Player#2887: calls $0.40
*** TURN *** [4s 7d Ah] [3h]
Player#2887: checks
Player#3971: checks
*** RIVER *** [4s 7d Ah] [3h] [8h]
Player#2887: bets $1.50
Player#3971: folds
Player#2887: doesn't show hand
Uncalled bet ($1.50) returned to Player#2887
Player#2887 collected $1.43 from pot
*** SUMMARY ***
Total Pot $1.50 | Rake $0.08
Board [4s 7d Ah 3h 8h]
Seat 1: Player#1475 (button) folded on the flop
Seat 2: Player#3775 (small blind) folded before the flop
Seat 3: Player#2887 shows [] and won ($1.43) with 
Seat 4: warioman folded before the flop
Seat 5: Player#7993 folded before the flop
Seat 6: Player#3971 folded on the river

PokerStars Hand #6e16bb3f-3913-47c2-82f0-8875c810a8db:  Hold'em No Limit ($0.1/$0.20 USD) - 2021/11/21 00:41:00 ET
Table 'Lacey' 6-max Seat #1 is the button
Seat 1: warioman ($47.40 in chips)
Seat 2: Player#3967 ($32.47 in chips)
Seat 3: Player#3097 ($14.35 in chips)
Seat 4: Player#9436 ($22.15 in chips)
Player#3967: posts small blind $0.10
Player#3097: posts big blind $0.20
*** HOLE CARDS ***
Dealt to warioman [5c Th]
Player#9436: raises $0.20 to $0.4
warioman: folds
Player#3967: calls $0.30
Player#3097: folds
*** FLOP *** [Ah 4d 8c]
Player#3967: checks
Player#9436: bets $0.20
Player#3967: calls $0.20
*** TURN *** [Ah 4d 8c] [5s]
Player#3967: checks
Player#9436: bets $2.00
Player#3967: folds
Player#9436: doesn't show hand
Uncalled bet ($2.00) returned to Player#9436
Player#9436 collected $1.33 from pot
*** SUMMARY ***
Total Pot $1.40 | Rake $0.07
Board [Ah 4d 8c 5s]
Seat 1: warioman (button) folded before the flop
Seat 2: Player#3967 (small blind) folded on the turn
Seat 3: Player#3097 (big blind) folded before the flop
Seat 4: Player#9436 shows [] and won ($1.33) with 

PokerStars Hand #dc5eba0d-3892-457c-86f4-a268199d3d41:  Hold'em No Limit ($0.1/$0.20 USD) - 2021/11/21 00:41:00 ET
Table 'Denver' 6-max Seat #6 is the button
Seat 1: Player#8395 ($28.71 in chips)
Seat 2: Player#4189 ($23.72 in chips)
Seat 3: Player#7908 ($35.35 in chips)
Seat 4: warioman ($41.93 in chips)
Seat 5: Player#5165 ($10.99 in chips)
Seat 6: Player#2508 ($22.78 in chips)
Player#8395: posts small blind $0.10
Player#4189: posts big blind $0.20
*** HOLE CARDS ***
Dealt to warioman [Qs As]
Player#7908: folds
warioman: raises $0.20 to $0.5
Player#5165: folds
Player#2508: folds
Player#8395: folds
Player#4189: raises $0.50 to $1.2
warioman: calls $0.70
*** FLOP *** [6s Th 5c]
Player#4189: bets $5.40
warioman: folds
Player#4189: doesn't show hand
Uncalled bet ($5.40) returned to Player#4189
Player#4189 collected $2.38 from pot
*** SUMMARY ***
Total Pot $2.50 | Rake $0.12
Board [6s Th 5c]
Seat 1: Player#8395 (small blind) folded before the flop
Seat 2: Player#4189 shows [] and won ($2.38) with 
Seat 3: Player#7908 folded before the flop
Seat 4: warioman folded on the flop
Seat 5: Player#5165 folded before the flop
Seat 6: Player#2508 (button) folded before the flop

PokerStars Hand #5226fdcb-9b1e-4eae-baaa-c8afe45322fc:  Hold'em No Limit ($0.1/$0.20 USD) - 2021/11/21 00:41:00 ET
Table 'Lacey' 6-max Seat #6 is the button
Seat 1: warioman ($47.50 in chips)
Seat 2: Player#5684 ($41.54 in chips)
Seat 3: Player#4888 ($31.61 in chips)
Seat 4: Player#7602 ($14.35 in chips)
Seat 5: Player#8888 ($23.00 in chips)
warioman: posts small blind $0.10
Player#4888: posts big blind $0.20
*** HOLE CARDS ***
Dealt to warioman [Kh 5h]
Player#5684 Decline Entry Bet
Player#7602: folds
Player#8888: raises $0.20 to $0.4
warioman: folds
Player#4888: calls $0.20
*** FLOP *** [7h Th Qs]
Player#4888: checks
Player#8888: checks
*** TURN *** [7h Th Qs] [3c]
Player#4888: bets $0.45
Player#8888: calls $0.45
*** RIVER *** [7h Th Qs] [3c] [3c]
Player#4888: bets $1.35
Player#8888: folds
Player#4888: doesn't show hand
Uncalled bet ($1.35) returned to Player#4888
Player#4888 collected $1.71 from pot
*** SUMMARY ***
Total Pot $1.80 | Rake $0.09
Board [7h Th Qs 3c 3c]
Seat 1: warioman (small blind) folded before the flop
Seat 2: Player#5684 mucked
Seat 3: Player#4888 shows [] and won ($1.71) with 
Seat 4: Player#7602 folded before the flop
Seat 5: Player#8888 folded on the river

PokerStars Hand #b7c92624-16a2-47f6-9bbc-bc3c936aa495:  Hold'em No Limit ($0.1/$0.20 USD) - 2021/11/21 00:41:00 ET
Table 'Denver' 6-max Seat #5 is the button
Seat 1: Player#2258 ($28.91 in chips)
Seat 2: Player#1859 ($23.72 in chips)
Seat 3: Player#0948 ($35.35 in chips)
Seat 4: warioman ($41.63 in chips)
Seat 5: Player#1382 ($10.99 in chips)
Seat 6: Player#7240 ($22.88 in chips)
Player#7240: posts small blind $0.10
Player#2258: posts big blind $0.20
*** HOLE CARDS ***
Dealt to warioman [Td 8d]
Player#1859: folds
Player#0948: folds
warioman: raises $0.20 to $0.5
Player#1382: folds
Player#7240: folds
Player#2258: folds
warioman: doesn't show hand
Uncalled bet ($0.50) returned to warioman
warioman collected $0.30 from pot
*** SUMMARY ***
Total Pot $0.30 | Rake $0.00
Seat 1: Player#2258 (big blind) folded before the flop
Seat 2: Player#1859 folded before the flop
Seat 3: Player#0948 folded before the flop
Seat 4: warioman
Seat 5: Player#1382 (button) folded before the flop
Seat 6: Player#7240 (small blind) folded before the flop

PokerStars Hand #cdcdd1bb-195c-417f-8456-c9247e4b6696:  Hold'em No Limit ($0.1/$0.20 USD) - 2021/11/21 00:40:00 ET
Table 'Lacey' 6-max Seat #4 is the button
Seat 1: warioman ($47.70 in chips)
Seat 2: Player#7924 ($41.54 in chips)
Seat 3: Player#6355 ($29.41 in chips)
Seat 4: Player#1074 ($14.95 in chips)
Seat 5: Player#7764 ($24.60 in chips)
Player#7764: posts small blind $0.10
warioman: posts big blind $0.20
*** HOLE CARDS ***
Dealt to warioman [7s 4s]
Player#7924: folds
Player#6355: raises $0.20 to $0.6
Player#1074: calls $0.60
Player#7764: calls $0.50
warioman: folds
*** FLOP *** [2s 3h Tc]
Player#7764: checks
Player#6355: bets $1.00
Player#1074: folds
Player#7764: calls $1.00
*** TURN *** [2s 3h Tc] [Kc]
Player#7764: checks
Player#6355: bets $2.00
Player#7764: folds
Player#6355: doesn't show hand
Uncalled bet ($2.00) returned to Player#6355
Player#6355 collected $3.80 from pot
*** SUMMARY ***
Total Pot $4.00 | Rake $0.20
Board [2s 3h Tc Kc]
Seat 1: warioman (big blind) folded before the flop
Seat 2: Player#7924 folded before the flop
Seat 3: Player#6355 shows [] and won ($3.80) with 
Seat 4: Player#1074 (button) folded on the flop
Seat 5: Player#7764 (small blind) folded on the turn

PokerStars Hand #091205c0-8643-411a-93ce-8c0f324a2b01:  Hold'em No Limit ($0.1/$0.20 USD) - 2021/11/21 00:39:00 ET
Table 'Denver' 6-max Seat #4 is the button
Seat 1: Player#1453 ($28.91 in chips)
Seat 2: Player#9671 ($24.32 in chips)
Seat 3: Player#2018 ($35.35 in chips)
Seat 4: warioman ($41.63 in chips)
Seat 5: Player#6297 ($15.99 in chips)
Seat 6: Player#7286 ($17.81 in chips)
Player#6297: posts small blind $0.10
Player#7286: posts big blind $0.20
*** HOLE CARDS ***
Dealt to warioman [5d 3c]
Player#1453: folds
Player#9671: raises $0.20 to $0.6
Player#2018: folds
warioman: folds
Player#6297: calls $0.50
Player#7286: calls $0.40
*** FLOP *** [7h 8h 3s]
Player#6297: checks
Player#7286: checks
Player#9671: checks
*** TURN *** [7h 8h 3s] [Kd]
Player#6297: bets $0.80
Player#7286: calls $0.80
Player#9671: folds
*** RIVER *** [7h 8h 3s] [Kd] [7d]
Player#6297: bets $1.40
Player#7286: raises $1.40 to $3.6
Player#6297: calls $2.20
*** SHOW DOWN *** 
Player#6297: doesn't show hand
Player#7286 collected $10.07 from pot
*** SUMMARY ***
Total Pot $10.60 | Rake $0.53
Board [7h 8h 3s Kd 7d]
Seat 1: Player#1453 folded before the flop
Seat 2: Player#9671 folded on the turn
Seat 3: Player#2018 folded before the flop
Seat 4: warioman (button) folded before the flop
Seat 5: Player#6297 (small blind) mucked
Seat 6: Player#7286 shows [Kc Ac] and won ($10.07) with 

PokerStars Hand #d4cf967e-0393-4f7d-a9ed-5ef76034a1d3:  Hold'em No Limit ($0.1/$0.20 USD) - 2021/11/21 00:39:00 ET
Table 'Lacey' 6-max Seat #3 is the button
Seat 1: warioman ($47.70 in chips)
Seat 2: Player#9796 ($41.54 in chips)
Seat 3: Player#7188 ($32.01 in chips)
Seat 4: Player#5256 ($15.05 in chips)
Seat 5: Player#7485 ($22.16 in chips)
Player#5256: posts small blind $0.10
Player#7485: posts big blind $0.20
*** HOLE CARDS ***
Dealt to warioman [5s 7s]
warioman: folds
Player#9796: folds
Player#7188: raises $0.20 to $0.6
Player#5256: folds
Player#7485: raises $0.60 to $2.6
Player#7188: calls $2.00
*** FLOP *** [8c 6h 3h]
Player#7485: bets $3.60
Player#7188: folds
Player#7485: doesn't show hand
Uncalled bet ($3.60) returned to Player#7485
Player#7485 collected $5.04 from pot
*** SUMMARY ***
Total Pot $5.30 | Rake $0.27
Board [8c 6h 3h]
Seat 1: warioman folded before the flop
Seat 2: Player#9796 folded before the flop
Seat 3: Player#7188 (button) folded on the flop
Seat 4: Player#5256 (small blind) folded before the flop
Seat 5: Player#7485 shows [] and won ($5.04) with 

PokerStars Hand #dc9428d1-81c4-48f5-9d9f-0b412bf80ac4:  Hold'em No Limit ($0.1/$0.20 USD) - 2021/11/21 00:39:00 ET
Table 'Lacey' 6-max Seat #2 is the button
Seat 1: warioman ($48.20 in chips)
Seat 2: Player#9848 ($41.54 in chips)
Seat 3: Player#4083 ($31.37 in chips)
Seat 4: Player#8221 ($15.25 in chips)
Seat 5: Player#6027 ($22.16 in chips)
Player#4083: posts small blind $0.10
Player#8221: posts big blind $0.20
*** HOLE CARDS ***
Dealt to warioman [7d 6d]
Player#6027: folds
warioman: raises $0.20 to $0.5
Player#9848: folds
Player#4083: calls $0.40
Player#8221: folds
*** FLOP *** [3s 9s Kc]
Player#4083: checks
warioman: checks
*** TURN *** [3s 9s Kc] [5h]
Player#4083: checks
warioman: checks
*** RIVER *** [3s 9s Kc] [5h] [9h]
Player#4083: checks
warioman: checks
*** SHOW DOWN *** 
Player#4083 collected $1.14 from pot
*** SUMMARY ***
Total Pot $1.20 | Rake $0.06
Board [3s 9s Kc 5h 9h]
Seat 1: warioman
Seat 2: Player#9848 (button) folded before the flop
Seat 3: Player#4083 shows [5s 6h] and won ($1.14) with 
Seat 4: Player#8221 (big blind) folded before the flop
Seat 5: Player#6027 folded before the flop

PokerStars Hand #7e169f14-efd8-4a80-8bea-deba89d8ed0d:  Hold'em No Limit ($0.1/$0.20 USD) - 2021/11/21 00:38:00 ET
Table 'Denver' 6-max Seat #3 is the button
Seat 1: Player#6165 ($25.55 in chips)
Seat 2: Player#9448 ($24.32 in chips)
Seat 3: Player#9256 ($38.76 in chips)
Seat 4: warioman ($41.73 in chips)
Seat 5: Player#6179 ($16.19 in chips)
Seat 6: Player#5318 ($17.81 in chips)
warioman: posts small blind $0.10
Player#6179: posts big blind $0.20
*** HOLE CARDS ***
Dealt to warioman [7d Th]
Player#5318: folds
Player#6165: raises $0.20 to $0.6
Player#9448: folds
Player#9256: calls $0.60
warioman: folds
Player#6179: folds
*** FLOP *** [Ks 2s 8s]
Player#6165: bets $0.75
Player#9256: raises $0.75 to $2.81
Player#6165: calls $2.06
*** TURN *** [Ks 2s 8s] [Tc]
Player#6165: checks
Player#9256: checks
*** RIVER *** [Ks 2s 8s] [Tc] [Kc]
Player#6165: checks
Player#9256: checks
*** SHOW DOWN *** 
Player#6165 collected $6.76 from pot
*** SUMMARY ***
Total Pot $7.12 | Rake $0.36
Board [Ks 2s 8s Tc Kc]
Seat 1: Player#6165 shows [Ts Js] and won ($6.76) with 
Seat 2: Player#9448 folded before the flop
Seat 3: Player#9256 (button) mucked
Seat 4: warioman (small blind) folded before the flop
Seat 5: Player#6179 (big blind) folded before the flop
Seat 6: Player#5318 folded before the flop

PokerStars Hand #8cb696e6-bcf3-45c5-9f27-19a9b049ef3e:  Hold'em No Limit ($0.1/$0.20 USD) - 2021/11/21 00:38:00 ET
Table 'Lacey' 6-max Seat #1 is the button
Seat 1: warioman ($48.20 in chips)
Seat 2: Player#3596 ($41.64 in chips)
Seat 3: Player#8758 ($31.77 in chips)
Seat 4: Player#3316 ($15.25 in chips)
Seat 5: Player#3151 ($21.70 in chips)
Player#3596: posts small blind $0.10
Player#8758: posts big blind $0.20
*** HOLE CARDS ***
Dealt to warioman [9d 7c]
Player#3316: folds
Player#3151: raises $0.20 to $0.4
warioman: folds
Player#3596: folds
Player#8758: calls $0.20
*** FLOP *** [Jd Kc Jc]
Player#8758: checks
Player#3151: checks
*** TURN *** [Jd Kc Jc] [9h]
Player#8758: checks
Player#3151: checks
*** RIVER *** [Jd Kc Jc] [9h] [Th]
Player#8758: checks
Player#3151: checks
*** SHOW DOWN *** 
Player#3151 collected $0.85 from pot
*** SUMMARY ***
Total Pot $0.90 | Rake $0.05
Board [Jd Kc Jc 9h Th]
Seat 1: warioman (button) folded before the flop
Seat 2: Player#3596 (small blind) folded before the flop
Seat 3: Player#8758 (big blind) mucked
Seat 4: Player#3316 folded before the flop
Seat 5: Player#3151 shows [4c Ad] and won ($0.85) with 

PokerStars Hand #759aaa18-c62f-473c-9c51-b540e212479c:  Hold'em No Limit ($0.1/$0.20 USD) - 2021/11/21 00:37:00 ET
Table 'Denver' 6-max Seat #2 is the button
Seat 1: Player#8140 ($25.55 in chips)
Seat 2: Player#0363 ($24.32 in chips)
Seat 3: Player#5246 ($36.50 in chips)
Seat 4: warioman ($41.93 in chips)
Seat 5: Player#3733 ($16.19 in chips)
Seat 6: Player#9253 ($20.11 in chips)
Player#5246: posts small blind $0.10
warioman: posts big blind $0.20
*** HOLE CARDS ***
Dealt to warioman [3d Ts]
Player#3733: folds
Player#9253: raises $0.20 to $0.8
Player#8140: folds
Player#0363: folds
Player#5246: calls $0.70
warioman: folds
*** FLOP *** [9c 9h 7d]
Player#5246: checks
Player#9253: bets $0.50
Player#5246: calls $0.50
*** TURN *** [9c 9h 7d] [Td]
Player#5246: checks
Player#9253: bets $1.00
Player#5246: raises $1.00 to $4.35
Player#9253: folds
Player#5246: doesn't show hand
Uncalled bet ($4.35) returned to Player#5246
Player#5246 collected $3.61 from pot
*** SUMMARY ***
Total Pot $3.80 | Rake $0.19
Board [9c 9h 7d Td]
Seat 1: Player#8140 folded before the flop
Seat 2: Player#0363 (button) folded before the flop
Seat 3: Player#5246 shows [] and won ($3.61) with 
Seat 4: warioman (big blind) folded before the flop
Seat 5: Player#3733 folded before the flop
Seat 6: Player#9253 folded on the turn

PokerStars Hand #bf65472c-8a04-4d62-8260-e629c0e7740e:  Hold'em No Limit ($0.1/$0.20 USD) - 2021/11/21 00:37:00 ET
Table 'Denver' 6-max Seat #1 is the button
Seat 1: Player#5854 ($25.55 in chips)
Seat 2: Player#7313 ($24.42 in chips)
Seat 3: Player#0871 ($36.40 in chips)
Seat 4: warioman ($41.93 in chips)
Seat 5: Player#4687 ($16.19 in chips)
Seat 6: Player#8418 ($20.11 in chips)
Player#7313: posts small blind $0.10
Player#0871: posts big blind $0.20
*** HOLE CARDS ***
Dealt to warioman [3s 8h]
warioman: folds
Player#4687: folds
Player#8418: folds
Player#5854: folds
Player#7313: folds
Player#0871 collected $0.20 from pot
*** SUMMARY ***
Total Pot $0.20 | Rake $0.00
Seat 1: Player#5854 (button) folded before the flop
Seat 2: Player#7313 (small blind) folded before the flop
Seat 3: Player#0871 shows [] and won ($0.20) with 
Seat 4: warioman folded before the flop
Seat 5: Player#4687 folded before the flop
Seat 6: Player#8418 folded before the flop

PokerStars Hand #ddc0452a-0fd9-4ea3-823d-99386370131f:  Hold'em No Limit ($0.1/$0.20 USD) - 2021/11/21 00:37:00 ET
Table 'Lacey' 6-max Seat #6 is the button
Seat 1: warioman ($48.40 in chips)
Seat 2: Player#9936 ($41.46 in chips)
Seat 3: Player#1192 ($31.77 in chips)
Seat 4: Player#9894 ($15.25 in chips)
Seat 5: Player#7485 ($21.70 in chips)
warioman: posts small blind $0.10
Player#9936: posts big blind $0.20
*** HOLE CARDS ***
Dealt to warioman [8d Js]
Player#1192: folds
Player#9894: folds
Player#7485: folds
warioman: calls $0.10
Player#9936: checks
*** FLOP *** [4d 9c 3d]
warioman: checks
Player#9936: bets $0.23
warioman: folds
Player#9936: doesn't show hand
Uncalled bet ($0.23) returned to Player#9936
Player#9936 collected $0.38 from pot
*** SUMMARY ***
Total Pot $0.40 | Rake $0.02
Board [4d 9c 3d]
Seat 1: warioman (small blind) folded on the flop
Seat 2: Player#9936 shows [] and won ($0.38) with 
Seat 3: Player#1192 folded before the flop
Seat 4: Player#9894 folded before the flop
Seat 5: Player#7485 folded before the flop

PokerStars Hand #f84a44c2-7f09-4b99-9dad-add1e0480850:  Hold'em No Limit ($0.1/$0.20 USD) - 2021/11/21 00:37:00 ET
Table 'Denver' 6-max Seat #6 is the button
Seat 1: Player#4469 ($25.65 in chips)
Seat 2: Player#1882 ($24.62 in chips)
Seat 3: Player#6707 ($35.57 in chips)
Seat 4: warioman ($41.93 in chips)
Seat 5: Player#8406 ($16.19 in chips)
Seat 6: Player#2014 ($20.71 in chips)
Player#4469: posts small blind $0.10
Player#1882: posts big blind $0.20
*** HOLE CARDS ***
Dealt to warioman [Ks Qh]
Player#6707: raises $0.20 to $0.6
warioman: folds
Player#8406: folds
Player#2014: calls $0.60
Player#4469: folds
Player#1882: folds
*** FLOP *** [7d 4d Qd]
Player#6707: bets $0.80
Player#2014: folds
Player#6707: doesn't show hand
Uncalled bet ($0.80) returned to Player#6707
Player#6707 collected $1.42 from pot
*** SUMMARY ***
Total Pot $1.50 | Rake $0.07
Board [7d 4d Qd]
Seat 1: Player#4469 (small blind) folded before the flop
Seat 2: Player#1882 (big blind) folded before the flop
Seat 3: Player#6707 shows [] and won ($1.42) with 
Seat 4: warioman folded before the flop
Seat 5: Player#8406 folded before the flop
Seat 6: Player#2014 (button) folded on the flop

PokerStars Hand #317f44ec-71b9-4058-bc7b-0e496022b739:  Hold'em No Limit ($0.1/$0.20 USD) - 2021/11/21 00:36:00 ET
Table 'Lacey' 6-max Seat #4 is the button
Seat 1: warioman ($48.60 in chips)
Seat 2: Player#3705 ($43.40 in chips)
Seat 3: Player#0986 ($31.77 in chips)
Seat 4: Player#2816 ($13.21 in chips)
Seat 5: Player#5413 ($21.80 in chips)
Player#5413: posts small blind $0.10
warioman: posts big blind $0.20
*** HOLE CARDS ***
Dealt to warioman [3c Kd]
Player#3705: raises $0.20 to $0.75
Player#0986: folds
Player#2816: calls $0.75
Player#5413: folds
warioman: folds
*** FLOP *** [Jd Qd Ts]
Player#3705: bets $1.19
Player#2816: calls $1.19
*** TURN *** [Jd Qd Ts] [7s]
Player#3705: checks
Player#2816: bets $3.33
Player#3705: folds
Player#2816: doesn't show hand
Uncalled bet ($3.33) returned to Player#2816
Player#2816 collected $3.97 from pot
*** SUMMARY ***
Total Pot $4.18 | Rake $0.21
Board [Jd Qd Ts 7s]
Seat 1: warioman (big blind) folded before the flop
Seat 2: Player#3705 folded on the turn
Seat 3: Player#0986 folded before the flop
Seat 4: Player#2816 shows [] and won ($3.97) with 
Seat 5: Player#5413 (small blind) folded before the flop

PokerStars Hand #76ccd43e-2136-4acc-a0e6-7ad95d0bbfb7:  Hold'em No Limit ($0.1/$0.20 USD) - 2021/11/21 00:36:00 ET
Table 'Lacey' 6-max Seat #3 is the button
Seat 1: warioman ($48.60 in chips)
Seat 2: Player#3364 ($43.40 in chips)
Seat 3: Player#0823 ($31.77 in chips)
Seat 4: Player#8758 ($13.31 in chips)
Seat 5: Player#4651 ($21.70 in chips)
Player#8758: posts small blind $0.10
Player#4651: posts big blind $0.20
*** HOLE CARDS ***
Dealt to warioman [Th 5c]
warioman: folds
Player#3364: folds
Player#0823: folds
Player#8758: folds
Player#4651 collected $0.20 from pot
*** SUMMARY ***
Total Pot $0.20 | Rake $0.00
Seat 1: warioman folded before the flop
Seat 2: Player#3364 folded before the flop
Seat 3: Player#0823 (button) folded before the flop
Seat 4: Player#8758 (small blind) folded before the flop
Seat 5: Player#4651 shows [] and won ($0.20) with 

PokerStars Hand #5a388a0b-503c-431a-9b23-154dd2dc0e38:  Hold'em No Limit ($0.1/$0.20 USD) - 2021/11/21 00:36:00 ET
Table 'Denver' 6-max Seat #5 is the button
Seat 1: Player#0971 ($25.85 in chips)
Seat 2: Player#0284 ($24.62 in chips)
Seat 3: Player#9075 ($37.37 in chips)
Seat 4: warioman ($41.93 in chips)
Seat 5: Player#2839 ($16.19 in chips)
Seat 6: Player#2671 ($18.90 in chips)
Player#2671: posts small blind $0.10
Player#0971: posts big blind $0.20
*** HOLE CARDS ***
Dealt to warioman [Qd 3c]
Player#0284: folds
Player#9075: raises $0.20 to $0.8
warioman: folds
Player#2839: folds
Player#2671: calls $0.70
Player#0971: folds
*** FLOP *** [5c 8d Ts]
Player#2671: bets $1.00
Player#9075: calls $1.00
*** TURN *** [5c 8d Ts] [Qs]
Player#2671: checks
Player#9075: checks
*** RIVER *** [5c 8d Ts] [Qs] [3s]
Player#2671: bets $3.00
Player#9075: folds
Player#2671: doesn't show hand
Uncalled bet ($3.00) returned to Player#2671
Player#2671 collected $3.61 from pot
*** SUMMARY ***
Total Pot $3.80 | Rake $0.19
Board [5c 8d Ts Qs 3s]
Seat 1: Player#0971 (big blind) folded before the flop
Seat 2: Player#0284 folded before the flop
Seat 3: Player#9075 folded on the river
Seat 4: warioman folded before the flop
Seat 5: Player#2839 (button) folded before the flop
Seat 6: Player#2671 shows [] and won ($3.61) with 

PokerStars Hand #81ed91fd-1721-4aff-b5e6-b326288821c2:  Hold'em No Limit ($0.1/$0.20 USD) - 2021/11/21 00:35:00 ET
Table 'Denver' 6-max Seat #4 is the button
Seat 1: Player#7883 ($25.85 in chips)
Seat 2: Player#5861 ($26.02 in chips)
Seat 3: Player#9224 ($37.37 in chips)
Seat 4: warioman ($41.93 in chips)
Seat 5: Player#8422 ($13.60 in chips)
Seat 6: Player#2608 ($20.30 in chips)
Player#8422: posts small blind $0.10
Player#2608: posts big blind $0.20
*** HOLE CARDS ***
Dealt to warioman [Qd 2c]
Player#7883: folds
Player#5861: raises $0.20 to $0.6
Player#9224: folds
warioman: folds
Player#8422: calls $0.50
Player#2608: calls $0.40
*** FLOP *** [Qh 4d 7c]
Player#8422: checks
Player#2608: bets $0.80
Player#5861: calls $0.80
Player#8422: raises0.80 to $4
Player#2608: folds
Player#5861: folds
Player#8422: doesn't show hand
Uncalled bet ($4.00) returned to Player#8422
Player#8422 collected $3.23 from pot
*** SUMMARY ***
Total Pot $3.40 | Rake $0.17
Board [Qh 4d 7c]
Seat 1: Player#7883 folded before the flop
Seat 2: Player#5861 folded on the flop
Seat 3: Player#9224 folded before the flop
Seat 4: warioman (button) folded before the flop
Seat 5: Player#8422 shows [] and won ($3.23) with 
Seat 6: Player#2608 (big blind) folded on the flop

PokerStars Hand #c3d86e7d-1633-47e8-82d3-cba650367742:  Hold'em No Limit ($0.1/$0.20 USD) - 2021/11/21 00:35:00 ET
Table 'Lacey' 6-max Seat #2 is the button
Seat 1: warioman ($48.60 in chips)
Seat 2: Player#0440 ($43.40 in chips)
Seat 3: Player#3120 ($25.00 in chips)
Seat 4: Player#0458 ($20.41 in chips)
Seat 5: Player#3469 ($22.10 in chips)
Player#3120: posts small blind $0.10
Player#0458: posts big blind $0.20
*** HOLE CARDS ***
Dealt to warioman [5c Qh]
Player#3469: raises $0.20 to $0.4
warioman: folds
Player#0440: folds
Player#3120: raises $0.40 to $1.4
Player#0458: raises $1.40 to $3.45
Player#3469: folds
Player#3120: calls $2.05
*** FLOP *** [Td 6d 2d]
Player#3120: checks
Player#0458: checks
*** TURN *** [Td 6d 2d] [8c]
Player#3120: bets $3.65
Player#0458: calls $3.65
*** RIVER *** [Td 6d 2d] [8c] [4c]
Player#3120: bets $7.30
Player#0458: folds
Player#3120: doesn't show hand
Uncalled bet ($7.30) returned to Player#3120
Player#3120 collected $13.87 from pot
*** SUMMARY ***
Total Pot $14.60 | Rake $0.73
Board [Td 6d 2d 8c 4c]
Seat 1: warioman folded before the flop
Seat 2: Player#0440 (button) folded before the flop
Seat 3: Player#3120 shows [] and won ($13.87) with 
Seat 4: Player#0458 (big blind) folded on the river
Seat 5: Player#3469 folded before the flop

PokerStars Hand #a0f4da6e-dba5-465f-96a8-bed1aba7558e:  Hold'em No Limit ($0.1/$0.20 USD) - 2021/11/21 00:35:00 ET
Table 'Denver' 6-max Seat #3 is the button
Seat 1: Player#8609 ($25.85 in chips)
Seat 2: Player#5075 ($26.02 in chips)
Seat 3: Player#2106 ($37.37 in chips)
Seat 4: warioman ($42.03 in chips)
Seat 5: Player#1491 ($13.80 in chips)
Seat 6: Player#2845 ($20.00 in chips)
warioman: posts small blind $0.10
Player#1491: posts big blind $0.20
*** HOLE CARDS ***
Dealt to warioman [5s 8s]
Player#2845 Entry Bet 0.2
Player#2845: raises $0.20 to $0.4
Player#8609: folds
Player#5075: folds
Player#2106: folds
warioman: folds
Player#1491: folds
Player#2845: doesn't show hand
Uncalled bet ($0.40) returned to Player#2845
Player#2845 collected $0.30 from pot
*** SUMMARY ***
Total Pot $0.30 | Rake $0.00
Seat 1: Player#8609 folded before the flop
Seat 2: Player#5075 folded before the flop
Seat 3: Player#2106 (button) folded before the flop
Seat 4: warioman (small blind) folded before the flop
Seat 5: Player#1491 (big blind) folded before the flop
Seat 6: Player#2845 shows [] and won ($0.30) with 

PokerStars Hand #4b1beab8-9712-4c1d-852d-09a4652ae034:  Hold'em No Limit ($0.1/$0.20 USD) - 2021/11/21 00:34:00 ET
Table 'Denver' 6-max Seat #5 is the button
Seat 1: Player#0982 ($25.85 in chips)
Seat 2: Player#5995 ($25.72 in chips)
Seat 3: Player#9769 ($37.47 in chips)
Seat 4: warioman ($42.23 in chips)
Seat 5: Player#5157 ($13.80 in chips)
Seat 6: Player#6490 ($20.00 in chips)
Player#6490: posts small blind $0.10
Player#9769: posts big blind $0.20
*** HOLE CARDS ***
Dealt to warioman [Td 2c]
Player#6490 Waiting
Player#5157: folds
Player#0982: folds
Player#5995: raises $0.20 to $1.2
Player#9769: folds
warioman: folds
Player#5995: doesn't show hand
Uncalled bet ($1.20) returned to Player#5995
Player#5995 collected $0.30 from pot
*** SUMMARY ***
Total Pot $0.30 | Rake $0.00
Seat 1: Player#0982 folded before the flop
Seat 2: Player#5995 shows [] and won ($0.30) with 
Seat 3: Player#9769 (big blind) folded before the flop
Seat 4: warioman folded before the flop
Seat 5: Player#5157 (button) folded before the flop
Seat 6: Player#6490 (small blind) mucked

PokerStars Hand #603c330e-c376-474b-af8f-ed5aeaf66b6f:  Hold'em No Limit ($0.1/$0.20 USD) - 2021/11/21 00:34:00 ET
Table 'Lacey' 6-max Seat #1 is the button
Seat 1: warioman ($24.95 in chips)
Seat 2: Player#5947 ($43.50 in chips)
Seat 3: Player#9484 ($49.95 in chips)
Seat 4: Player#5267 ($21.01 in chips)
Seat 5: Player#2015 ($22.10 in chips)
Player#5947: posts small blind $0.10
Player#9484: posts big blind $0.20
*** HOLE CARDS ***
Dealt to warioman [Qs Qd]
Player#5267: raises $0.20 to $0.6
Player#2015: folds
warioman: raises $0.60 to $2.1
Player#5947: folds
Player#9484: calls $1.90
Player#5267: folds
*** FLOP *** [As Qh Th]
Player#9484: checks
warioman: bets $2.07
Player#9484: calls $2.07
*** TURN *** [As Qh Th] [Td]
Player#9484: checks
warioman: checks
*** RIVER *** [As Qh Th] [Td] [Jd]
Player#9484: bets $9.04
warioman: raises $ 29.04 to $20.78
Player#9484: calls $11.74
*** SHOW DOWN *** 
Player#9484: doesn't show hand
warioman collected $49.10 from pot
*** SUMMARY ***
Total Pot $50.60 | Rake $1.50
Board [As Qh Th Td Jd]
Seat 1: warioman (button)
Seat 2: Player#5947 (small blind) folded before the flop
Seat 3: Player#9484 (big blind) mucked
Seat 4: Player#5267 folded before the flop
Seat 5: Player#2015 folded before the flop

PokerStars Hand #029506b1-49ce-4e6c-a797-c43284fee82a:  Hold'em No Limit ($0.1/$0.20 USD) - 2021/11/21 00:34:00 ET
Table 'Lacey' 6-max Seat #6 is the button
Seat 1: warioman ($25.05 in chips)
Seat 2: Player#2198 ($43.40 in chips)
Seat 3: Player#4515 ($49.95 in chips)
Seat 4: Player#6766 ($21.01 in chips)
Seat 5: Player#3126 ($22.10 in chips)
warioman: posts small blind $0.10
Player#2198: posts big blind $0.20
*** HOLE CARDS ***
Dealt to warioman [3h 2s]
Player#4515: folds
Player#6766: folds
Player#3126: folds
warioman: folds
Player#2198 collected $0.20 from pot
*** SUMMARY ***
Total Pot $0.20 | Rake $0.00
Seat 1: warioman (small blind) folded before the flop
Seat 2: Player#2198 shows [] and won ($0.20) with 
Seat 3: Player#4515 folded before the flop
Seat 4: Player#6766 folded before the flop
Seat 5: Player#3126 folded before the flop

PokerStars Hand #73a2dcea-505e-4a62-8d0c-67db7d5dc068:  Hold'em No Limit ($0.1/$0.20 USD) - 2021/11/21 00:34:00 ET
Table 'Lacey' 6-max Seat #4 is the button
Seat 1: warioman ($25.25 in chips)
Seat 2: Player#4081 ($43.40 in chips)
Seat 3: Player#4574 ($49.65 in chips)
Seat 4: Player#0257 ($21.01 in chips)
Seat 5: Player#1543 ($22.20 in chips)
Player#1543: posts small blind $0.10
warioman: posts big blind $0.20
*** HOLE CARDS ***
Dealt to warioman [6s Td]
Player#4574 BB + Dead Small 0.3
Player#4081: folds
Player#4574: raises $0.20 to $0.6
Player#0257: folds
Player#1543: folds
warioman: folds
Player#4574: doesn't show hand
Uncalled bet ($0.60) returned to Player#4574
Player#4574 collected $0.30 from pot
*** SUMMARY ***
Total Pot $0.30 | Rake $0.00
Seat 1: warioman (big blind) folded before the flop
Seat 2: Player#4081 folded before the flop
Seat 3: Player#4574 shows [] and won ($0.30) with 
Seat 4: Player#0257 (button) folded before the flop
Seat 5: Player#1543 (small blind) folded before the flop

PokerStars Hand #419d446a-6357-4fd2-b643-3b251602d0de:  Hold'em No Limit ($0.1/$0.20 USD) - 2021/11/21 00:34:00 ET
Table 'Denver' 6-max Seat #1 is the button
Seat 1: Player#7684 ($25.85 in chips)
Seat 2: Player#3643 ($28.52 in chips)
Seat 3: Player#9771 ($34.95 in chips)
Seat 4: warioman ($42.23 in chips)
Seat 5: Player#7755 ($13.80 in chips)
Player#3643: posts small blind $0.10
Player#9771: posts big blind $0.20
*** HOLE CARDS ***
Dealt to warioman [9h 5c]
warioman: folds
Player#7755: folds
Player#7684: folds
Player#3643: raises $0.20 to $1.2
Player#9771: calls $1.00
*** FLOP *** [3h Qs 2d]
Player#3643: checks
Player#9771: checks
*** TURN *** [3h Qs 2d] [4h]
Player#3643: checks
Player#9771: bets $1.60
Player#3643: calls $1.60
*** RIVER *** [3h Qs 2d] [4h] [6h]
Player#3643: checks
Player#9771: checks
*** SHOW DOWN *** 
Player#9771 collected $5.32 from pot
*** SUMMARY ***
Total Pot $5.60 | Rake $0.28
Board [3h Qs 2d 4h 6h]
Seat 1: Player#7684 (button) folded before the flop
Seat 2: Player#3643 (small blind) mucked
Seat 3: Player#9771 shows [Qd 8c] and won ($5.32) with 
Seat 4: warioman folded before the flop
Seat 5: Player#7755 folded before the flop

PokerStars Hand #9fb9d607-82fe-4c9f-83cb-59a75e5fc93e:  Hold'em No Limit ($0.1/$0.20 USD) - 2021/11/21 00:33:00 ET
Table 'Denver' 6-max Seat #6 is the button
Seat 1: Player#0437 ($25.95 in chips)
Seat 2: Player#7620 ($28.72 in chips)
Seat 3: Player#3999 ($34.65 in chips)
Seat 4: warioman ($42.23 in chips)
Seat 5: Player#7783 ($13.80 in chips)
Player#0437: posts small blind $0.10
Player#7620: posts big blind $0.20
*** HOLE CARDS ***
Dealt to warioman [8s Kh]
Player#3999: raises $0.20 to $0.8
warioman: folds
Player#7783: folds
Player#0437: folds
Player#7620: folds
Player#3999: doesn't show hand
Uncalled bet ($0.80) returned to Player#3999
Player#3999 collected $0.30 from pot
*** SUMMARY ***
Total Pot $0.30 | Rake $0.00
Seat 1: Player#0437 (small blind) folded before the flop
Seat 2: Player#7620 (big blind) folded before the flop
Seat 3: Player#3999 shows [] and won ($0.30) with 
Seat 4: warioman folded before the flop
Seat 5: Player#7783 folded before the flop

PokerStars Hand #7116f311-7af5-47d3-a1d4-a71edf3f6bdd:  Hold'em No Limit ($0.1/$0.20 USD) - 2021/11/21 00:33:00 ET
Table 'Lacey' 6-max Seat #3 is the button
Seat 1: warioman ($25.25 in chips)
Seat 2: Player#9663 ($42.90 in chips)
Seat 3: Player#9208 ($49.65 in chips)
Seat 4: Player#5227 ($21.11 in chips)
Seat 5: Player#6358 ($22.65 in chips)
Player#5227: posts small blind $0.10
Player#6358: posts big blind $0.20
*** HOLE CARDS ***
Dealt to warioman [5h 8h]
warioman: folds
Player#9663: raises $0.20 to $0.45
Player#5227: folds
Player#6358: calls $0.25
*** FLOP *** [Ah Kh 9h]
Player#6358: checks
Player#9663: bets $0.65
Player#6358: folds
Player#9663: doesn't show hand
Uncalled bet ($0.65) returned to Player#9663
Player#9663 collected $0.95 from pot
*** SUMMARY ***
Total Pot $1.00 | Rake $0.05
Board [Ah Kh 9h]
Seat 1: warioman folded before the flop
Seat 2: Player#9663 shows [] and won ($0.95) with 
Seat 3: Player#9208 (button) mucked
Seat 4: Player#5227 (small blind) folded before the flop
Seat 5: Player#6358 (big blind) folded on the flop

PokerStars Hand #2db69717-9e85-41a2-a01c-530d298b939d:  Hold'em No Limit ($0.1/$0.20 USD) - 2021/11/21 00:33:00 ET
Table 'Denver' 6-max Seat #3 is the button
Seat 1: Player#9954 ($26.15 in chips)
Seat 2: Player#2708 ($34.35 in chips)
Seat 3: warioman ($42.23 in chips)
Seat 4: Player#7397 ($13.90 in chips)
Player#7397: posts small blind $0.10
Player#9954: posts big blind $0.20
*** HOLE CARDS ***
Dealt to warioman [3d Td]
Player#2708: raises $0.20 to $0.6
warioman: folds
Player#7397: folds
Player#9954: folds
Player#2708: doesn't show hand
Uncalled bet ($0.60) returned to Player#2708
Player#2708 collected $0.30 from pot
*** SUMMARY ***
Total Pot $0.30 | Rake $0.00
Seat 1: Player#9954 (big blind) folded before the flop
Seat 2: Player#2708 shows [] and won ($0.30) with 
Seat 3: warioman (button) folded before the flop
Seat 4: Player#7397 (small blind) folded before the flop

PokerStars Hand #287fa7e2-06fa-4531-827a-bc3816dd801e:  Hold'em No Limit ($0.1/$0.20 USD) - 2021/11/21 00:33:00 ET
Table 'Lacey' 6-max Seat #1 is the button
Seat 1: warioman ($25.25 in chips)
Seat 2: Player#1794 ($43.00 in chips)
Seat 3: Player#2387 ($49.65 in chips)
Seat 4: Player#0622 ($21.31 in chips)
Seat 5: Player#5042 ($22.35 in chips)
Player#1794: posts small blind $0.10
Player#0622: posts big blind $0.20
*** HOLE CARDS ***
Dealt to warioman [2s Qc]
Player#2387 Decline Entry Bet
Player#5042: raises $0.20 to $0.4
warioman: folds
Player#1794: folds
Player#0622: folds
Player#5042: doesn't show hand
Uncalled bet ($0.40) returned to Player#5042
Player#5042 collected $0.30 from pot
*** SUMMARY ***
Total Pot $0.30 | Rake $0.00
Seat 1: warioman (button) folded before the flop
Seat 2: Player#1794 (small blind) folded before the flop
Seat 3: Player#2387 mucked
Seat 4: Player#0622 (big blind) folded before the flop
Seat 5: Player#5042 shows [] and won ($0.30) with 

PokerStars Hand #497e78b0-209c-4c5f-8087-a579c7cfdefb:  Hold'em No Limit ($0.1/$0.20 USD) - 2021/11/21 00:33:00 ET
Table 'Lacey' 6-max Seat #6 is the button
Seat 1: warioman ($24.65 in chips)
Seat 2: Player#3199 ($43.20 in chips)
Seat 3: Player#7092 ($49.65 in chips)
Seat 4: Player#0366 ($21.31 in chips)
Seat 5: Player#1856 ($22.75 in chips)
warioman: posts small blind $0.10
Player#3199: posts big blind $0.20
*** HOLE CARDS ***
Dealt to warioman [Jc Jd]
Player#7092: folds
Player#0366: folds
Player#1856: raises $0.20 to $0.4
warioman: raises $0.40 to $1.6
Player#3199: folds
Player#1856: folds
warioman: doesn't show hand
Uncalled bet ($1.60) returned to warioman
warioman collected $0.60 from pot
*** SUMMARY ***
Total Pot $0.60 | Rake $0.00
Seat 1: warioman (small blind)
Seat 2: Player#3199 (big blind) folded before the flop
Seat 3: Player#7092 folded before the flop
Seat 4: Player#0366 folded before the flop
Seat 5: Player#1856 folded before the flop

PokerStars Hand #0b58a3c9-214d-416a-a728-2b145270bc37:  Hold'em No Limit ($0.1/$0.20 USD) - 2021/11/21 00:33:00 ET
Table 'Denver' 6-max Seat #3 is the button
Seat 1: Player#8324 ($26.15 in chips)
Seat 2: Player#0783 ($28.72 in chips)
Seat 3: Player#2618 ($34.05 in chips)
Seat 4: warioman ($42.33 in chips)
Seat 5: Player#6323 ($14.10 in chips)
warioman: posts small blind $0.10
Player#6323: posts big blind $0.20
*** HOLE CARDS ***
Dealt to warioman [5h Ks]
Player#8324: folds
Player#0783: folds
Player#2618: raises $0.20 to $0.6
warioman: folds
Player#6323: folds
Player#2618: doesn't show hand
Uncalled bet ($0.60) returned to Player#2618
Player#2618 collected $0.30 from pot
*** SUMMARY ***
Total Pot $0.30 | Rake $0.00
Seat 1: Player#8324 folded before the flop
Seat 2: Player#0783 folded before the flop
Seat 3: Player#2618 shows [] and won ($0.30) with 
Seat 4: warioman (small blind) folded before the flop
Seat 5: Player#6323 (big blind) folded before the flop

PokerStars Hand #d2cf6b16-da6b-4186-a5dd-d0bdf905b966:  Hold'em No Limit ($0.1/$0.20 USD) - 2021/11/21 00:32:00 ET
Table 'Lacey' 6-max Seat #4 is the button
Seat 1: warioman ($24.37 in chips)
Seat 2: Player#3047 ($43.20 in chips)
Seat 3: Player#6332 ($49.85 in chips)
Seat 4: Player#3676 ($21.31 in chips)
Seat 5: Player#4461 ($22.85 in chips)
Player#4461: posts small blind $0.10
warioman: posts big blind $0.20
*** HOLE CARDS ***
Dealt to warioman [8d 6c]
Player#3047: folds
Player#6332: calls $0.20
Player#3676: folds
Player#4461: folds
warioman: checks
*** FLOP *** [6d 9s Kc]
warioman: checks
Player#6332: checks
*** TURN *** [6d 9s Kc] [Ac]
warioman: checks
Player#6332: checks
*** RIVER *** [6d 9s Kc] [Ac] [Ac]
warioman: checks
Player#6332: checks
*** SHOW DOWN *** 
warioman collected $0.47 from pot
*** SUMMARY ***
Total Pot $0.50 | Rake $0.03
Board [6d 9s Kc Ac Ac]
Seat 1: warioman (big blind)
Seat 2: Player#3047 folded before the flop
Seat 3: Player#6332 mucked
Seat 4: Player#3676 (button) folded before the flop
Seat 5: Player#4461 (small blind) folded before the flop

PokerStars Hand #9160b1b1-32cf-4a99-925f-8924897d35e5:  Hold'em No Limit ($0.1/$0.20 USD) - 2021/11/21 00:32:00 ET
Table 'Denver' 6-max Seat #2 is the button
Seat 1: Player#9859 ($26.15 in chips)
Seat 2: Player#9457 ($28.72 in chips)
Seat 3: Player#1730 ($33.87 in chips)
Seat 4: warioman ($42.53 in chips)
Seat 5: Player#1446 ($14.10 in chips)
Player#1730: posts small blind $0.10
warioman: posts big blind $0.20
*** HOLE CARDS ***
Dealt to warioman [Tc 2d]
Player#1446: folds
Player#9859: folds
Player#9457: folds
Player#1730: calls $0.10
warioman: checks
*** FLOP *** [Kh Js 2c]
Player#1730: checks
warioman: checks
*** TURN *** [Kh Js 2c] [Kd]
Player#1730: checks
warioman: checks
*** RIVER *** [Kh Js 2c] [Kd] [Ad]
Player#1730: bets $0.40
warioman: folds
Player#1730: doesn't show hand
Uncalled bet ($0.40) returned to Player#1730
Player#1730 collected $0.38 from pot
*** SUMMARY ***
Total Pot $0.40 | Rake $0.02
Board [Kh Js 2c Kd Ad]
Seat 1: Player#9859 folded before the flop
Seat 2: Player#9457 (button) folded before the flop
Seat 3: Player#1730 shows [] and won ($0.38) with 
Seat 4: warioman (big blind) folded on the river
Seat 5: Player#1446 folded before the flop

PokerStars Hand #41f0730c-a613-40dd-ae53-e2735ade9508:  Hold'em No Limit ($0.1/$0.20 USD) - 2021/11/21 00:32:00 ET
Table 'Lacey' 6-max Seat #3 is the button
Seat 1: warioman ($24.37 in chips)
Seat 2: Player#3816 ($43.20 in chips)
Seat 3: Player#4697 ($49.85 in chips)
Seat 4: Player#1505 ($21.11 in chips)
Seat 5: Player#4860 ($23.05 in chips)
Player#1505: posts small blind $0.10
Player#4860: posts big blind $0.20
*** HOLE CARDS ***
Dealt to warioman [5d Jd]
warioman: folds
Player#3816: folds
Player#4697: folds
Player#1505: raises $0.20 to $0.6
Player#4860: folds
Player#1505: doesn't show hand
Uncalled bet ($0.60) returned to Player#1505
Player#1505 collected $0.20 from pot
*** SUMMARY ***
Total Pot $0.20 | Rake $0.00
Seat 1: warioman folded before the flop
Seat 2: Player#3816 folded before the flop
Seat 3: Player#4697 (button) folded before the flop
Seat 4: Player#1505 shows [] and won ($0.20) with 
Seat 5: Player#4860 (big blind) folded before the flop

PokerStars Hand #1cb7642f-f383-47f5-9eb4-8f3cac6de8a3:  Hold'em No Limit ($0.1/$0.20 USD) - 2021/11/21 00:32:00 ET
Table 'Denver' 6-max Seat #1 is the button
Seat 1: Player#4784 ($26.15 in chips)
Seat 2: Player#4397 ($28.82 in chips)
Seat 3: Player#3239 ($33.77 in chips)
Seat 4: warioman ($42.53 in chips)
Seat 5: Player#8147 ($14.10 in chips)
Player#4397: posts small blind $0.10
Player#3239: posts big blind $0.20
*** HOLE CARDS ***
Dealt to warioman [2c 2d]
warioman: folds
Player#8147: folds
Player#4784: folds
Player#4397: folds
Player#3239 collected $0.20 from pot
*** SUMMARY ***
Total Pot $0.20 | Rake $0.00
Seat 1: Player#4784 (button) folded before the flop
Seat 2: Player#4397 (small blind) folded before the flop
Seat 3: Player#3239 shows [] and won ($0.20) with 
Seat 4: warioman folded before the flop
Seat 5: Player#8147 folded before the flop

PokerStars Hand #66102046-e73e-4137-8343-47e3d0a0a080:  Hold'em No Limit ($0.1/$0.20 USD) - 2021/11/21 00:31:00 ET
Table 'Lacey' 6-max Seat #3 is the button
Seat 1: warioman ($24.37 in chips)
Seat 2: Player#0857 ($43.20 in chips)
Seat 3: Player#7928 ($50.55 in chips)
Seat 4: Player#8046 ($21.31 in chips)
Seat 5: Player#7130 ($22.23 in chips)
Player#8046: posts small blind $0.10
Player#0857: posts big blind $0.20
*** HOLE CARDS ***
Dealt to warioman [2h 4d]
Player#7130: raises $0.20 to $0.4
warioman: folds
Player#0857: folds
Player#7928: raises $0.40 to $0.7
Player#8046: folds
Player#7130: calls $0.30
*** FLOP *** [2d 5d 2c]
Player#7130: checks
Player#7928: checks
*** TURN *** [2d 5d 2c] [6c]
Player#7130: bets $0.48
Player#7928: folds
Player#7130: doesn't show hand
Uncalled bet ($0.48) returned to Player#7130
Player#7130 collected $1.52 from pot
*** SUMMARY ***
Total Pot $1.60 | Rake $0.08
Board [2d 5d 2c 6c]
Seat 1: warioman folded before the flop
Seat 2: Player#0857 (big blind) folded before the flop
Seat 3: Player#7928 (button) folded on the turn
Seat 4: Player#8046 (small blind) folded before the flop
Seat 5: Player#7130 shows [] and won ($1.52) with 

PokerStars Hand #153b724d-16cb-413e-8733-7ca98b6213f8:  Hold'em No Limit ($0.1/$0.20 USD) - 2021/11/21 00:31:00 ET
Table 'Denver' 6-max Seat #6 is the button
Seat 1: Player#8471 ($26.25 in chips)
Seat 2: Player#6193 ($27.46 in chips)
Seat 3: Player#0620 ($33.77 in chips)
Seat 4: warioman ($42.53 in chips)
Seat 5: Player#1419 ($15.50 in chips)
Player#8471: posts small blind $0.10
Player#6193: posts big blind $0.20
*** HOLE CARDS ***
Dealt to warioman [4d Qc]
Player#0620: folds
warioman: folds
Player#1419: raises $0.20 to $0.6
Player#8471: folds
Player#6193: calls $0.40
*** FLOP *** [Qs 8s 6s]
Player#6193: checks
Player#1419: bets $0.80
Player#6193: calls $0.80
*** TURN *** [Qs 8s 6s] [3c]
Player#6193: checks
Player#1419: checks
*** RIVER *** [Qs 8s 6s] [3c] [Jc]
Player#6193: bets $2.17
Player#1419: folds
Player#6193: doesn't show hand
Uncalled bet ($2.17) returned to Player#6193
Player#6193 collected $2.76 from pot
*** SUMMARY ***
Total Pot $2.90 | Rake $0.15
Board [Qs 8s 6s 3c Jc]
Seat 1: Player#8471 (small blind) folded before the flop
Seat 2: Player#6193 shows [] and won ($2.76) with 
Seat 3: Player#0620 folded before the flop
Seat 4: warioman folded before the flop
Seat 5: Player#1419 folded on the river

PokerStars Hand #895422d7-e8bd-4533-acfd-9b81269d3cb5:  Hold'em No Limit ($0.1/$0.20 USD) - 2021/11/21 00:31:00 ET
Table 'Denver' 6-max Seat #4 is the button
Seat 1: Player#0371 ($26.15 in chips)
Seat 2: Player#8272 ($27.46 in chips)
Seat 3: Player#7767 ($33.77 in chips)
Seat 4: warioman ($42.53 in chips)
Seat 5: Player#6825 ($15.60 in chips)
Player#6825: posts small blind $0.10
Player#0371: posts big blind $0.20
*** HOLE CARDS ***
Dealt to warioman [8s 7d]
Player#8272: folds
Player#7767: folds
warioman: folds
Player#6825: folds
Player#0371 collected $0.20 from pot
*** SUMMARY ***
Total Pot $0.20 | Rake $0.00
Seat 1: Player#0371 shows [] and won ($0.20) with 
Seat 2: Player#8272 folded before the flop
Seat 3: Player#7767 folded before the flop
Seat 4: warioman (button) folded before the flop
Seat 5: Player#6825 (small blind) folded before the flop

PokerStars Hand #0c04d3cd-44bc-4e4b-9fce-7e68ef0ae31c:  Hold'em No Limit ($0.1/$0.20 USD) - 2021/11/21 00:30:00 ET
Table 'Denver' 6-max Seat #3 is the button
Seat 1: Player#9477 ($26.15 in chips)
Seat 2: Player#4689 ($27.46 in chips)
Seat 3: Player#0518 ($34.37 in chips)
Seat 4: warioman ($42.63 in chips)
Seat 5: Player#5102 ($14.90 in chips)
warioman: posts small blind $0.10
Player#5102: posts big blind $0.20
*** HOLE CARDS ***
Dealt to warioman [3d 9h]
Player#9477: folds
Player#4689: folds
Player#0518: raises $0.20 to $0.6
warioman: folds
Player#5102: raises0.60 to $2
Player#0518: folds
Player#5102: doesn't show hand
Uncalled bet ($2.00) returned to Player#5102
Player#5102 collected $0.70 from pot
*** SUMMARY ***
Total Pot $0.70 | Rake $0.00
Seat 1: Player#9477 folded before the flop
Seat 2: Player#4689 folded before the flop
Seat 3: Player#0518 (button) folded before the flop
Seat 4: warioman (small blind) folded before the flop
Seat 5: Player#5102 shows [] and won ($0.70) with 

PokerStars Hand #7529f05b-6e29-4287-87ec-64c277071c27:  Hold'em No Limit ($0.1/$0.20 USD) - 2021/11/21 00:30:00 ET
Table 'Lacey' 6-max Seat #2 is the button
Seat 1: warioman ($24.37 in chips)
Seat 2: Player#5891 ($43.26 in chips)
Seat 3: Player#3423 ($50.61 in chips)
Seat 4: Player#2877 ($19.56 in chips)
Seat 5: Player#9620 ($21.31 in chips)
Seat 6: Player#0923 ($22.23 in chips)
Player#3423: posts small blind $0.10
Player#2877: posts big blind $0.20
*** HOLE CARDS ***
Dealt to warioman [Js 3h]
Player#9620: folds
Player#0923: folds
warioman: folds
Player#5891: raises $0.20 to $0.5
Player#3423: calls $0.40
Player#2877: folds
*** FLOP *** [3s 6c 5h]
Player#3423: checks
Player#5891: bets $0.89
Player#3423: calls $0.89
*** TURN *** [3s 6c 5h] [9d]
Player#3423: checks
Player#5891: checks
*** RIVER *** [3s 6c 5h] [9d] [Ad]
Player#3423: checks
Player#5891: bets $1.75
Player#3423: calls $1.75
*** SHOW DOWN *** 
warioman: doesn't show hand
Player#5891: doesn't show hand
Player#3423: doesn't show hand
Player#2877: doesn't show hand
Player#9620: doesn't show hand
Player#0923: doesn't show hand
 *** SUMMARY ***
Total Pot $6.48 | Rake $0.32
Board [3s 6c 5h 9d Ad]
Seat 1: warioman folded before the flop
Seat 2: Player#5891 (button) mucked
Seat 3: Player#3423 (small blind) mucked
Seat 4: Player#2877 (big blind) folded before the flop
Seat 5: Player#9620 folded before the flop
Seat 6: Player#0923 folded before the flop

PokerStars Hand #4ebcbc23-7d12-4549-b641-2ac854aef702:  Hold'em No Limit ($0.1/$0.20 USD) - 2021/11/21 00:30:00 ET
Table 'Denver' 6-max Seat #2 is the button
Seat 1: Player#8451 ($26.15 in chips)
Seat 2: Player#1779 ($27.46 in chips)
Seat 3: Player#4213 ($34.19 in chips)
Seat 4: warioman ($42.83 in chips)
Seat 5: Player#1626 ($14.90 in chips)
Player#4213: posts small blind $0.10
warioman: posts big blind $0.20
*** HOLE CARDS ***
Dealt to warioman [2c 6h]
Player#1626: folds
Player#8451: folds
Player#1779: folds
Player#4213: calls $0.10
warioman: checks
*** FLOP *** [7c Td 6c]
Player#4213: bets $0.40
warioman: folds
Player#4213: doesn't show hand
Uncalled bet ($0.40) returned to Player#4213
Player#4213 collected $0.38 from pot
*** SUMMARY ***
Total Pot $0.40 | Rake $0.02
Board [7c Td 6c]
Seat 1: Player#8451 folded before the flop
Seat 2: Player#1779 (button) folded before the flop
Seat 3: Player#4213 shows [] and won ($0.38) with 
Seat 4: warioman (big blind) folded on the flop
Seat 5: Player#1626 folded before the flop

PokerStars Hand #87cb7c4a-51d5-4c81-9349-293349173995:  Hold'em No Limit ($0.1/$0.20 USD) - 2021/11/21 00:30:00 ET
Table 'Lacey' 6-max Seat #1 is the button
Seat 1: warioman ($24.37 in chips)
Seat 2: Player#5518 ($43.36 in chips)
Seat 3: Player#9727 ($51.01 in chips)
Seat 4: Player#4913 ($19.10 in chips)
Seat 5: Player#6554 ($21.31 in chips)
Seat 6: Player#8224 ($22.23 in chips)
Player#5518: posts small blind $0.10
Player#9727: posts big blind $0.20
*** HOLE CARDS ***
Dealt to warioman [9c Kh]
Player#4913: raises $0.20 to $0.4
Player#6554: folds
Player#8224: folds
warioman: folds
Player#5518: folds
Player#9727: calls $0.20
*** FLOP *** [Js 6s 8s]
Player#9727: checks
Player#4913: checks
*** TURN *** [Js 6s 8s] [Ac]
Player#9727: checks
Player#4913: bets $1.00
Player#9727: folds
Player#4913: doesn't show hand
Uncalled bet ($1.00) returned to Player#4913
Player#4913 collected $0.85 from pot
*** SUMMARY ***
Total Pot $0.90 | Rake $0.04
Board [Js 6s 8s Ac]
Seat 1: warioman (button) folded before the flop
Seat 2: Player#5518 (small blind) folded before the flop
Seat 3: Player#9727 (big blind) folded on the turn
Seat 4: Player#4913 shows [] and won ($0.85) with 
Seat 5: Player#6554 folded before the flop
Seat 6: Player#8224 folded before the flop

PokerStars Hand #475a5990-643b-4797-ac20-8ed74325ee81:  Hold'em No Limit ($0.1/$0.20 USD) - 2021/11/21 00:28:00 ET
Table 'Lacey' 6-max Seat #6 is the button
Seat 1: warioman ($24.47 in chips)
Seat 2: Player#5388 ($42.90 in chips)
Seat 3: Player#0747 ($51.01 in chips)
Seat 4: Player#2696 ($19.10 in chips)
Seat 5: Player#3074 ($21.31 in chips)
Seat 6: Player#7451 ($22.63 in chips)
warioman: posts small blind $0.10
Player#5388: posts big blind $0.20
*** HOLE CARDS ***
Dealt to warioman [3d Ac]
Player#0747: folds
Player#2696: folds
Player#3074: folds
Player#7451: raises $0.20 to $0.4
warioman: folds
Player#5388: calls $0.20
*** FLOP *** [9d Jc Qs]
Player#5388: checks
Player#7451: checks
*** TURN *** [9d Jc Qs] [2s]
Player#5388: bets $0.65
Player#7451: folds
Player#5388: doesn't show hand
Uncalled bet ($0.65) returned to Player#5388
Player#5388 collected $0.85 from pot
*** SUMMARY ***
Total Pot $0.90 | Rake $0.05
Board [9d Jc Qs 2s]
Seat 1: warioman (small blind) folded before the flop
Seat 2: Player#5388 shows [] and won ($0.85) with 
Seat 3: Player#0747 folded before the flop
Seat 4: Player#2696 folded before the flop
Seat 5: Player#3074 folded before the flop
Seat 6: Player#7451 (button) folded on the turn

PokerStars Hand #2f241595-0f39-47ca-a874-d22c9f35b648:  Hold'em No Limit ($0.1/$0.20 USD) - 2021/11/21 00:28:00 ET
Table 'Denver' 6-max Seat #1 is the button
Seat 1: Player#2657 ($19.55 in chips)
Seat 2: Player#4754 ($29.26 in chips)
Seat 3: Player#5574 ($34.79 in chips)
Seat 4: warioman ($42.83 in chips)
Seat 5: Player#8903 ($19.70 in chips)
Player#4754: posts small blind $0.10
Player#5574: posts big blind $0.20
*** HOLE CARDS ***
Dealt to warioman [2c 9c]
warioman: folds
Player#8903: raises $0.20 to $0.6
Player#2657: calls $0.60
Player#4754: calls $0.50
Player#5574: calls $0.40
*** FLOP *** [Tc 9d 3s]
Player#4754: checks
Player#5574: checks
Player#8903: bets $1.20
Player#2657: calls $1.20
Player#4754: calls $1.20
Player#5574: folds
*** TURN *** [Tc 9d 3s] [3h]
Player#4754: checks
Player#8903: checks
Player#2657: bets $3.00
Player#4754: folds
Player#8903: calls $3.00
*** RIVER *** [Tc 9d 3s] [3h] [2h]
Player#8903: checks
Player#2657: checks
*** SHOW DOWN *** 
Player#2657 collected $11.40 from pot
*** SUMMARY ***
Total Pot $12.00 | Rake $0.60
Board [Tc 9d 3s 3h 2h]
Seat 1: Player#2657 shows [Kh 9h] and won ($11.40) with 
Seat 2: Player#4754 (small blind) folded on the turn
Seat 3: Player#5574 (big blind) folded on the flop
Seat 4: warioman folded before the flop
Seat 5: Player#8903 mucked

PokerStars Hand #b48c6d69-be0b-4c09-86d0-ffec4536e85a:  Hold'em No Limit ($0.1/$0.20 USD) - 2021/11/21 00:28:00 ET
Table 'Denver' 6-max Seat #6 is the button
Seat 1: Player#3958 ($19.65 in chips)
Seat 2: Player#0223 ($29.46 in chips)
Seat 3: Player#5352 ($34.49 in chips)
Seat 4: warioman ($42.83 in chips)
Seat 5: Player#2867 ($19.70 in chips)
Player#3958: posts small blind $0.10
Player#0223: posts big blind $0.20
*** HOLE CARDS ***
Dealt to warioman [Kh Tc]
Player#5352: raises $0.20 to $0.6
warioman: folds
Player#2867: folds
Player#3958: folds
Player#0223: folds
Player#5352: doesn't show hand
Uncalled bet ($0.60) returned to Player#5352
Player#5352 collected $0.30 from pot
*** SUMMARY ***
Total Pot $0.30 | Rake $0.00
Seat 1: Player#3958 (small blind) folded before the flop
Seat 2: Player#0223 (big blind) folded before the flop
Seat 3: Player#5352 shows [] and won ($0.30) with 
Seat 4: warioman folded before the flop
Seat 5: Player#2867 folded before the flop

PokerStars Hand #dad8b0fc-66bc-4d47-b765-a89c677ed0df:  Hold'em No Limit ($0.1/$0.20 USD) - 2021/11/21 00:27:00 ET
Table 'Lacey' 6-max Seat #5 is the button
Seat 1: warioman ($24.67 in chips)
Seat 2: Player#5149 ($42.90 in chips)
Seat 3: Player#9529 ($50.54 in chips)
Seat 4: Player#9553 ($19.10 in chips)
Seat 5: Player#8640 ($21.51 in chips)
Seat 6: Player#3924 ($22.73 in chips)
Player#3924: posts small blind $0.10
warioman: posts big blind $0.20
*** HOLE CARDS ***
Dealt to warioman [4s Qc]
Player#5149: folds
Player#9529: calls $0.20
Player#9553: folds
Player#8640: calls $0.20
Player#3924: folds
warioman: checks
*** FLOP *** [4h 3h 3c]
warioman: checks
Player#9529: checks
Player#8640: checks
*** TURN *** [4h 3h 3c] [9s]
warioman: checks
Player#9529: bets $0.60
Player#8640: folds
warioman: folds
Player#9529: doesn't show hand
Uncalled bet ($0.60) returned to Player#9529
Player#9529 collected $0.67 from pot
*** SUMMARY ***
Total Pot $0.70 | Rake $0.04
Board [4h 3h 3c 9s]
Seat 1: warioman (big blind) folded on the turn
Seat 2: Player#5149 folded before the flop
Seat 3: Player#9529 shows [] and won ($0.67) with 
Seat 4: Player#9553 folded before the flop
Seat 5: Player#8640 (button) folded on the turn
Seat 6: Player#3924 (small blind) folded before the flop

PokerStars Hand #8813312b-17a0-4154-9e27-60b255efe56c:  Hold'em No Limit ($0.1/$0.20 USD) - 2021/11/21 00:27:00 ET
Table 'Lacey' 6-max Seat #4 is the button
Seat 1: warioman ($24.67 in chips)
Seat 2: Player#9718 ($42.90 in chips)
Seat 3: Player#5433 ($50.54 in chips)
Seat 4: Player#3803 ($19.10 in chips)
Seat 5: Player#8315 ($21.61 in chips)
Seat 6: Player#5669 ($22.63 in chips)
Player#8315: posts small blind $0.10
Player#5669: posts big blind $0.20
*** HOLE CARDS ***
Dealt to warioman [Ah 3c]
warioman: folds
Player#9718: folds
Player#5433: folds
Player#3803: folds
Player#8315: folds
Player#5669 collected $0.20 from pot
*** SUMMARY ***
Total Pot $0.20 | Rake $0.00
Seat 1: warioman folded before the flop
Seat 2: Player#9718 folded before the flop
Seat 3: Player#5433 folded before the flop
Seat 4: Player#3803 (button) folded before the flop
Seat 5: Player#8315 (small blind) folded before the flop
Seat 6: Player#5669 shows [] and won ($0.20) with 

PokerStars Hand #51c477e2-dfdc-4bfb-8765-9c61f1a59e39:  Hold'em No Limit ($0.1/$0.20 USD) - 2021/11/21 00:27:00 ET
Table 'Denver' 6-max Seat #6 is the button
Seat 1: Player#1206 ($19.85 in chips)
Seat 2: Player#5443 ($27.11 in chips)
Seat 3: Player#4847 ($36.89 in chips)
Seat 4: warioman ($42.83 in chips)
Seat 5: Player#4515 ($19.70 in chips)
Player#1206: posts small blind $0.10
Player#5443: posts big blind $0.20
*** HOLE CARDS ***
Dealt to warioman [Ad 4c]
Player#5443: raises $0.20 to $0.6
Player#4847: raises $0.60 to $2.4
warioman: folds
Player#4515: folds
Player#1206: folds
Player#5443: calls $1.80
*** FLOP *** [6c 7d Js]
Player#5443: bets $24.71
Player#4847: folds
Player#5443: doesn't show hand
Uncalled bet ($24.71) returned to Player#5443
Player#5443 collected $4.75 from pot
*** SUMMARY ***
Total Pot $5.00 | Rake $0.25
Board [6c 7d Js]
Seat 1: Player#1206 (small blind) folded before the flop
Seat 2: Player#5443 shows [] and won ($4.75) with 
Seat 3: Player#4847 folded on the flop
Seat 4: warioman folded before the flop
Seat 5: Player#4515 folded before the flop

PokerStars Hand #b87cf8ff-013d-4b2f-8f83-57d9354cbd5d:  Hold'em No Limit ($0.1/$0.20 USD) - 2021/11/21 00:27:00 ET
Table 'Lacey' 6-max Seat #3 is the button
Seat 1: warioman ($24.67 in chips)
Seat 2: Player#4965 ($42.90 in chips)
Seat 3: Player#2184 ($51.97 in chips)
Seat 4: Player#6552 ($19.20 in chips)
Seat 5: Player#1325 ($20.22 in chips)
Seat 6: Player#1460 ($22.63 in chips)
Player#6552: posts small blind $0.10
Player#1325: posts big blind $0.20
*** HOLE CARDS ***
Dealt to warioman [7c Tc]
Player#1460: folds
warioman: folds
Player#4965: folds
Player#2184: raises $0.20 to $0.6
Player#6552: folds
Player#1325: raises $0.60 to $1.43
Player#2184: calls $0.83
*** FLOP *** [7s Ac 7d]
Player#1325: bets $1.48
Player#2184: folds
Player#1325: doesn't show hand
Uncalled bet ($1.48) returned to Player#1325
Player#1325 collected $2.81 from pot
*** SUMMARY ***
Total Pot $2.96 | Rake $0.15
Board [7s Ac 7d]
Seat 1: warioman folded before the flop
Seat 2: Player#4965 folded before the flop
Seat 3: Player#2184 (button) folded on the flop
Seat 4: Player#6552 (small blind) folded before the flop
Seat 5: Player#1325 shows [] and won ($2.81) with 
Seat 6: Player#1460 folded before the flop

PokerStars Hand #de5414d5-05bf-4a76-baf8-22de39fc1282:  Hold'em No Limit ($0.1/$0.20 USD) - 2021/11/21 00:26:00 ET
Table 'Lacey' 6-max Seat #2 is the button
Seat 1: warioman ($24.67 in chips)
Seat 2: Player#2079 ($42.90 in chips)
Seat 3: Player#4443 ($51.25 in chips)
Seat 4: Player#2655 ($20.00 in chips)
Seat 5: Player#3273 ($20.22 in chips)
Seat 6: Player#5762 ($22.63 in chips)
Player#4443: posts small blind $0.10
Player#2655: posts big blind $0.20
*** HOLE CARDS ***
Dealt to warioman [5d 8h]
Player#3273: folds
Player#5762: folds
warioman: folds
Player#2079: folds
Player#4443: calls $0.10
Player#2655: checks
*** FLOP *** [Th Tc 4h]
Player#4443: checks
Player#2655: checks
*** TURN *** [Th Tc 4h] [3d]
Player#4443: bets $0.60
Player#2655: calls $0.60
*** RIVER *** [Th Tc 4h] [3d] [6d]
Player#4443: checks
Player#2655: checks
*** SHOW DOWN *** 
Player#4443 collected $1.52 from pot
*** SUMMARY ***
Total Pot $1.60 | Rake $0.08
Board [Th Tc 4h 3d 6d]
Seat 1: warioman folded before the flop
Seat 2: Player#2079 (button) folded before the flop
Seat 3: Player#4443 shows [2h Ad] and won ($1.52) with 
Seat 4: Player#2655 (big blind) mucked
Seat 5: Player#3273 folded before the flop
Seat 6: Player#5762 folded before the flop

PokerStars Hand #4a1b351c-ed4d-4d1e-b53b-1aa4013eeaab:  Hold'em No Limit ($0.1/$0.20 USD) - 2021/11/21 00:25:00 ET
Table 'Denver' 6-max Seat #4 is the button
Seat 1: Player#7484 ($18.66 in chips)
Seat 2: Player#1707 ($27.11 in chips)
Seat 3: Player#0019 ($37.89 in chips)
Seat 4: warioman ($42.83 in chips)
Seat 5: Player#7716 ($19.80 in chips)
Seat 6: Player#1508 ($16.62 in chips)
Player#7716: posts small blind $0.10
Player#1508: posts big blind $0.20
*** HOLE CARDS ***
Dealt to warioman [Jh 8s]
Player#7484: raises $0.20 to $0.6
Player#1707: folds
Player#0019: calls $0.60
warioman: folds
Player#7716: folds
Player#1508: folds
*** FLOP *** [9s Kh Ks]
Player#7484: checks
Player#0019: checks
*** TURN *** [9s Kh Ks] [2h]
Player#7484: bets $0.40
Player#0019: calls $0.40
*** RIVER *** [9s Kh Ks] [2h] [7h]
Player#7484: bets $1.15
Player#0019: folds
Player#7484: doesn't show hand
Uncalled bet ($1.15) returned to Player#7484
Player#7484 collected $2.18 from pot
*** SUMMARY ***
Total Pot $2.30 | Rake $0.11
Board [9s Kh Ks 2h 7h]
Seat 1: Player#7484 shows [] and won ($2.18) with 
Seat 2: Player#1707 folded before the flop
Seat 3: Player#0019 folded on the river
Seat 4: warioman (button) folded before the flop
Seat 5: Player#7716 (small blind) folded before the flop
Seat 6: Player#1508 (big blind) folded before the flop

PokerStars Hand #5c4c91ad-cfdd-49cf-80c7-7177c041c8d9:  Hold'em No Limit ($0.1/$0.20 USD) - 2021/11/21 00:25:00 ET
Table 'Lacey' 6-max Seat #1 is the button
Seat 1: warioman ($24.67 in chips)
Seat 2: Player#7782 ($43.70 in chips)
Seat 3: Player#4715 ($49.77 in chips)
Seat 4: Player#1602 ($20.22 in chips)
Seat 5: Player#9771 ($23.43 in chips)
Player#7782: posts small blind $0.10
Player#4715: posts big blind $0.20
*** HOLE CARDS ***
Dealt to warioman [7c 3h]
Player#1602: folds
Player#9771: raises $0.20 to $0.4
warioman: folds
Player#7782: calls $0.30
Player#4715: raises $0.40 to $0.8
Player#9771: calls $0.40
Player#7782: calls $0.40
*** FLOP *** [Ts 4c Ad]
Player#7782: checks
Player#4715: bets $1.20
Player#9771: folds
Player#7782: folds
Player#4715: doesn't show hand
Uncalled bet ($1.20) returned to Player#4715
Player#4715 collected $2.28 from pot
*** SUMMARY ***
Total Pot $2.40 | Rake $0.12
Board [Ts 4c Ad]
Seat 1: warioman (button) folded before the flop
Seat 2: Player#7782 (small blind) folded on the flop
Seat 3: Player#4715 shows [] and won ($2.28) with 
Seat 4: Player#1602 folded before the flop
Seat 5: Player#9771 folded on the flop

PokerStars Hand #48dd0486-ba61-403a-8c6d-a2a18ca99dd4:  Hold'em No Limit ($0.1/$0.20 USD) - 2021/11/21 00:24:00 ET
Table 'Lacey' 6-max Seat #6 is the button
Seat 1: warioman ($24.77 in chips)
Seat 2: Player#4508 ($44.30 in chips)
Seat 3: Player#1766 ($60.06 in chips)
Seat 4: Player#3253 ($10.29 in chips)
Seat 5: Player#0515 ($23.43 in chips)
warioman: posts small blind $0.10
Player#4508: posts big blind $0.20
*** HOLE CARDS ***
Dealt to warioman [9d 7d]
Player#1766: raises $0.20 to $0.6
Player#3253: calls $0.60
Player#0515: folds
warioman: folds
Player#4508: calls $0.40
*** FLOP *** [Jh Qc Qh]
Player#4508: checks
Player#1766: bets $0.95
Player#3253: raises $0.95 to $3.56
Player#4508: folds
Player#1766: calls $2.61
*** TURN *** [Jh Qc Qh] [Ts]
Player#1766: checks
Player#3253: bets $6.13
Player#1766: calls $6.13
Player#1766 Showing Pocket Cards AJ
Player#3253 Showing Pocket Cards T9
*** RIVER *** [Jh Qc Qh] [Ts] [8c]
Player#3253 collected $20.22 from pot
*** SUMMARY ***
Total Pot $21.28 | Rake $1.06
Board [Jh Qc Qh Ts 8c]
Seat 1: warioman (small blind) folded before the flop
Seat 2: Player#4508 (big blind) folded on the flop
Seat 3: Player#1766 mucked
Seat 4: Player#3253 shows [Tc 9c] and won ($20.22) with 
Seat 5: Player#0515 folded before the flop

PokerStars Hand #831227f0-1707-49ec-899f-9c61f1dbb0c6:  Hold'em No Limit ($0.1/$0.20 USD) - 2021/11/21 00:24:00 ET
Table 'Denver' 6-max Seat #3 is the button
Seat 1: Player#2932 ($20.24 in chips)
Seat 2: Player#4842 ($25.40 in chips)
Seat 3: Player#2116 ($37.89 in chips)
Seat 4: warioman ($42.93 in chips)
Seat 5: Player#0721 ($20.00 in chips)
Seat 6: Player#0221 ($16.62 in chips)
warioman: posts small blind $0.10
Player#0721: posts big blind $0.20
*** HOLE CARDS ***
Dealt to warioman [Js 4d]
Player#0221: folds
Player#2932: raises $0.20 to $0.6
Player#4842: raises $0.60 to $1.58
Player#2116: folds
warioman: folds
Player#0721: folds
Player#2932: calls $0.98
*** FLOP *** [Qh 5s 7c]
Player#2932: checks
Player#4842: bets $4.26
Player#2932: folds
Player#4842: doesn't show hand
Uncalled bet ($4.26) returned to Player#4842
Player#4842 collected $3.29 from pot
*** SUMMARY ***
Total Pot $3.46 | Rake $0.17
Board [Qh 5s 7c]
Seat 1: Player#2932 folded on the flop
Seat 2: Player#4842 shows [] and won ($3.29) with 
Seat 3: Player#2116 (button) folded before the flop
Seat 4: warioman (small blind) folded before the flop
Seat 5: Player#0721 (big blind) folded before the flop
Seat 6: Player#0221 folded before the flop

PokerStars Hand #88e8b28a-0a5c-4348-ac08-b751c1ec5661:  Hold'em No Limit ($0.1/$0.20 USD) - 2021/11/21 00:24:00 ET
Table 'Lacey' 6-max Seat #4 is the button
Seat 1: warioman ($24.97 in chips)
Seat 2: Player#9354 ($44.30 in chips)
Seat 3: Player#9463 ($59.76 in chips)
Seat 4: Player#0071 ($10.29 in chips)
Seat 5: Player#1000 ($23.53 in chips)
Player#1000: posts small blind $0.10
warioman: posts big blind $0.20
*** HOLE CARDS ***
Dealt to warioman [6s 5h]
Player#9354: folds
Player#9463: raises $0.20 to $0.6
Player#0071: folds
Player#1000: folds
warioman: folds
Player#9463: doesn't show hand
Uncalled bet ($0.60) returned to Player#9463
Player#9463 collected $0.30 from pot
*** SUMMARY ***
Total Pot $0.30 | Rake $0.00
Seat 1: warioman (big blind) folded before the flop
Seat 2: Player#9354 folded before the flop
Seat 3: Player#9463 shows [] and won ($0.30) with 
Seat 4: Player#0071 (button) folded before the flop
Seat 5: Player#1000 (small blind) folded before the flop

PokerStars Hand #9664a312-8557-4cb3-a1ac-f9aed9dcba50:  Hold'em No Limit ($0.1/$0.20 USD) - 2021/11/21 00:24:00 ET
Table 'Lacey' 6-max Seat #3 is the button
Seat 1: warioman ($24.97 in chips)
Seat 2: Player#2110 ($43.34 in chips)
Seat 3: Player#9796 ($60.51 in chips)
Seat 4: Player#1106 ($10.39 in chips)
Seat 5: Player#4327 ($23.73 in chips)
Player#1106: posts small blind $0.10
Player#4327: posts big blind $0.20
*** HOLE CARDS ***
Dealt to warioman [7d 8h]
warioman: folds
Player#2110: raises $0.20 to $0.75
Player#9796: calls $0.75
Player#1106: folds
Player#4327: folds
*** FLOP *** [4d 2d Td]
Player#2110: bets $1.09
Player#9796: folds
Player#2110: doesn't show hand
Uncalled bet ($1.09) returned to Player#2110
Player#2110 collected $1.71 from pot
*** SUMMARY ***
Total Pot $1.80 | Rake $0.09
Board [4d 2d Td]
Seat 1: warioman folded before the flop
Seat 2: Player#2110 shows [] and won ($1.71) with 
Seat 3: Player#9796 (button) folded on the flop
Seat 4: Player#1106 (small blind) folded before the flop
Seat 5: Player#4327 (big blind) folded before the flop

PokerStars Hand #900c4335-3220-4cf0-8716-9b30039c0709:  Hold'em No Limit ($0.1/$0.20 USD) - 2021/11/21 00:23:00 ET
Table 'Lacey' 6-max Seat #2 is the button
Seat 1: warioman ($24.97 in chips)
Seat 2: Player#7265 ($43.34 in chips)
Seat 3: Player#5989 ($60.31 in chips)
Seat 4: Player#6747 ($10.59 in chips)
Seat 5: Player#5160 ($23.73 in chips)
Player#5989: posts small blind $0.10
Player#6747: posts big blind $0.20
*** HOLE CARDS ***
Dealt to warioman [4d 9s]
Player#5160: folds
warioman: folds
Player#7265: folds
Player#5989: raises $0.20 to $0.6
Player#6747: folds
Player#5989: doesn't show hand
Uncalled bet ($0.60) returned to Player#5989
Player#5989 collected $0.20 from pot
*** SUMMARY ***
Total Pot $0.20 | Rake $0.00
Seat 1: warioman folded before the flop
Seat 2: Player#7265 (button) folded before the flop
Seat 3: Player#5989 shows [] and won ($0.20) with 
Seat 4: Player#6747 (big blind) folded before the flop
Seat 5: Player#5160 folded before the flop

PokerStars Hand #92d22c06-a8d8-4e56-bd2f-c754e3f029ca:  Hold'em No Limit ($0.1/$0.20 USD) - 2021/11/21 00:23:00 ET
Table 'Denver' 6-max Seat #4 is the button
Seat 1: Player#4587 ($20.24 in chips)
Seat 2: Player#1034 ($28.28 in chips)
Seat 3: Player#6780 ($35.10 in chips)
Seat 4: warioman ($43.13 in chips)
Seat 5: Player#4600 ($20.00 in chips)
Seat 6: Player#0232 ($16.62 in chips)
Player#4600: posts small blind $0.10
Player#6780: posts big blind $0.20
*** HOLE CARDS ***
Dealt to warioman [As 4c]
Player#4600 Waiting
Player#0232: folds
Player#4587: folds
Player#1034: raises $0.20 to $0.6
Player#6780: calls $0.50
warioman: folds
*** FLOP *** [9h 3c 6c]
Player#6780: checks
Player#1034: checks
*** TURN *** [9h 3c 6c] [8s]
Player#6780: bets $1.05
Player#1034: raises $1.05 to $2.28
Player#6780: calls $1.23
*** RIVER *** [9h 3c 6c] [8s] [2s]
Player#6780: checks
Player#1034: checks
*** SHOW DOWN *** 
Player#6780 collected $5.66 from pot
*** SUMMARY ***
Total Pot $5.96 | Rake $0.30
Board [9h 3c 6c 8s 2s]
Seat 1: Player#4587 folded before the flop
Seat 2: Player#1034 mucked
Seat 3: Player#6780 shows [9d Td] and won ($5.66) with 
Seat 4: warioman (button) folded before the flop
Seat 5: Player#4600 (small blind) mucked
Seat 6: Player#0232 folded before the flop

PokerStars Hand #404eb559-e380-4f86-9bdc-0ba37847a3f7:  Hold'em No Limit ($0.1/$0.20 USD) - 2021/11/21 00:23:00 ET
Table 'Lacey' 6-max Seat #1 is the button
Seat 1: warioman ($24.97 in chips)
Seat 2: Player#0417 ($43.14 in chips)
Seat 3: Player#3380 ($60.51 in chips)
Seat 4: Player#6058 ($10.59 in chips)
Seat 5: Player#2159 ($23.73 in chips)
Player#0417: posts small blind $0.10
Player#3380: posts big blind $0.20
*** HOLE CARDS ***
Dealt to warioman [Th 3h]
Player#6058: folds
Player#2159: folds
warioman: folds
Player#0417: raises $0.20 to $0.75
Player#3380: folds
Player#0417: doesn't show hand
Uncalled bet ($0.75) returned to Player#0417
Player#0417 collected $0.20 from pot
*** SUMMARY ***
Total Pot $0.20 | Rake $0.00
Seat 1: warioman (button) folded before the flop
Seat 2: Player#0417 shows [] and won ($0.20) with 
Seat 3: Player#3380 (big blind) folded before the flop
Seat 4: Player#6058 folded before the flop
Seat 5: Player#2159 folded before the flop

PokerStars Hand #165f9551-9b62-444b-bc45-741fcca00d8b:  Hold'em No Limit ($0.1/$0.20 USD) - 2021/11/21 00:22:00 ET
Table 'Denver' 6-max Seat #4 is the button
Seat 1: Player#7568 ($18.40 in chips)
Seat 2: Player#6294 ($28.38 in chips)
Seat 3: Player#1518 ($35.80 in chips)
Seat 4: warioman ($43.13 in chips)
Seat 5: Player#0394 ($20.00 in chips)
Seat 6: Player#6633 ($17.82 in chips)
Player#0394: posts small blind $0.10
Player#6294: posts big blind $0.20
*** HOLE CARDS ***
Dealt to warioman [Jd 5h]
Player#0394 Waiting
warioman: folds
Player#6633: raises $0.20 to $0.7
Player#7568: calls $0.70
Player#6294: folds
Player#1518: calls $0.50
*** FLOP *** [4c 8h 2c]
Player#1518: checks
Player#6633: bets $0.50
Player#7568: raises $0.50 to $2.78
Player#1518: folds
Player#6633: folds
Player#7568: doesn't show hand
Uncalled bet ($2.78) returned to Player#7568
Player#7568 collected $2.57 from pot
*** SUMMARY ***
Total Pot $2.70 | Rake $0.14
Board [4c 8h 2c]
Seat 1: Player#7568 shows [] and won ($2.57) with 
Seat 2: Player#6294 (big blind) folded before the flop
Seat 3: Player#1518 folded on the flop
Seat 4: warioman (button) folded before the flop
Seat 5: Player#0394 (small blind) mucked
Seat 6: Player#6633 folded on the flop

PokerStars Hand #8ab8e2df-30e6-4428-9e0f-6487ecef7e23:  Hold'em No Limit ($0.1/$0.20 USD) - 2021/11/21 00:22:00 ET
Table 'Lacey' 6-max Seat #6 is the button
Seat 1: warioman ($25.07 in chips)
Seat 2: Player#6740 ($43.34 in chips)
Seat 3: Player#7203 ($60.51 in chips)
Seat 4: Player#0978 ($13.64 in chips)
Seat 5: Player#7596 ($20.70 in chips)
warioman: posts small blind $0.10
Player#6740: posts big blind $0.20
*** HOLE CARDS ***
Dealt to warioman [2s Ac]
Player#7203: folds
Player#0978: raises $0.20 to $0.6
Player#7596: calls $0.60
warioman: folds
Player#6740: folds
*** FLOP *** [Qd 3h Kc]
Player#0978: bets $0.75
Player#7596: calls $0.75
*** TURN *** [Qd 3h Kc] [7c]
Player#0978: checks
Player#7596: checks
*** RIVER *** [Qd 3h Kc] [7c] [9c]
Player#0978: bets $1.70
Player#7596: calls $1.70
*** SHOW DOWN *** 
Player#7596 collected $6.08 from pot
*** SUMMARY ***
Total Pot $6.40 | Rake $0.32
Board [Qd 3h Kc 7c 9c]
Seat 1: warioman (small blind) folded before the flop
Seat 2: Player#6740 (big blind) folded before the flop
Seat 3: Player#7203 folded before the flop
Seat 4: Player#0978 mucked
Seat 5: Player#7596 shows [Kh 9h] and won ($6.08) with 

PokerStars Hand #ebd96e01-02b9-4b10-b99a-c7d84302be78:  Hold'em No Limit ($0.1/$0.20 USD) - 2021/11/21 00:22:00 ET
Table 'Denver' 6-max Seat #6 is the button
Seat 1: Player#1572 ($19.10 in chips)
Seat 2: Player#7629 ($28.58 in chips)
Seat 3: Player#2918 ($35.80 in chips)
Seat 4: warioman ($43.13 in chips)
Seat 5: Player#7031 ($17.00 in chips)
Player#1572: posts small blind $0.10
Player#7629: posts big blind $0.20
*** HOLE CARDS ***
Dealt to warioman [2d Qc]
Player#2918: folds
warioman: folds
Player#7031: raises $0.20 to $0.7
Player#1572: calls $0.60
Player#7629: folds
*** FLOP *** [7d 9h Ts]
Player#1572: checks
Player#7031: bets $0.60
Player#1572: folds
Player#7031: doesn't show hand
Uncalled bet ($0.60) returned to Player#7031
Player#7031 collected $1.52 from pot
*** SUMMARY ***
Total Pot $1.60 | Rake $0.08
Board [7d 9h Ts]
Seat 1: Player#1572 (small blind) folded on the flop
Seat 2: Player#7629 (big blind) folded before the flop
Seat 3: Player#2918 folded before the flop
Seat 4: warioman folded before the flop
Seat 5: Player#7031 shows [] and won ($1.52) with 

PokerStars Hand #a3aec946-b629-4122-a986-dac95f1f38ac:  Hold'em No Limit ($0.1/$0.20 USD) - 2021/11/21 00:21:00 ET
Table 'Lacey' 6-max Seat #4 is the button
Seat 1: warioman ($26.07 in chips)
Seat 2: Player#6684 ($43.34 in chips)
Seat 3: Player#0898 ($60.51 in chips)
Seat 4: Player#8968 ($13.64 in chips)
Seat 5: Player#0921 ($19.80 in chips)
Player#0921: posts small blind $0.10
warioman: posts big blind $0.20
*** HOLE CARDS ***
Dealt to warioman [2s 2h]
Player#6684: folds
Player#0898: folds
Player#8968: folds
Player#0921: raises $0.20 to $0.6
warioman: calls $0.40
*** FLOP *** [4d 7h 3d]
Player#0921: checks
warioman: checks
*** TURN *** [4d 7h 3d] [5s]
Player#0921: bets $0.40
warioman: calls $0.40
*** RIVER *** [4d 7h 3d] [5s] [Js]
Player#0921: bets $3.00
warioman: folds
Player#0921: doesn't show hand
Uncalled bet ($3.00) returned to Player#0921
Player#0921 collected $1.90 from pot
*** SUMMARY ***
Total Pot $2.00 | Rake $0.10
Board [4d 7h 3d 5s Js]
Seat 1: warioman (big blind) folded on the river
Seat 2: Player#6684 folded before the flop
Seat 3: Player#0898 folded before the flop
Seat 4: Player#8968 (button) folded before the flop
Seat 5: Player#0921 shows [] and won ($1.90) with 

PokerStars Hand #dc956fbc-ec13-4c44-a274-81b06c4d5440:  Hold'em No Limit ($0.1/$0.20 USD) - 2021/11/21 00:21:00 ET
Table 'Denver' 6-max Seat #4 is the button
Seat 1: Player#0079 ($19.30 in chips)
Seat 2: Player#3006 ($35.18 in chips)
Seat 3: Player#0580 ($29.57 in chips)
Seat 4: warioman ($43.13 in chips)
Seat 5: Player#6228 ($17.10 in chips)
Player#6228: posts small blind $0.10
Player#0079: posts big blind $0.20
*** HOLE CARDS ***
Dealt to warioman [Jc 6s]
Player#3006: raises $0.20 to $1.2
Player#0580: calls $1.20
warioman: folds
Player#6228: folds
Player#0079: folds
*** FLOP *** [5h Qc 6c]
Player#3006: bets $1.35
Player#0580: calls $1.35
*** TURN *** [5h Qc 6c] [Th]
Player#3006: checks
Player#0580: bets $4.05
Player#3006: calls $4.05
*** RIVER *** [5h Qc 6c] [Th] [2h]
Player#3006: checks
Player#0580: checks
*** SHOW DOWN *** 
Player#0580 collected $12.82 from pot
*** SUMMARY ***
Total Pot $13.50 | Rake $0.68
Board [5h Qc 6c Th 2h]
Seat 1: Player#0079 (big blind) folded before the flop
Seat 2: Player#3006 mucked
Seat 3: Player#0580 shows [Qh Jh] and won ($12.82) with 
Seat 4: warioman (button) folded before the flop
Seat 5: Player#6228 (small blind) folded before the flop

PokerStars Hand #d73f0839-8f4c-454b-8be9-fd0c4fd8d31b:  Hold'em No Limit ($0.1/$0.20 USD) - 2021/11/21 00:21:00 ET
Table 'Lacey' 6-max Seat #3 is the button
Seat 1: warioman ($26.07 in chips)
Seat 2: Player#0131 ($43.04 in chips)
Seat 3: Player#5014 ($60.51 in chips)
Seat 4: Player#9742 ($13.74 in chips)
Seat 5: Player#7312 ($20.00 in chips)
Player#9742: posts small blind $0.10
Player#7312: posts big blind $0.20
*** HOLE CARDS ***
Dealt to warioman [Js 4s]
warioman: folds
Player#0131: raises $0.20 to $0.75
Player#5014: folds
Player#9742: folds
Player#7312: folds
Player#0131: doesn't show hand
Uncalled bet ($0.75) returned to Player#0131
Player#0131 collected $0.30 from pot
*** SUMMARY ***
Total Pot $0.30 | Rake $0.00
Seat 1: warioman folded before the flop
Seat 2: Player#0131 shows [] and won ($0.30) with 
Seat 3: Player#5014 (button) folded before the flop
Seat 4: Player#9742 (small blind) folded before the flop
Seat 5: Player#7312 (big blind) folded before the flop

PokerStars Hand #b0f37be3-5ac7-485d-b988-c5d9d8113963:  Hold'em No Limit ($0.1/$0.20 USD) - 2021/11/21 00:21:00 ET
Table 'Denver' 6-max Seat #3 is the button
Seat 1: Player#1294 ($19.70 in chips)
Seat 2: Player#3449 ($35.18 in chips)
Seat 3: Player#2375 ($29.97 in chips)
Seat 4: warioman ($43.23 in chips)
Seat 5: Player#3996 ($16.20 in chips)
warioman: posts small blind $0.10
Player#3996: posts big blind $0.20
*** HOLE CARDS ***
Dealt to warioman [6c Kh]
Player#1294: raises $0.20 to $0.4
Player#3449: folds
Player#2375: calls $0.40
warioman: folds
Player#3996: raises $0.40 to $2.1
Player#1294: folds
Player#2375: folds
Player#3996: doesn't show hand
Uncalled bet ($2.10) returned to Player#3996
Player#3996 collected $0.90 from pot
*** SUMMARY ***
Total Pot $0.90 | Rake $0.00
Seat 1: Player#1294 folded before the flop
Seat 2: Player#3449 folded before the flop
Seat 3: Player#2375 (button) folded before the flop
Seat 4: warioman (small blind) folded before the flop
Seat 5: Player#3996 shows [] and won ($0.90) with 

PokerStars Hand #bb723cb7-3b86-48b5-b430-24a3a6ba0be6:  Hold'em No Limit ($0.1/$0.20 USD) - 2021/11/21 00:20:00 ET
Table 'Lacey' 6-max Seat #2 is the button
Seat 1: warioman ($26.07 in chips)
Seat 2: Player#8542 ($48.19 in chips)
Seat 3: Player#9266 ($55.68 in chips)
Seat 4: Player#8091 ($13.94 in chips)
Player#9266: posts small blind $0.10
Player#8091: posts big blind $0.20
*** HOLE CARDS ***
Dealt to warioman [Kh 4s]
warioman: folds
Player#8542: raises $0.20 to $0.6
Player#9266: calls $0.50
Player#8091: folds
*** FLOP *** [8d 6c Qd]
Player#9266: bets $0.70
Player#8542: raises $0.70 to $1.4
Player#9266: calls $0.70
*** TURN *** [8d 6c Qd] [2s]
Player#9266: bets $3.15
Player#8542: calls $3.15
*** RIVER *** [8d 6c Qd] [2s] [Ts]
Player#9266: checks
Player#8542: checks
*** SHOW DOWN *** 
Player#9266 collected $9.97 from pot
*** SUMMARY ***
Total Pot $10.50 | Rake $0.53
Board [8d 6c Qd 2s Ts]
Seat 1: warioman folded before the flop
Seat 2: Player#8542 (button) mucked
Seat 3: Player#9266 shows [Qs Jh] and won ($9.97) with 
Seat 4: Player#8091 (big blind) folded before the flop

PokerStars Hand #a4b11df3-2ca8-418e-be23-cc001cc385d2:  Hold'em No Limit ($0.1/$0.20 USD) - 2021/11/21 00:20:00 ET
Table 'Lacey' 6-max Seat #1 is the button
Seat 1: warioman ($26.07 in chips)
Seat 2: Player#7087 ($47.99 in chips)
Seat 3: Player#9682 ($55.88 in chips)
Seat 4: Player#0347 ($13.94 in chips)
Player#7087: posts small blind $0.10
Player#9682: posts big blind $0.20
*** HOLE CARDS ***
Dealt to warioman [3d 9h]
Player#0347: folds
warioman: folds
Player#7087: raises $0.20 to $0.5
Player#9682: folds
Player#7087: doesn't show hand
Uncalled bet ($0.50) returned to Player#7087
Player#7087 collected $0.20 from pot
*** SUMMARY ***
Total Pot $0.20 | Rake $0.00
Seat 1: warioman (button) folded before the flop
Seat 2: Player#7087 shows [] and won ($0.20) with 
Seat 3: Player#9682 (big blind) folded before the flop
Seat 4: Player#0347 folded before the flop

PokerStars Hand #e6108bff-31b5-4fd3-8b41-cc4f8b1bdcf2:  Hold'em No Limit ($0.1/$0.20 USD) - 2021/11/21 00:19:00 ET
Table 'Denver' 6-max Seat #2 is the button
Seat 1: Player#0107 ($19.70 in chips)
Seat 2: Player#8973 ($36.48 in chips)
Seat 3: Player#7128 ($30.67 in chips)
Seat 4: warioman ($39.44 in chips)
Seat 5: Player#7468 ($18.30 in chips)
Player#7128: posts small blind $0.10
warioman: posts big blind $0.20
*** HOLE CARDS ***
Dealt to warioman [Tc 8c]
Player#7468: raises $0.20 to $0.7
Player#0107: folds
Player#8973: calls $0.70
Player#7128: calls $0.60
warioman: calls $0.50
*** FLOP *** [Th 2d Ts]
Player#7128: checks
warioman: checks
Player#7468: bets $0.60
Player#8973: calls $0.60
Player#7128: folds
warioman: calls $0.60
*** TURN *** [Th 2d Ts] [3s]
warioman: checks
Player#7468: bets $0.80
Player#8973: folds
warioman: calls $0.80
*** RIVER *** [Th 2d Ts] [3s] [5s]
warioman: checks
Player#7468: checks
*** SHOW DOWN *** 
warioman collected $5.89 from pot
*** SUMMARY ***
Total Pot $6.20 | Rake $0.31
Board [Th 2d Ts 3s 5s]
Seat 1: Player#0107 folded before the flop
Seat 2: Player#8973 (button) folded on the turn
Seat 3: Player#7128 (small blind) folded on the flop
Seat 4: warioman (big blind)
Seat 5: Player#7468 mucked

PokerStars Hand #b6af82f6-9d9e-429a-908c-9ae29365aeda:  Hold'em No Limit ($0.1/$0.20 USD) - 2021/11/21 00:19:00 ET
Table 'Lacey' 6-max Seat #6 is the button
Seat 1: warioman ($26.17 in chips)
Seat 2: Player#0354 ($48.59 in chips)
Seat 3: Player#6533 ($54.67 in chips)
Seat 4: Player#7715 ($14.54 in chips)
warioman: posts small blind $0.10
Player#0354: posts big blind $0.20
*** HOLE CARDS ***
Dealt to warioman [9c Ts]
Player#6533: raises $0.20 to $0.6
Player#7715: calls $0.60
warioman: folds
Player#0354: calls $0.40
*** FLOP *** [6c 2c 3h]
Player#0354: checks
Player#6533: bets $0.95
Player#7715: folds
Player#0354: folds
Player#6533: doesn't show hand
Uncalled bet ($0.95) returned to Player#6533
Player#6533 collected $1.80 from pot
*** SUMMARY ***
Total Pot $1.90 | Rake $0.09
Board [6c 2c 3h]
Seat 1: warioman (small blind) folded before the flop
Seat 2: Player#0354 (big blind) folded on the flop
Seat 3: Player#6533 shows [] and won ($1.80) with 
Seat 4: Player#7715 folded on the flop

PokerStars Hand #04ae2f94-aef2-4eb4-8b66-8b1884a2dcc0:  Hold'em No Limit ($0.1/$0.20 USD) - 2021/11/21 00:19:00 ET
Table 'Denver' 6-max Seat #1 is the button
Seat 1: Player#4689 ($19.70 in chips)
Seat 2: Player#1749 ($36.58 in chips)
Seat 3: Player#9607 ($30.87 in chips)
Seat 4: warioman ($39.44 in chips)
Seat 5: Player#1720 ($18.00 in chips)
Player#1749: posts small blind $0.10
Player#9607: posts big blind $0.20
*** HOLE CARDS ***
Dealt to warioman [9d 2c]
warioman: folds
Player#1720: raises $0.20 to $0.7
Player#4689: folds
Player#1749: folds
Player#9607: folds
Player#1720: doesn't show hand
Uncalled bet ($0.70) returned to Player#1720
Player#1720 collected $0.30 from pot
*** SUMMARY ***
Total Pot $0.30 | Rake $0.00
Seat 1: Player#4689 (button) folded before the flop
Seat 2: Player#1749 (small blind) folded before the flop
Seat 3: Player#9607 (big blind) folded before the flop
Seat 4: warioman folded before the flop
Seat 5: Player#1720 shows [] and won ($0.30) with 

PokerStars Hand #59702965-170a-4342-b271-7baa7e7302ae:  Hold'em No Limit ($0.1/$0.20 USD) - 2021/11/21 00:19:00 ET
Table 'Lacey' 6-max Seat #2 is the button
Seat 1: warioman ($26.37 in chips)
Seat 2: Player#7337 ($54.37 in chips)
Seat 3: Player#9676 ($14.64 in chips)
Player#9676: posts small blind $0.10
warioman: posts big blind $0.20
*** HOLE CARDS ***
Dealt to warioman [8d 6c]
Player#7337: raises $0.20 to $0.6
Player#9676: folds
warioman: folds
Player#7337: doesn't show hand
Uncalled bet ($0.60) returned to Player#7337
Player#7337 collected $0.30 from pot
*** SUMMARY ***
Total Pot $0.30 | Rake $0.00
Seat 1: warioman (big blind) folded before the flop
Seat 2: Player#7337 shows [] and won ($0.30) with 
Seat 3: Player#9676 (small blind) folded before the flop

PokerStars Hand #0a04a24b-da9c-4fef-b55d-8b9df74458ac:  Hold'em No Limit ($0.1/$0.20 USD) - 2021/11/21 00:18:00 ET
Table 'Denver' 6-max Seat #6 is the button
Seat 1: Player#2403 ($19.80 in chips)
Seat 2: Player#1830 ($36.78 in chips)
Seat 3: Player#2875 ($30.87 in chips)
Seat 4: warioman ($37.14 in chips)
Seat 5: Player#3512 ($20.00 in chips)
Player#2403: posts small blind $0.10
Player#1830: posts big blind $0.20
*** HOLE CARDS ***
Dealt to warioman [Ks Ac]
Player#2875: folds
warioman: raises $0.20 to $0.5
Player#3512: raises0.50 to $2
Player#2403: folds
Player#1830: folds
warioman: raises $2.00 to $5.1
Player#3512: folds
warioman: doesn't show hand
Uncalled bet ($5.10) returned to warioman
warioman collected $2.30 from pot
*** SUMMARY ***
Total Pot $2.30 | Rake $0.00
Seat 1: Player#2403 (small blind) folded before the flop
Seat 2: Player#1830 (big blind) folded before the flop
Seat 3: Player#2875 folded before the flop
Seat 4: warioman
Seat 5: Player#3512 folded before the flop

PokerStars Hand #9cc23024-5929-47c5-8749-29229d726117:  Hold'em No Limit ($0.1/$0.20 USD) - 2021/11/21 00:18:00 ET
Table 'Lacey' 6-max Seat #1 is the button
Seat 1: warioman ($26.37 in chips)
Seat 2: Player#4700 ($54.97 in chips)
Seat 3: Player#3263 ($14.10 in chips)
Seat 4: Player#9475 ($48.59 in chips)
Player#4700: posts small blind $0.10
Player#3263: posts big blind $0.20
*** HOLE CARDS ***
Dealt to warioman [8s Jc]
Player#9475: folds
warioman: folds
Player#4700: calls $0.10
Player#3263: raises $0.20 to $0.6
Player#4700: calls $0.40
*** FLOP *** [4d Jh 4h]
Player#4700: checks
Player#3263: bets $0.60
Player#4700: folds
Player#3263: doesn't show hand
Uncalled bet ($0.60) returned to Player#3263
Player#3263 collected $1.14 from pot
*** SUMMARY ***
Total Pot $1.20 | Rake $0.06
Board [4d Jh 4h]
Seat 1: warioman (button) folded before the flop
Seat 2: Player#4700 (small blind) folded on the flop
Seat 3: Player#3263 shows [] and won ($1.14) with 
Seat 4: Player#9475 folded before the flop

PokerStars Hand #167a28e0-1987-45d6-bd5a-97df3d32a223:  Hold'em No Limit ($0.1/$0.20 USD) - 2021/11/21 00:18:00 ET
Table 'Denver' 6-max Seat #4 is the button
Seat 1: Player#0528 ($20.00 in chips)
Seat 2: Player#2124 ($19.10 in chips)
Seat 3: Player#8759 ($31.47 in chips)
Seat 4: warioman ($37.14 in chips)
Seat 5: Player#3929 ($18.80 in chips)
Player#3929: posts small blind $0.10
Player#0528: posts big blind $0.20
*** HOLE CARDS ***
Dealt to warioman [Qh 3s]
Player#2124: raises $0.20 to $0.6
Player#8759: calls $0.60
warioman: folds
Player#3929: raises $0.60 to $4.2
Player#0528: folds
Player#2124: raises $4.20 to $19.1
Player#8759: folds
Player#3929: calls $14.60
Player#3929 Showing Pocket Cards KA
Player#2124 Showing Pocket Cards 99
*** FLOP *** [4s 8h 6h]
*** TURN *** [4s 8h 6h] [4c]
*** RIVER *** [4s 8h 6h] [4c] [6h]
Player#2124 collected $37.20 from pot
*** SUMMARY ***
Total Pot $38.70 | Rake $1.50
Board [4s 8h 6h 4c 6h]
Seat 1: Player#0528 (big blind) folded before the flop
Seat 2: Player#2124 shows [9h 9s] and won ($37.20) with 
Seat 3: Player#8759 folded before the flop
Seat 4: warioman (button) folded before the flop
Seat 5: Player#3929 (small blind) mucked

PokerStars Hand #582053ba-0b3c-4607-b92c-9c341cb9b678:  Hold'em No Limit ($0.1/$0.20 USD) - 2021/11/21 00:17:00 ET
Table 'Denver' 6-max Seat #6 is the button
Seat 1: Player#0125 ($20.00 in chips)
Seat 2: Player#4786 ($32.07 in chips)
Seat 3: warioman ($36.34 in chips)
Seat 4: Player#3523 ($19.00 in chips)
Player#0125: posts small blind $0.10
warioman: posts big blind $0.20
*** HOLE CARDS ***
Dealt to warioman [Qc Ks]
Player#0125 Waiting
Player#4786: raises $0.20 to $0.6
warioman: raises $0.60 to $2.4
Player#3523: folds
Player#4786: folds
warioman: doesn't show hand
Uncalled bet ($2.40) returned to warioman
warioman collected $0.80 from pot
*** SUMMARY ***
Total Pot $0.80 | Rake $0.00
Seat 1: Player#0125 (small blind) mucked
Seat 2: Player#4786 folded before the flop
Seat 3: warioman (big blind)
Seat 4: Player#3523 folded before the flop

PokerStars Hand #3e03b82b-c8a1-4327-8b19-eaf68793bad8:  Hold'em No Limit ($0.1/$0.20 USD) - 2021/11/21 00:17:00 ET
Table 'Lacey' 6-max Seat #6 is the button
Seat 1: warioman ($26.47 in chips)
Seat 2: Player#5927 ($55.37 in chips)
Seat 3: Player#4351 ($34.59 in chips)
Seat 4: Player#6412 ($12.16 in chips)
Seat 5: Player#5258 ($48.99 in chips)
warioman: posts small blind $0.10
Player#5927: posts big blind $0.20
*** HOLE CARDS ***
Dealt to warioman [Td 8c]
Player#4351: raises $0.20 to $0.4
Player#6412: calls $0.40
Player#5258: calls $0.40
warioman: folds
Player#5927: calls $0.20
*** FLOP *** [7h 7c 7d]
Player#5927: checks
Player#4351: bets $0.80
Player#6412: calls $0.80
Player#5258: folds
Player#5927: folds
*** TURN *** [7h 7c 7d] [8h]
Player#4351: checks
Player#6412: bets $1.65
Player#4351: folds
Player#6412: doesn't show hand
Uncalled bet ($1.65) returned to Player#6412
Player#6412 collected $3.13 from pot
*** SUMMARY ***
Total Pot $3.30 | Rake $0.16
Board [7h 7c 7d 8h]
Seat 1: warioman (small blind) folded before the flop
Seat 2: Player#5927 (big blind) folded on the flop
Seat 3: Player#4351 folded on the turn
Seat 4: Player#6412 shows [] and won ($3.13) with 
Seat 5: Player#5258 folded on the flop

PokerStars Hand #efbee162-4730-43f5-8f11-ce96219fb7a2:  Hold'em No Limit ($0.1/$0.20 USD) - 2021/11/21 00:17:00 ET
Table 'Denver' 6-max Seat #6 is the button
Seat 1: Player#5012 ($20.00 in chips)
Seat 2: Player#6261 ($19.10 in chips)
Seat 3: Player#9416 ($32.17 in chips)
Seat 4: warioman ($36.24 in chips)
Seat 5: Player#9198 ($19.00 in chips)
Player#5012: posts small blind $0.10
Player#9416: posts big blind $0.20
*** HOLE CARDS ***
Dealt to warioman [9s Ac]
Player#5012 Waiting
Player#9198: folds
Player#6261: folds
Player#9416: folds
warioman collected $0.20 from pot
*** SUMMARY ***
Total Pot $0.20 | Rake $0.00
Seat 1: Player#5012 (small blind) mucked
Seat 2: Player#6261 folded before the flop
Seat 3: Player#9416 (big blind) folded before the flop
Seat 4: warioman
Seat 5: Player#9198 folded before the flop

PokerStars Hand #b8f625d7-ebf0-40ba-b783-526d6d9288d8:  Hold'em No Limit ($0.1/$0.20 USD) - 2021/11/21 00:17:00 ET
Table 'Denver' 6-max Seat #6 is the button
Seat 1: Player#3556 ($19.20 in chips)
Seat 2: Player#0757 ($32.37 in chips)
Seat 3: warioman ($36.24 in chips)
Seat 4: Player#7857 ($18.70 in chips)
Player#3556: posts small blind $0.10
Player#0757: posts big blind $0.20
*** HOLE CARDS ***
Dealt to warioman [6c Tc]
warioman: folds
Player#7857: raises $0.20 to $0.7
Player#3556: folds
Player#0757: folds
Player#7857: doesn't show hand
Uncalled bet ($0.70) returned to Player#7857
Player#7857 collected $0.30 from pot
*** SUMMARY ***
Total Pot $0.30 | Rake $0.00
Seat 1: Player#3556 (small blind) folded before the flop
Seat 2: Player#0757 (big blind) folded before the flop
Seat 3: warioman folded before the flop
Seat 4: Player#7857 shows [] and won ($0.30) with 

PokerStars Hand #1c350d19-bbe4-46d3-915f-2889a3e75353:  Hold'em No Limit ($0.1/$0.20 USD) - 2021/11/21 00:16:00 ET
Table 'Denver' 6-max Seat #3 is the button
Seat 1: Player#4872 ($19.10 in chips)
Seat 2: Player#2895 ($32.37 in chips)
Seat 3: warioman ($36.24 in chips)
Seat 4: Player#1354 ($18.80 in chips)
Player#1354: posts small blind $0.10
Player#4872: posts big blind $0.20
*** HOLE CARDS ***
Dealt to warioman [Qh 3h]
Player#2895: folds
warioman: folds
Player#1354: folds
Player#4872 collected $0.20 from pot
*** SUMMARY ***
Total Pot $0.20 | Rake $0.00
Seat 1: Player#4872 shows [] and won ($0.20) with 
Seat 2: Player#2895 folded before the flop
Seat 3: warioman (button) folded before the flop
Seat 4: Player#1354 (small blind) folded before the flop

PokerStars Hand #886a27fd-296c-453f-b4c4-943450ea3e1a:  Hold'em No Limit ($0.1/$0.20 USD) - 2021/11/21 00:16:00 ET
Table 'Lacey' 6-max Seat #4 is the button
Seat 1: warioman ($22.48 in chips)
Seat 2: Player#2015 ($59.69 in chips)
Seat 3: Player#3804 ($34.59 in chips)
Seat 4: Player#0683 ($12.16 in chips)
Seat 5: Player#2886 ($49.09 in chips)
Player#2886: posts small blind $0.10
warioman: posts big blind $0.20
*** HOLE CARDS ***
Dealt to warioman [Ks As]
Player#2015: raises $0.20 to $0.6
Player#3804: folds
Player#0683: folds
Player#2886: folds
warioman: raises $0.60 to $2.5
Player#2015: calls $1.90
*** FLOP *** [9c Kh 2h]
warioman: bets $1.82
Player#2015: calls $1.82
*** TURN *** [9c Kh 2h] [7h]
warioman: checks
Player#2015: checks
*** RIVER *** [9c Kh 2h] [7h] [7h]
warioman: checks
Player#2015: checks
*** SHOW DOWN *** 
warioman collected $8.30 from pot
*** SUMMARY ***
Total Pot $8.74 | Rake $0.44
Board [9c Kh 2h 7h 7h]
Seat 1: warioman (big blind)
Seat 2: Player#2015 mucked
Seat 3: Player#3804 folded before the flop
Seat 4: Player#0683 (button) folded before the flop
Seat 5: Player#2886 (small blind) folded before the flop

PokerStars Hand #09a422b8-66fb-4c98-9a8f-4eade57ab854:  Hold'em No Limit ($0.1/$0.20 USD) - 2021/11/21 00:16:00 ET
Table 'Lacey' 6-max Seat #3 is the button
Seat 1: warioman ($22.48 in chips)
Seat 2: Player#2597 ($59.69 in chips)
Seat 3: Player#4872 ($34.59 in chips)
Seat 4: Player#6231 ($12.26 in chips)
Seat 5: Player#4231 ($48.99 in chips)
Player#6231: posts small blind $0.10
Player#4231: posts big blind $0.20
*** HOLE CARDS ***
Dealt to warioman [Jd 4d]
warioman: folds
Player#2597: folds
Player#4872: folds
Player#6231: folds
Player#4231 collected $0.20 from pot
*** SUMMARY ***
Total Pot $0.20 | Rake $0.00
Seat 1: warioman folded before the flop
Seat 2: Player#2597 folded before the flop
Seat 3: Player#4872 (button) folded before the flop
Seat 4: Player#6231 (small blind) folded before the flop
Seat 5: Player#4231 shows [] and won ($0.20) with 

PokerStars Hand #b537318b-9b8a-4d43-a295-ca6f73ec415e:  Hold'em No Limit ($0.1/$0.20 USD) - 2021/11/21 00:16:00 ET
Table 'Denver' 6-max Seat #2 is the button
Seat 1: Player#1671 ($18.80 in chips)
Seat 2: Player#8233 ($32.37 in chips)
Seat 3: warioman ($36.34 in chips)
Seat 4: Player#1176 ($19.00 in chips)
warioman: posts small blind $0.10
Player#1176: posts big blind $0.20
*** HOLE CARDS ***
Dealt to warioman [6h Ac]
Player#1671: raises $0.20 to $1.2
Player#8233: folds
warioman: folds
Player#1176: folds
Player#1671: doesn't show hand
Uncalled bet ($1.20) returned to Player#1671
Player#1671 collected $0.30 from pot
*** SUMMARY ***
Total Pot $0.30 | Rake $0.00
Seat 1: Player#1671 shows [] and won ($0.30) with 
Seat 2: Player#8233 (button) folded before the flop
Seat 3: warioman (small blind) folded before the flop
Seat 4: Player#1176 (big blind) folded before the flop

PokerStars Hand #f76a493d-0093-46d0-975f-30ea5e50aa9d:  Hold'em No Limit ($0.1/$0.20 USD) - 2021/11/21 00:15:00 ET
Table 'Denver' 6-max Seat #1 is the button
Seat 1: Player#4626 ($18.80 in chips)
Seat 2: Player#3270 ($30.29 in chips)
Seat 3: warioman ($36.54 in chips)
Seat 4: Player#2941 ($21.10 in chips)
Player#3270: posts small blind $0.10
warioman: posts big blind $0.20
*** HOLE CARDS ***
Dealt to warioman [7h 2d]
Player#2941: raises $0.20 to $0.7
Player#4626: folds
Player#3270: calls $0.60
warioman: folds
*** FLOP *** [Ts Qh 9h]
Player#3270: checks
Player#2941: bets $0.60
Player#3270: calls $0.60
*** TURN *** [Ts Qh 9h] [4d]
Player#3270: checks
Player#2941: bets $0.80
Player#3270: calls $0.80
*** RIVER *** [Ts Qh 9h] [4d] [2d]
Player#3270: checks
Player#2941: checks
*** SHOW DOWN *** 
Player#3270 collected $4.18 from pot
*** SUMMARY ***
Total Pot $4.40 | Rake $0.22
Board [Ts Qh 9h 4d 2d]
Seat 1: Player#4626 (button) folded before the flop
Seat 2: Player#3270 shows [Ks Qc] and won ($4.18) with 
Seat 3: warioman (big blind) folded before the flop
Seat 4: Player#2941 mucked

PokerStars Hand #100b4299-0844-48d4-aa0c-aaf103448a78:  Hold'em No Limit ($0.1/$0.20 USD) - 2021/11/21 00:15:00 ET
Table 'Lacey' 6-max Seat #3 is the button
Seat 1: warioman ($22.48 in chips)
Seat 2: Player#5309 ($19.50 in chips)
Seat 3: Player#0204 ($59.69 in chips)
Seat 4: Player#9642 ($30.63 in chips)
Seat 5: Player#8948 ($16.66 in chips)
Seat 6: Player#0160 ($48.99 in chips)
Player#9642: posts small blind $0.10
Player#8948: posts big blind $0.20
*** HOLE CARDS ***
Dealt to warioman [6d Td]
Player#0160: folds
warioman: folds
Player#5309: folds
Player#0204: folds
Player#9642: raises $0.20 to $0.6
Player#8948: calls $0.40
*** FLOP *** [Ks 4c Qs]
Player#9642: bets $0.60
Player#8948: calls $0.60
*** TURN *** [Ks 4c Qs] [5c]
Player#9642: bets $1.00
Player#8948: calls $1.00
*** RIVER *** [Ks 4c Qs] [5c] [3c]
Player#9642: bets $2.20
Player#8948: calls $2.20
*** SHOW DOWN *** 
Player#8948: doesn't show hand
Player#9642 collected $8.36 from pot
*** SUMMARY ***
Total Pot $8.80 | Rake $0.44
Board [Ks 4c Qs 5c 3c]
Seat 1: warioman folded before the flop
Seat 2: Player#5309 folded before the flop
Seat 3: Player#0204 (button) folded before the flop
Seat 4: Player#9642 shows [2s 7s] and won ($8.36) with 
Seat 5: Player#8948 (big blind) mucked
Seat 6: Player#0160 folded before the flop

PokerStars Hand #59738e90-d8c5-402e-9136-a9407d4a6f40:  Hold'em No Limit ($0.1/$0.20 USD) - 2021/11/21 00:15:00 ET
Table 'Denver' 6-max Seat #1 is the button
Seat 1: Player#8024 ($11.01 in chips)
Seat 2: Player#5595 ($18.90 in chips)
Seat 3: Player#7552 ($20.00 in chips)
Seat 4: warioman ($36.54 in chips)
Seat 5: Player#7932 ($21.40 in chips)
Player#5595: posts small blind $0.10
Player#7552: posts big blind $0.20
*** HOLE CARDS ***
Dealt to warioman [7h Qs]
Player#7932 BB + Dead Small 0.3
warioman: folds
Player#7932: checks
Player#8024: raises $ 10.20 to $11.01
Player#5595: folds
Player#7552: calls $10.81
Player#7932: folds
Player#7552 Showing Pocket Cards 88
Player#8024 Showing Pocket Cards 72
*** FLOP *** [5h Ts Td]
*** TURN *** [5h Ts Td] [Kc]
*** RIVER *** [5h Ts Td] [Kc] [4h]
Player#7552 collected $21.01 from pot
*** SUMMARY ***
Total Pot $22.12 | Rake $1.11
Board [5h Ts Td Kc 4h]
Seat 1: Player#8024 (button) mucked
Seat 2: Player#5595 (small blind) folded before the flop
Seat 3: Player#7552 shows [8h 8s] and won ($21.01) with 
Seat 4: warioman folded before the flop
Seat 5: Player#7932 folded before the flop

PokerStars Hand #25527236-f691-4483-9896-0f53aaae86a1:  Hold'em No Limit ($0.1/$0.20 USD) - 2021/11/21 00:14:00 ET
Table 'Denver' 6-max Seat #6 is the button
Seat 1: Player#6090 ($11.11 in chips)
Seat 2: Player#2875 ($19.10 in chips)
Seat 3: Player#7355 ($20.00 in chips)
Seat 4: warioman ($36.24 in chips)
Seat 5: Player#1686 ($21.40 in chips)
Player#6090: posts small blind $0.10
Player#2875: posts big blind $0.20
*** HOLE CARDS ***
Dealt to warioman [6d 7d]
Player#7355: folds
warioman: raises $0.20 to $0.5
Player#6090: folds
Player#2875: folds
warioman: doesn't show hand
Uncalled bet ($0.50) returned to warioman
warioman collected $0.30 from pot
*** SUMMARY ***
Total Pot $0.30 | Rake $0.00
Seat 1: Player#6090 (small blind) folded before the flop
Seat 2: Player#2875 (big blind) folded before the flop
Seat 3: Player#7355 folded before the flop
Seat 4: warioman
Seat 5: Player#1686 mucked

PokerStars Hand #b67c3cd2-d38c-4785-ae95-349596b1c54a:  Hold'em No Limit ($0.1/$0.20 USD) - 2021/11/21 00:14:00 ET
Table 'Lacey' 6-max Seat #2 is the button
Seat 1: warioman ($20.72 in chips)
Seat 2: Player#9226 ($20.71 in chips)
Seat 3: Player#8771 ($60.19 in chips)
Seat 4: Player#7847 ($30.83 in chips)
Seat 5: Player#6329 ($16.66 in chips)
Seat 6: Player#1573 ($48.99 in chips)
Player#8771: posts small blind $0.10
Player#7847: posts big blind $0.20
*** HOLE CARDS ***
Dealt to warioman [5h Qh]
Player#6329: folds
Player#1573: folds
warioman: raises $0.20 to $0.5
Player#9226: calls $0.50
Player#8771: calls $0.40
Player#7847: folds
*** FLOP *** [4c Ah Jd]
Player#8771: checks
warioman: bets $0.71
Player#9226: calls $0.71
Player#8771: folds
*** TURN *** [4c Ah Jd] [7h]
warioman: bets $2.54
Player#9226: folds
warioman: doesn't show hand
Uncalled bet ($2.54) returned to warioman
warioman collected $2.96 from pot
*** SUMMARY ***
Total Pot $3.12 | Rake $0.16
Board [4c Ah Jd 7h]
Seat 1: warioman
Seat 2: Player#9226 (button) folded on the turn
Seat 3: Player#8771 (small blind) folded on the flop
Seat 4: Player#7847 (big blind) folded before the flop
Seat 5: Player#6329 folded before the flop
Seat 6: Player#1573 folded before the flop

PokerStars Hand #71eee160-177d-4ca4-bbcd-2120ebe86665:  Hold'em No Limit ($0.1/$0.20 USD) - 2021/11/21 00:14:00 ET
Table 'Denver' 6-max Seat #3 is the button
Seat 1: Player#1641 ($11.71 in chips)
Seat 2: Player#7984 ($19.10 in chips)
Seat 3: Player#5522 ($20.00 in chips)
Seat 4: warioman ($35.70 in chips)
warioman: posts small blind $0.10
Player#1641: posts big blind $0.20
*** HOLE CARDS ***
Dealt to warioman [Ts As]
Player#7984: folds
Player#5522: folds
warioman: raises $0.20 to $0.6
Player#1641: calls $0.40
*** FLOP *** [4s 9c 7c]
warioman: bets $0.36
Player#1641: folds
warioman: doesn't show hand
Uncalled bet ($0.36) returned to warioman
warioman collected $1.14 from pot
*** SUMMARY ***
Total Pot $1.20 | Rake $0.06
Board [4s 9c 7c]
Seat 1: Player#1641 (big blind) folded on the flop
Seat 2: Player#7984 folded before the flop
Seat 3: Player#5522 (button) folded before the flop
Seat 4: warioman (small blind)

PokerStars Hand #7a16df3c-14d5-43c7-9b6b-140b220d0c81:  Hold'em No Limit ($0.1/$0.20 USD) - 2021/11/21 00:13:00 ET
Table 'Denver' 6-max Seat #2 is the button
Seat 1: Player#3197 ($11.71 in chips)
Seat 2: Player#2443 ($18.80 in chips)
Seat 3: Player#4350 ($20.10 in chips)
Seat 4: warioman ($35.90 in chips)
Seat 5: Player#5716 ($21.40 in chips)
Player#4350: posts small blind $0.10
warioman: posts big blind $0.20
*** HOLE CARDS ***
Dealt to warioman [Kc Ts]
Player#5716: folds
Player#3197: folds
Player#2443: raises $0.20 to $1.2
Player#4350: folds
warioman: folds
Player#2443: doesn't show hand
Uncalled bet ($1.20) returned to Player#2443
Player#2443 collected $0.30 from pot
*** SUMMARY ***
Total Pot $0.30 | Rake $0.00
Seat 1: Player#3197 folded before the flop
Seat 2: Player#2443 shows [] and won ($0.30) with 
Seat 3: Player#4350 (small blind) folded before the flop
Seat 4: warioman (big blind) folded before the flop
Seat 5: Player#5716 folded before the flop

PokerStars Hand #208f028e-93a5-4b85-8db9-ff7dad275b81:  Hold'em No Limit ($0.1/$0.20 USD) - 2021/11/21 00:13:00 ET
Table 'Denver' 6-max Seat #1 is the button
Seat 1: Player#1200 ($11.71 in chips)
Seat 2: Player#4283 ($18.90 in chips)
Seat 3: Player#8135 ($20.00 in chips)
Seat 4: warioman ($35.90 in chips)
Seat 5: Player#4537 ($21.40 in chips)
Player#4283: posts small blind $0.10
Player#8135: posts big blind $0.20
*** HOLE CARDS ***
Dealt to warioman [Jd 6h]
warioman: folds
Player#4537: folds
Player#1200: folds
Player#4283: folds
Player#8135 collected $0.20 from pot
*** SUMMARY ***
Total Pot $0.20 | Rake $0.00
Seat 1: Player#1200 (button) folded before the flop
Seat 2: Player#4283 (small blind) folded before the flop
Seat 3: Player#8135 shows [] and won ($0.20) with 
Seat 4: warioman folded before the flop
Seat 5: Player#4537 folded before the flop

PokerStars Hand #7769bda9-86e0-4d6d-bfa5-8825d504e12b:  Hold'em No Limit ($0.1/$0.20 USD) - 2021/11/21 00:13:00 ET
Table 'Lacey' 6-max Seat #1 is the button
Seat 1: warioman ($20.72 in chips)
Seat 2: Player#3878 ($20.80 in chips)
Seat 3: Player#8326 ($60.28 in chips)
Seat 4: Player#3457 ($30.83 in chips)
Seat 5: Player#2503 ($16.66 in chips)
Seat 6: Player#6308 ($48.99 in chips)
Player#3878: posts small blind $0.10
Player#8326: posts big blind $0.20
*** HOLE CARDS ***
Dealt to warioman [7s 4c]
Player#3457: folds
Player#2503: folds
Player#6308: folds
warioman: folds
Player#3878: calls $0.10
Player#8326: checks
*** FLOP *** [Tc 9d Kd]
Player#3878: checks
Player#8326: bets $0.60
Player#3878: calls $0.60
*** TURN *** [Tc 9d Kd] [Qs]
Player#3878: checks
Player#8326: bets $1.00
Player#3878: calls $1.00
*** RIVER *** [Tc 9d Kd] [Qs] [4s]
Player#3878: checks
Player#8326: checks
*** SHOW DOWN *** 
 *** SUMMARY ***
Total Pot $3.60 | Rake $0.18
Board [Tc 9d Kd Qs 4s]
Seat 1: warioman (button) folded before the flop
Seat 2: Player#3878 (small blind) mucked
Seat 3: Player#8326 (big blind) mucked
Seat 4: Player#3457 folded before the flop
Seat 5: Player#2503 folded before the flop
Seat 6: Player#6308 folded before the flop

PokerStars Hand #d1f3f20d-28c5-4ee7-acfc-bed2f6cd824c:  Hold'em No Limit ($0.1/$0.20 USD) - 2021/11/21 00:13:00 ET
Table 'Lacey' 6-max Seat #6 is the button
Seat 1: warioman ($20.82 in chips)
Seat 2: Player#6002 ($20.70 in chips)
Seat 3: Player#9445 ($60.28 in chips)
Seat 4: Player#5178 ($30.83 in chips)
Seat 5: Player#2653 ($16.66 in chips)
Seat 6: Player#6164 ($48.99 in chips)
warioman: posts small blind $0.10
Player#6002: posts big blind $0.20
*** HOLE CARDS ***
Dealt to warioman [Ts 5d]
Player#9445: folds
Player#5178: folds
Player#2653: folds
Player#6164: folds
warioman: folds
Player#6002 collected $0.20 from pot
*** SUMMARY ***
Total Pot $0.20 | Rake $0.00
Seat 1: warioman (small blind) folded before the flop
Seat 2: Player#6002 shows [] and won ($0.20) with 
Seat 3: Player#9445 folded before the flop
Seat 4: Player#5178 folded before the flop
Seat 5: Player#2653 folded before the flop
Seat 6: Player#6164 (button) folded before the flop

PokerStars Hand #8c63816c-d76c-486f-80b3-557b4d371c85:  Hold'em No Limit ($0.1/$0.20 USD) - 2021/11/21 00:12:00 ET
Table 'Denver' 6-max Seat #6 is the button
Seat 1: Player#3055 ($10.81 in chips)
Seat 2: Player#6387 ($19.10 in chips)
Seat 3: Player#3752 ($20.00 in chips)
Seat 4: warioman ($35.90 in chips)
Seat 5: Player#3516 ($22.10 in chips)
Player#3055: posts small blind $0.10
Player#6387: posts big blind $0.20
*** HOLE CARDS ***
Dealt to warioman [4c 8h]
Player#3752: folds
warioman: folds
Player#3516: raises $0.20 to $0.7
Player#3055: raises $0.70 to $2.3
Player#6387: folds
Player#3516: folds
Player#3055: doesn't show hand
Uncalled bet ($2.30) returned to Player#3055
Player#3055 collected $0.90 from pot
*** SUMMARY ***
Total Pot $0.90 | Rake $0.00
Seat 1: Player#3055 shows [] and won ($0.90) with 
Seat 2: Player#6387 (big blind) folded before the flop
Seat 3: Player#3752 folded before the flop
Seat 4: warioman folded before the flop
Seat 5: Player#3516 folded before the flop

PokerStars Hand #24486980-56e7-4269-95e1-4a476fff0474:  Hold'em No Limit ($0.1/$0.20 USD) - 2021/11/21 00:12:00 ET
Table 'Denver' 6-max Seat #4 is the button
Seat 1: Player#7362 ($11.01 in chips)
Seat 2: Player#6701 ($20.30 in chips)
Seat 3: Player#0365 ($19.18 in chips)
Seat 4: warioman ($35.90 in chips)
Seat 5: Player#9790 ($20.40 in chips)
Player#9790: posts small blind $0.10
Player#7362: posts big blind $0.20
*** HOLE CARDS ***
Dealt to warioman [7h 2d]
Player#0365 BB + Dead Small 0.3
Player#6701: raises $0.20 to $1.2
Player#0365: folds
warioman: folds
Player#9790: raises $1.20 to $5.2
Player#7362: folds
Player#6701: folds
Player#9790: doesn't show hand
Uncalled bet ($5.20) returned to Player#9790
Player#9790 collected $1.40 from pot
*** SUMMARY ***
Total Pot $1.40 | Rake $0.00
Seat 1: Player#7362 (big blind) folded before the flop
Seat 2: Player#6701 folded before the flop
Seat 3: Player#0365 folded before the flop
Seat 4: warioman (button) folded before the flop
Seat 5: Player#9790 shows [] and won ($1.40) with 

PokerStars Hand #41579ac5-c8e3-4d53-afb6-e1b41e7a995d:  Hold'em No Limit ($0.1/$0.20 USD) - 2021/11/21 00:12:00 ET
Table 'Denver' 6-max Seat #3 is the button
Seat 1: Player#1063 ($11.01 in chips)
Seat 2: Player#7923 ($20.00 in chips)
Seat 3: Player#2450 ($19.18 in chips)
Seat 4: warioman ($36.00 in chips)
Seat 5: Player#9333 ($20.60 in chips)
warioman: posts small blind $0.10
Player#9333: posts big blind $0.20
*** HOLE CARDS ***
Dealt to warioman [Ac 7h]
Player#1063: folds
Player#7923: raises $0.20 to $1.2
warioman: folds
Player#9333: folds
Player#7923: doesn't show hand
Uncalled bet ($1.20) returned to Player#7923
Player#7923 collected $0.30 from pot
*** SUMMARY ***
Total Pot $0.30 | Rake $0.00
Seat 1: Player#1063 folded before the flop
Seat 2: Player#7923 shows [] and won ($0.30) with 
Seat 3: Player#2450 (button) mucked
Seat 4: warioman (small blind) folded before the flop
Seat 5: Player#9333 (big blind) folded before the flop

PokerStars Hand #31ab2ea2-8c75-4037-81d7-180b2eae18e4:  Hold'em No Limit ($0.1/$0.20 USD) - 2021/11/21 00:12:00 ET
Table 'Lacey' 6-max Seat #5 is the button
Seat 1: warioman ($21.02 in chips)
Seat 2: Player#5919 ($21.50 in chips)
Seat 3: Player#2667 ($60.28 in chips)
Seat 4: Player#6868 ($29.73 in chips)
Seat 5: Player#3685 ($16.66 in chips)
Seat 6: Player#6560 ($49.19 in chips)
Player#6560: posts small blind $0.10
warioman: posts big blind $0.20
*** HOLE CARDS ***
Dealt to warioman [7h 2d]
Player#5919: calls $0.20
Player#2667: folds
Player#6868: calls $0.20
Player#3685: folds
Player#6560: calls $0.10
warioman: checks
*** FLOP *** [As 9s Jd]
Player#6560: checks
warioman: checks
Player#5919: checks
Player#6868: bets $0.60
Player#6560: folds
warioman: folds
Player#5919: calls $0.60
*** TURN *** [As 9s Jd] [Kh]
Player#5919: checks
Player#6868: bets $1.00
Player#5919: folds
Player#6868: doesn't show hand
Uncalled bet ($1.00) returned to Player#6868
Player#6868 collected $1.90 from pot
*** SUMMARY ***
Total Pot $2.00 | Rake $0.10
Board [As 9s Jd Kh]
Seat 1: warioman (big blind) folded on the flop
Seat 2: Player#5919 folded on the turn
Seat 3: Player#2667 folded before the flop
Seat 4: Player#6868 shows [] and won ($1.90) with 
Seat 5: Player#3685 (button) folded before the flop
Seat 6: Player#6560 (small blind) folded on the flop

PokerStars Hand #f289ff99-cc04-490f-a845-d07ff4e304dd:  Hold'em No Limit ($0.1/$0.20 USD) - 2021/11/21 00:11:00 ET
Table 'Denver' 6-max Seat #1 is the button
Seat 1: Player#7690 ($11.01 in chips)
Seat 2: Player#1897 ($8.96 in chips)
Seat 3: warioman ($36.20 in chips)
Seat 4: Player#5608 ($20.30 in chips)
Player#1897: posts small blind $0.10
warioman: posts big blind $0.20
*** HOLE CARDS ***
Dealt to warioman [3h Ks]
Player#5608: raises $0.20 to $0.7
Player#7690: folds
Player#1897: folds
warioman: folds
Player#5608: doesn't show hand
Uncalled bet ($0.70) returned to Player#5608
Player#5608 collected $0.30 from pot
*** SUMMARY ***
Total Pot $0.30 | Rake $0.00
Seat 1: Player#7690 (button) folded before the flop
Seat 2: Player#1897 (small blind) folded before the flop
Seat 3: warioman (big blind) folded before the flop
Seat 4: Player#5608 shows [] and won ($0.30) with 

PokerStars Hand #695c5953-7492-4330-8b15-a692f215b1bc:  Hold'em No Limit ($0.1/$0.20 USD) - 2021/11/21 00:11:00 ET
Table 'Lacey' 6-max Seat #4 is the button
Seat 1: warioman ($21.02 in chips)
Seat 2: Player#6409 ($21.50 in chips)
Seat 3: Player#5150 ($60.28 in chips)
Seat 4: Player#4807 ($30.98 in chips)
Seat 5: Player#8431 ($16.76 in chips)
Seat 6: Player#7243 ($47.97 in chips)
Player#8431: posts small blind $0.10
Player#7243: posts big blind $0.20
*** HOLE CARDS ***
Dealt to warioman [8c Kh]
warioman: folds
Player#6409: folds
Player#5150: folds
Player#4807: raises $0.20 to $0.4
Player#8431: folds
Player#7243: raises $0.40 to $1.25
Player#4807: calls $0.85
*** FLOP *** [Jc 8s Tc]
Player#7243: bets $1.59
Player#4807: folds
Player#7243: doesn't show hand
Uncalled bet ($1.59) returned to Player#7243
Player#7243 collected $2.47 from pot
*** SUMMARY ***
Total Pot $2.60 | Rake $0.13
Board [Jc 8s Tc]
Seat 1: warioman folded before the flop
Seat 2: Player#6409 folded before the flop
Seat 3: Player#5150 folded before the flop
Seat 4: Player#4807 (button) folded on the flop
Seat 5: Player#8431 (small blind) folded before the flop
Seat 6: Player#7243 shows [] and won ($2.47) with 

PokerStars Hand #4a92072c-5cbe-4b60-9532-4d5d9f769052:  Hold'em No Limit ($0.1/$0.20 USD) - 2021/11/21 00:10:00 ET
Table 'Denver' 6-max Seat #4 is the button
Seat 1: Player#3352 ($11.11 in chips)
Seat 2: Player#5283 ($27.96 in chips)
Seat 3: Player#9068 ($19.18 in chips)
Seat 4: warioman ($19.00 in chips)
Seat 5: Player#7836 ($10.55 in chips)
Seat 6: Player#5277 ($20.30 in chips)
Player#7836: posts small blind $0.10
Player#3352: posts big blind $0.20
*** HOLE CARDS ***
Dealt to warioman [7h 9h]
Player#7836 Waiting
Player#9068: folds
warioman: raises $0.20 to $0.5
Player#5277: folds
Player#3352: folds
Player#5283: calls $0.30
*** FLOP *** [6s 8s Th]
Player#5283: bets $0.55
warioman: raises $0.55 to $1.5
Player#5283: calls $0.95
*** TURN *** [6s 8s Th] [2d]
Player#5283: bets $8.20
warioman: raises8.20 to $17
Player#5283: calls $8.80
Player#5283 Showing Pocket Cards TQ
warioman Showing Pocket Cards 79
*** RIVER *** [6s 8s Th] [2d] [Ah]
warioman collected $36.60 from pot
*** SUMMARY ***
Total Pot $38.10 | Rake $1.50
Board [6s 8s Th 2d Ah]
Seat 1: Player#3352 (big blind) folded before the flop
Seat 2: Player#5283 mucked
Seat 3: Player#9068 folded before the flop
Seat 4: warioman (button)
Seat 5: Player#7836 (small blind) mucked
Seat 6: Player#5277 folded before the flop

PokerStars Hand #10534208-dbce-4de1-bd78-6a9d61afc92b:  Hold'em No Limit ($0.1/$0.20 USD) - 2021/11/21 00:10:00 ET
Table 'Lacey' 6-max Seat #3 is the button
Seat 1: warioman ($19.90 in chips)
Seat 2: Player#2627 ($22.00 in chips)
Seat 3: Player#6141 ($60.28 in chips)
Seat 4: Player#3591 ($31.48 in chips)
Seat 5: Player#8573 ($16.96 in chips)
Seat 6: Player#1617 ($47.97 in chips)
Player#3591: posts small blind $0.10
Player#8573: posts big blind $0.20
*** HOLE CARDS ***
Dealt to warioman [Ac Ks]
Player#1617: folds
warioman: raises $0.20 to $0.5
Player#2627: calls $0.50
Player#6141: folds
Player#3591: calls $0.40
Player#8573: folds
*** FLOP *** [Ad 2h Qh]
Player#3591: checks
warioman: bets $0.51
Player#2627: folds
Player#3591: folds
warioman: doesn't show hand
Uncalled bet ($0.51) returned to warioman
warioman collected $1.61 from pot
*** SUMMARY ***
Total Pot $1.70 | Rake $0.09
Board [Ad 2h Qh]
Seat 1: warioman
Seat 2: Player#2627 folded on the flop
Seat 3: Player#6141 (button) folded before the flop
Seat 4: Player#3591 (small blind) folded on the flop
Seat 5: Player#8573 (big blind) folded before the flop
Seat 6: Player#1617 folded before the flop

PokerStars Hand #c922ecfc-7ba2-4807-aec7-b6ef226fb932:  Hold'em No Limit ($0.1/$0.20 USD) - 2021/11/21 00:10:00 ET
Table 'Denver' 6-max Seat #4 is the button
Seat 1: Player#9859 ($10.41 in chips)
Seat 2: Player#1440 ($28.56 in chips)
Seat 3: Player#9245 ($19.18 in chips)
Seat 4: warioman ($19.00 in chips)
Seat 5: Player#3468 ($20.40 in chips)
Player#3468: posts small blind $0.10
Player#9859: posts big blind $0.20
*** HOLE CARDS ***
Dealt to warioman [5d Qc]
Player#1440: raises $0.20 to $0.6
Player#9245: folds
warioman: folds
Player#3468: folds
Player#9859: raises $ 10.60 to $10.41
Player#1440: folds
Player#9859: doesn't show hand
Uncalled bet ($10.41) returned to Player#9859
Player#9859 collected $0.70 from pot
*** SUMMARY ***
Total Pot $0.70 | Rake $0.00
Seat 1: Player#9859 shows [] and won ($0.70) with 
Seat 2: Player#1440 folded before the flop
Seat 3: Player#9245 folded before the flop
Seat 4: warioman (button) folded before the flop
Seat 5: Player#3468 (small blind) folded before the flop

PokerStars Hand #ee272ac6-eff9-4d59-ba76-481e5db0e300:  Hold'em No Limit ($0.1/$0.20 USD) - 2021/11/21 00:09:00 ET
Table 'Denver' 6-max Seat #3 is the button
Seat 1: Player#8895 ($10.41 in chips)
Seat 2: Player#6309 ($28.56 in chips)
Seat 3: Player#0035 ($19.18 in chips)
Seat 4: warioman ($20.00 in chips)
Seat 5: Player#0265 ($19.50 in chips)
warioman: posts small blind $0.10
Player#0265: posts big blind $0.20
*** HOLE CARDS ***
Dealt to warioman [6d Ah]
Player#8895: folds
Player#6309: folds
Player#0035: folds
warioman: raises $0.20 to $0.6
Player#0265: calls $0.40
*** FLOP *** [2c Jh 2d]
warioman: checks
Player#0265: bets $0.40
warioman: calls $0.40
*** TURN *** [2c Jh 2d] [Td]
warioman: checks
Player#0265: bets $1.00
warioman: folds
Player#0265: doesn't show hand
Uncalled bet ($1.00) returned to Player#0265
Player#0265 collected $1.90 from pot
*** SUMMARY ***
Total Pot $2.00 | Rake $0.10
Board [2c Jh 2d Td]
Seat 1: Player#8895 folded before the flop
Seat 2: Player#6309 folded before the flop
Seat 3: Player#0035 (button) folded before the flop
Seat 4: warioman (small blind) folded on the turn
Seat 5: Player#0265 shows [] and won ($1.90) with 

PokerStars Hand #47b6ab58-9d63-4d34-9952-9f848bf17f9e:  Hold'em No Limit ($0.1/$0.20 USD) - 2021/11/21 00:09:00 ET
Table 'Lacey' 6-max Seat #2 is the button
Seat 1: warioman ($19.90 in chips)
Seat 2: Player#7448 ($20.45 in chips)
Seat 3: Player#8273 ($60.38 in chips)
Seat 4: Player#3390 ($31.68 in chips)
Seat 5: Player#6742 ($18.36 in chips)
Seat 6: Player#9691 ($47.97 in chips)
Player#8273: posts small blind $0.10
Player#3390: posts big blind $0.20
*** HOLE CARDS ***
Dealt to warioman [6d 7h]
Player#6742: calls $0.20
Player#9691: folds
warioman: folds
Player#7448: calls $0.20
Player#8273: folds
Player#3390: checks
*** FLOP *** [4d 5s Ad]
Player#3390: checks
Player#6742: checks
Player#7448: bets $0.40
Player#3390: folds
Player#6742: calls $0.40
*** TURN *** [4d 5s Ad] [Ah]
Player#6742: checks
Player#7448: checks
*** RIVER *** [4d 5s Ad] [Ah] [Jh]
Player#6742: bets $0.80
Player#7448: raises $0.80 to $1.6
Player#6742: folds
Player#7448: doesn't show hand
Uncalled bet ($1.60) returned to Player#7448
Player#7448 collected $2.19 from pot
*** SUMMARY ***
Total Pot $2.30 | Rake $0.12
Board [4d 5s Ad Ah Jh]
Seat 1: warioman folded before the flop
Seat 2: Player#7448 shows [] and won ($2.19) with 
Seat 3: Player#8273 (small blind) folded before the flop
Seat 4: Player#3390 (big blind) folded on the flop
Seat 5: Player#6742 folded on the river
Seat 6: Player#9691 folded before the flop

PokerStars Hand #6ab1dac8-5ab8-4fa1-8d8c-8c068b050108:  Hold'em No Limit ($0.1/$0.20 USD) - 2021/11/21 00:08:00 ET
Table 'Lacey' 6-max Seat #1 is the button
Seat 1: warioman ($19.90 in chips)
Seat 2: Player#2970 ($20.55 in chips)
Seat 3: Player#3231 ($56.82 in chips)
Seat 4: Player#4527 ($31.68 in chips)
Seat 5: Player#7759 ($22.21 in chips)
Seat 6: Player#2138 ($47.97 in chips)
Player#2970: posts small blind $0.10
Player#3231: posts big blind $0.20
*** HOLE CARDS ***
Dealt to warioman [9d 5c]
Player#4527: folds
Player#7759: raises $0.20 to $0.6
Player#2138: folds
warioman: folds
Player#2970: folds
Player#3231: calls $0.40
*** FLOP *** [Td 8h 4h]
Player#3231: checks
Player#7759: bets $0.65
Player#3231: calls $0.65
*** TURN *** [Td 8h 4h] [Qh]
Player#3231: checks
Player#7759: checks
*** RIVER *** [Td 8h 4h] [Qh] [5h]
Player#3231: bets $2.60
Player#7759: calls $2.60
*** SHOW DOWN *** 
Player#7759: doesn't show hand
Player#3231 collected $7.41 from pot
*** SUMMARY ***
Total Pot $7.80 | Rake $0.39
Board [Td 8h 4h Qh 5h]
Seat 1: warioman (button) folded before the flop
Seat 2: Player#2970 (small blind) folded before the flop
Seat 3: Player#3231 shows [4s 5s] and won ($7.41) with 
Seat 4: Player#4527 folded before the flop
Seat 5: Player#7759 mucked
Seat 6: Player#2138 folded before the flop

PokerStars Hand #006a8521-4c7d-4871-b209-65bc412d9e0f:  Hold'em No Limit ($0.1/$0.20 USD) - 2021/11/21 00:08:00 ET
Table 'Denver' 6-max Seat #2 is the button
Seat 1: Player#2600 ($18.76 in chips)
Seat 2: Player#8937 ($20.76 in chips)
Seat 3: Player#1923 ($19.28 in chips)
Seat 4: warioman ($19.00 in chips)
Seat 5: Player#6666 ($19.50 in chips)
Player#1923: posts small blind $0.10
warioman: posts big blind $0.20
*** HOLE CARDS ***
Dealt to warioman [8h 9c]
Player#6666: folds
Player#2600: raises $0.20 to $0.7
Player#8937: calls $0.70
Player#1923: folds
warioman: folds
*** FLOP *** [3d 5h Jd]
Player#2600: bets $0.85
Player#8937: calls $0.85
*** TURN *** [3d 5h Jd] [5c]
Player#2600: bets $1.70
Player#8937: calls $1.70
*** RIVER *** [3d 5h Jd] [5c] [Ac]
Player#2600: bets $5.10
Player#8937: raises $ 15.10 to $16.58
Player#2600: folds
Player#8937: doesn't show hand
Uncalled bet ($16.58) returned to Player#8937
Player#8937 collected $11.30 from pot
*** SUMMARY ***
Total Pot $11.90 | Rake $0.59
Board [3d 5h Jd 5c Ac]
Seat 1: Player#2600 folded on the river
Seat 2: Player#8937 shows [] and won ($11.30) with 
Seat 3: Player#1923 (small blind) folded before the flop
Seat 4: warioman (big blind) folded before the flop
Seat 5: Player#6666 folded before the flop

PokerStars Hand #bdc8f697-a515-4468-bfb4-4f01d7b8493f:  Hold'em No Limit ($0.1/$0.20 USD) - 2021/11/21 00:08:00 ET
Table 'Denver' 6-max Seat #1 is the button
Seat 1: Player#2415 ($18.76 in chips)
Seat 2: Player#0220 ($20.86 in chips)
Seat 3: Player#5351 ($19.18 in chips)
Seat 4: warioman ($19.00 in chips)
Seat 5: Player#1450 ($45.43 in chips)
Seat 6: Player#0334 ($19.50 in chips)
Player#0220: posts small blind $0.10
Player#5351: posts big blind $0.20
*** HOLE CARDS ***
Dealt to warioman [Tc Kd]
warioman: folds
Player#1450: folds
Player#0334: folds
Player#2415: folds
Player#0220: folds
Player#5351 collected $0.20 from pot
*** SUMMARY ***
Total Pot $0.20 | Rake $0.00
Seat 1: Player#2415 (button) folded before the flop
Seat 2: Player#0220 (small blind) folded before the flop
Seat 3: Player#5351 shows [] and won ($0.20) with 
Seat 4: warioman folded before the flop
Seat 5: Player#1450 folded before the flop
Seat 6: Player#0334 folded before the flop

PokerStars Hand #af9d41b4-9540-4b5b-852e-91a7ea255af7:  Hold'em No Limit ($0.1/$0.20 USD) - 2021/11/21 00:07:00 ET
Table 'Denver' 6-max Seat #6 is the button
Seat 1: Player#8046 ($18.86 in chips)
Seat 2: Player#2036 ($19.68 in chips)
Seat 3: Player#7870 ($19.18 in chips)
Seat 4: warioman ($19.00 in chips)
Seat 5: Player#3387 ($46.63 in chips)
Seat 6: Player#5178 ($19.50 in chips)
Player#8046: posts small blind $0.10
Player#2036: posts big blind $0.20
*** HOLE CARDS ***
Dealt to warioman [Ad 2c]
Player#7870: folds
warioman: folds
Player#3387: raises $0.20 to $0.6
Player#5178: folds
Player#8046: folds
Player#2036: raises $0.60 to $1.2
Player#3387: calls $0.60
*** FLOP *** [Kc Jd Jh]
Player#2036: bets $2.50
Player#3387: folds
Player#2036: doesn't show hand
Uncalled bet ($2.50) returned to Player#2036
Player#2036 collected $2.38 from pot
*** SUMMARY ***
Total Pot $2.50 | Rake $0.12
Board [Kc Jd Jh]
Seat 1: Player#8046 (small blind) folded before the flop
Seat 2: Player#2036 shows [] and won ($2.38) with 
Seat 3: Player#7870 folded before the flop
Seat 4: warioman folded before the flop
Seat 5: Player#3387 folded on the flop
Seat 6: Player#5178 (button) folded before the flop

PokerStars Hand #71258302-c4b8-486c-8fc0-85a9912dace3:  Hold'em No Limit ($0.1/$0.20 USD) - 2021/11/21 00:07:00 ET
Table 'Lacey' 6-max Seat #6 is the button
Seat 1: warioman ($20.00 in chips)
Seat 2: Player#3465 ($21.60 in chips)
Seat 3: Player#6947 ($56.82 in chips)
Seat 4: Player#5215 ($30.26 in chips)
Seat 5: Player#6128 ($22.61 in chips)
Seat 6: Player#0099 ($47.97 in chips)
warioman: posts small blind $0.10
Player#3465: posts big blind $0.20
*** HOLE CARDS ***
Dealt to warioman [6c Jc]
Player#6947: folds
Player#5215: raises $0.20 to $0.4
Player#6128: calls $0.40
Player#0099: folds
warioman: folds
Player#3465: calls $0.20
*** FLOP *** [8s Ad 3d]
Player#3465: checks
Player#5215: bets $0.65
Player#6128: folds
Player#3465: calls $0.65
*** TURN *** [8s Ad 3d] [Jh]
Player#3465: checks
Player#5215: bets $1.95
Player#3465: folds
Player#5215: doesn't show hand
Uncalled bet ($1.95) returned to Player#5215
Player#5215 collected $2.47 from pot
*** SUMMARY ***
Total Pot $2.60 | Rake $0.13
Board [8s Ad 3d Jh]
Seat 1: warioman (small blind) folded before the flop
Seat 2: Player#3465 (big blind) folded on the turn
Seat 3: Player#6947 folded before the flop
Seat 4: Player#5215 shows [] and won ($2.47) with 
Seat 5: Player#6128 folded on the flop
Seat 6: Player#0099 (button) folded before the flop

PokerStars Hand #c0e4d728-288a-4861-84c5-53821d03cf60:  Hold'em No Limit ($0.1/$0.20 USD) - 2021/11/21 00:07:00 ET
Table 'Denver' 6-max Seat #5 is the button
Seat 1: Player#6895 ($18.26 in chips)
Seat 2: Player#2629 ($19.68 in chips)
Seat 3: Player#1062 ($19.18 in chips)
Seat 4: warioman ($19.00 in chips)
Seat 5: Player#8375 ($46.63 in chips)
Seat 6: Player#4229 ($20.10 in chips)
Player#4229: posts small blind $0.10
Player#6895: posts big blind $0.20
*** HOLE CARDS ***
Dealt to warioman [5c As]
Player#2629: folds
Player#1062: folds
warioman: folds
Player#8375: folds
Player#4229: raises $0.20 to $0.6
Player#6895: raises $0.60 to $1.8
Player#4229: folds
Player#6895: doesn't show hand
Uncalled bet ($1.80) returned to Player#6895
Player#6895 collected $0.60 from pot
*** SUMMARY ***
Total Pot $0.60 | Rake $0.00
Seat 1: Player#6895 shows [] and won ($0.60) with 
Seat 2: Player#2629 folded before the flop
Seat 3: Player#1062 folded before the flop
Seat 4: warioman folded before the flop
Seat 5: Player#8375 (button) folded before the flop
Seat 6: Player#4229 (small blind) folded before the flop

PokerStars Hand #8b5b218f-5fb3-4eb4-a992-bdfbbefae847:  Hold'em No Limit ($0.1/$0.20 USD) - 2021/11/21 00:07:00 ET
Table 'Lacey' 6-max Seat #5 is the button
Seat 1: warioman ($19.17 in chips)
Seat 2: Player#5650 ($21.60 in chips)
Seat 3: Player#1820 ($56.52 in chips)
Seat 4: Player#5951 ($30.26 in chips)
Seat 5: Player#2952 ($22.61 in chips)
Seat 6: Player#0059 ($48.07 in chips)
Player#0059: posts small blind $0.10
warioman: posts big blind $0.20
*** HOLE CARDS ***
Dealt to warioman [7d Qh]
Player#5650: folds
Player#1820: raises $0.20 to $0.6
Player#5951: folds
Player#2952: folds
Player#0059: folds
warioman: folds
Player#1820: doesn't show hand
Uncalled bet ($0.60) returned to Player#1820
Player#1820 collected $0.30 from pot
*** SUMMARY ***
Total Pot $0.30 | Rake $0.00
Seat 1: warioman (big blind) folded before the flop
Seat 2: Player#5650 folded before the flop
Seat 3: Player#1820 shows [] and won ($0.30) with 
Seat 4: Player#5951 folded before the flop
Seat 5: Player#2952 (button) folded before the flop
Seat 6: Player#0059 (small blind) folded before the flop

PokerStars Hand #1fa4cee2-f3da-4134-94e1-3de408418d8f:  Hold'em No Limit ($0.1/$0.20 USD) - 2021/11/21 00:06:00 ET
Table 'Denver' 6-max Seat #6 is the button
Seat 1: Player#4124 ($18.26 in chips)
Seat 2: Player#8736 ($19.38 in chips)
Seat 3: Player#6407 ($19.18 in chips)
Seat 4: warioman ($19.00 in chips)
Seat 5: Player#6503 ($46.73 in chips)
Seat 6: Player#3008 ($20.30 in chips)
Player#4124: posts small blind $0.10
Player#6503: posts big blind $0.20
*** HOLE CARDS ***
Dealt to warioman [5h 6c]
Player#4124 Waiting
Player#8736: raises $0.20 to $1.2
Player#6407: folds
warioman: folds
Player#6503: folds
Player#3008: folds
Player#8736: doesn't show hand
Uncalled bet ($1.20) returned to Player#8736
Player#8736 collected $0.30 from pot
*** SUMMARY ***
Total Pot $0.30 | Rake $0.00
Seat 1: Player#4124 (small blind) mucked
Seat 2: Player#8736 shows [] and won ($0.30) with 
Seat 3: Player#6407 folded before the flop
Seat 4: warioman folded before the flop
Seat 5: Player#6503 (big blind) folded before the flop
Seat 6: Player#3008 (button) folded before the flop

PokerStars Hand #c19f6023-3d4c-4325-8cca-1d5b7666801d:  Hold'em No Limit ($0.1/$0.20 USD) - 2021/11/21 00:06:00 ET
Table 'Denver' 6-max Seat #6 is the button
Seat 1: Player#7012 ($18.26 in chips)
Seat 2: Player#5079 ($19.38 in chips)
Seat 3: Player#2498 ($19.18 in chips)
Seat 4: warioman ($19.10 in chips)
Seat 5: Player#8718 ($46.63 in chips)
Seat 6: Player#0760 ($20.30 in chips)
Player#7012: posts small blind $0.10
warioman: posts big blind $0.20
*** HOLE CARDS ***
Dealt to warioman [7h Jd]
Player#7012 Waiting
Player#0760: folds
Player#5079: folds
Player#2498: folds
warioman: folds
Player#8718 collected $0.20 from pot
*** SUMMARY ***
Total Pot $0.20 | Rake $0.00
Seat 1: Player#7012 (small blind) mucked
Seat 2: Player#5079 folded before the flop
Seat 3: Player#2498 folded before the flop
Seat 4: warioman (big blind) folded before the flop
Seat 5: Player#8718 shows [] and won ($0.20) with 
Seat 6: Player#0760 (button) folded before the flop

PokerStars Hand #3f0e8a8b-af46-4265-80a2-691d7068306a:  Hold'em No Limit ($0.1/$0.20 USD) - 2021/11/21 00:06:00 ET
Table 'Denver' 6-max Seat #1 is the button
Seat 1: Player#1662 ($20.43 in chips)
Seat 2: Player#8410 ($21.91 in chips)
Seat 3: warioman ($19.30 in chips)
Seat 4: Player#6943 ($42.98 in chips)
Seat 5: Player#6836 ($20.30 in chips)
Player#8410: posts small blind $0.10
warioman: posts big blind $0.20
*** HOLE CARDS ***
Dealt to warioman [2c 9s]
Player#6943: raises $0.20 to $0.6
Player#6836: folds
Player#1662: raises $0.60 to $1.05
Player#8410: calls $0.95
warioman: folds
Player#6943: calls $0.45
*** FLOP *** [4h Kc Td]
Player#8410: checks
Player#6943: checks
Player#1662: checks
*** TURN *** [4h Kc Td] [Ad]
Player#8410: checks
Player#6943: bets $1.68
Player#1662: folds
Player#8410: calls $1.68
*** RIVER *** [4h Kc Td] [Ad] [8d]
Player#8410: checks
Player#6943: bets $3.96
Player#8410: folds
Player#6943: doesn't show hand
Uncalled bet ($3.96) returned to Player#6943
Player#6943 collected $6.37 from pot
*** SUMMARY ***
Total Pot $6.71 | Rake $0.34
Board [4h Kc Td Ad 8d]
Seat 1: Player#1662 (button) folded on the turn
Seat 2: Player#8410 (small blind) folded on the river
Seat 3: warioman (big blind) folded before the flop
Seat 4: Player#6943 shows [] and won ($6.37) with 
Seat 5: Player#6836 folded before the flop

PokerStars Hand #6e47eb1d-8272-4d8e-9614-b424bde801f9:  Hold'em No Limit ($0.1/$0.20 USD) - 2021/11/21 00:06:00 ET
Table 'Lacey' 6-max Seat #4 is the button
Seat 1: warioman ($19.17 in chips)
Seat 2: Player#1995 ($21.60 in chips)
Seat 3: Player#8554 ($56.72 in chips)
Seat 4: Player#1213 ($29.70 in chips)
Seat 5: Player#3746 ($22.81 in chips)
Seat 6: Player#0884 ($48.27 in chips)
Player#3746: posts small blind $0.10
Player#0884: posts big blind $0.20
*** HOLE CARDS ***
Dealt to warioman [5s 4d]
warioman: folds
Player#1995: folds
Player#8554: calls $0.20
Player#1213: calls $0.20
Player#3746: calls $0.10
Player#0884: checks
*** FLOP *** [9d 3s 4s]
Player#3746: checks
Player#0884: checks
Player#8554: checks
Player#1213: checks
*** TURN *** [9d 3s 4s] [7s]
Player#3746: checks
Player#0884: checks
Player#8554: checks
Player#1213: checks
*** RIVER *** [9d 3s 4s] [7s] [Ts]
Player#3746: checks
Player#0884: checks
Player#8554: checks
Player#1213: bets $1.40
Player#3746: folds
Player#0884: folds
Player#8554: folds
Player#1213: doesn't show hand
Uncalled bet ($1.40) returned to Player#1213
Player#1213 collected $0.76 from pot
*** SUMMARY ***
Total Pot $0.80 | Rake $0.04
Board [9d 3s 4s 7s Ts]
Seat 1: warioman folded before the flop
Seat 2: Player#1995 folded before the flop
Seat 3: Player#8554 folded on the river
Seat 4: Player#1213 shows [] and won ($0.76) with 
Seat 5: Player#3746 (small blind) folded on the river
Seat 6: Player#0884 (big blind) folded on the river

PokerStars Hand #2b9efc9c-e199-48dc-931e-556bf545bbfe:  Hold'em No Limit ($0.1/$0.20 USD) - 2021/11/21 00:05:00 ET
Table 'Denver' 6-max Seat #6 is the button
Seat 1: Player#7981 ($20.53 in chips)
Seat 2: Player#6152 ($22.11 in chips)
Seat 3: warioman ($19.30 in chips)
Seat 4: Player#8114 ($42.98 in chips)
Seat 5: Player#0266 ($20.00 in chips)
Player#7981: posts small blind $0.10
Player#6152: posts big blind $0.20
*** HOLE CARDS ***
Dealt to warioman [Kc 8d]
warioman: folds
Player#8114: folds
Player#0266: raises $0.20 to $0.7
Player#7981: folds
Player#6152: folds
Player#0266: doesn't show hand
Uncalled bet ($0.70) returned to Player#0266
Player#0266 collected $0.30 from pot
*** SUMMARY ***
Total Pot $0.30 | Rake $0.00
Seat 1: Player#7981 (small blind) folded before the flop
Seat 2: Player#6152 (big blind) folded before the flop
Seat 3: warioman folded before the flop
Seat 4: Player#8114 folded before the flop
Seat 5: Player#0266 shows [] and won ($0.30) with 

PokerStars Hand #27c3e753-60ab-4574-9f5e-5ef1f5a871ec:  Hold'em No Limit ($0.1/$0.20 USD) - 2021/11/21 00:05:00 ET
Table 'Lacey' 6-max Seat #5 is the button
Seat 1: warioman ($19.17 in chips)
Seat 2: Player#3128 ($21.60 in chips)
Seat 3: Player#7175 ($56.72 in chips)
Seat 4: Player#0493 ($29.52 in chips)
Seat 5: Player#5010 ($23.01 in chips)
Seat 6: Player#2853 ($48.27 in chips)
Player#2853: posts small blind $0.10
Player#0493: posts big blind $0.20
*** HOLE CARDS ***
Dealt to warioman [2s Jh]
Player#2853 Waiting
warioman: folds
Player#3128: folds
Player#7175: folds
Player#0493: calls $0.10
Player#5010: checks
*** FLOP *** [Js Tc Qh]
Player#0493: checks
Player#5010: checks
*** TURN *** [Js Tc Qh] [5s]
Player#0493: bets $0.40
Player#5010: folds
Player#0493: doesn't show hand
Uncalled bet ($0.40) returned to Player#0493
Player#0493 collected $0.38 from pot
*** SUMMARY ***
Total Pot $0.40 | Rake $0.02
Board [Js Tc Qh 5s]
Seat 1: warioman folded before the flop
Seat 2: Player#3128 folded before the flop
Seat 3: Player#7175 folded before the flop
Seat 4: Player#0493 shows [] and won ($0.38) with 
Seat 5: Player#5010 (button) folded on the turn
Seat 6: Player#2853 (small blind) mucked

PokerStars Hand #08feabda-4a94-47de-aa2b-70fedfa68243:  Hold'em No Limit ($0.1/$0.20 USD) - 2021/11/21 00:05:00 ET
Table 'Denver' 6-max Seat #4 is the button
Seat 1: Player#1470 ($20.73 in chips)
Seat 2: Player#3333 ($22.11 in chips)
Seat 3: warioman ($19.30 in chips)
Seat 4: Player#1248 ($35.68 in chips)
Seat 5: Player#6399 ($18.10 in chips)
Player#6399: posts small blind $0.10
Player#1470: posts big blind $0.20
*** HOLE CARDS ***
Dealt to warioman [8c 7d]
Player#3333: folds
warioman: folds
Player#1248: raises $0.20 to $0.6
Player#6399: raises $0.60 to $2.2
Player#1470: folds
Player#1248: calls $1.60
*** FLOP *** [9c 9d Ac]
Player#6399: bets $1.70
Player#1248: calls $1.70
*** TURN *** [9c 9d Ac] [5h]
Player#6399: bets $4.00
Player#1248: raises $ 34.00 to $31.78
Player#6399: folds
Player#1248: doesn't show hand
Uncalled bet ($31.78) returned to Player#1248
Player#1248 collected $11.40 from pot
*** SUMMARY ***
Total Pot $12.00 | Rake $0.60
Board [9c 9d Ac 5h]
Seat 1: Player#1470 (big blind) folded before the flop
Seat 2: Player#3333 folded before the flop
Seat 3: warioman folded before the flop
Seat 4: Player#1248 shows [] and won ($11.40) with 
Seat 5: Player#6399 (small blind) folded on the turn

PokerStars Hand #9d5673f6-585b-4dbb-a690-4121282b114b:  Hold'em No Limit ($0.1/$0.20 USD) - 2021/11/21 00:04:00 ET
Table 'Lacey' 6-max Seat #2 is the button
